a=අනියමාර්ථ විශේෂණය | ඉංග්‍රීසි හෝඩියේ මුල් අකුර | උඩ | තුළ | නැති | මත | රහිත | විද්‍යුතය මනින ඒකකය
a=අනියමාර්ථ විශේෂණය | ඉංග්‍රීසි හෝඩියේ මුල් අකුර | උඩ | තුළ | නැති | මත | රහිත | විද්‍යුතය මනින ඒකකය
a-=විරුද්ධාර්ථය අඟවන උපසර්ගයක්
a-bomb=පරමාණු බෝම්බය
a-dynamic=නිර්ගතික
a-effect=තාදාත්ම්‍ය විඝටනය
a.b.c.c.=බ්‍රිතාන්‍ය වාණිජ මණ්ඩලීය සමාගම
a.c.a.=වරලත් ගණකාධිකාරී ආයතනයේ ආශ්‍රිත සාමාක
a.c.t.h=අධිවෘක්ක බාහික භරණ හෝමෝනය | ඇඩ්‍රිනොකෝටිකෝට්‍රොපික් හෝමෝනය
a.d.b.=ආසියානු සංවර්ධන බැංකුව
a.e.a.=පරමාණු ශක්ති අදිකාරිය
a.f=ශ්‍රව්‍ය සංඛ්‍යාතය
a.f.c=ස්වයංක්‍රිය සංඛ්‍යාත පාලකය
a.f.c.=ස්වයංක්‍රිය සංඛ්‍යාත පාලකය
a.g.c=ස්වයංක්‍රිය ලාභ පාලකය
a.g.c.=ස්වයංක්‍රිය ලාභ පාලකය
a.l.s.=අ සි ලි
a.p.t.=ඇලම් අවක්ෂේපිත ධූලකාභය
a.r.=පරිපාලන රෙගුලාසි
a.s.c.e.=ඇමෙරිකන් සිවිල් ඉංජිනේරු සංගමය
a.u.=ඇංස්ට්‍රම් ඒකකය
a.v.c=ස්වයංක්‍රිය පරිමා පාලකය
a.v.c.=ස්වයංක්‍රිය පරිමා පාලකය
aa=ආහය
aarrow=ඇටමිදුළු | මිදුලුව
ab-initio=මුල පටන්
ab-intestato=තෙස්තමේන්තු රහිතව
aba=එළු ලොමින් සෑදූ සිරියා රෙද්ද | ඔටු ලොමින් සෑදූ සිරියා රෙද්ද | සිරියා රෙද්දෙන් මැසූ කබාය
abac=ඇකිය
abaca=අබක
aback=පස්සට | පස්සෙන් | පසුපසට | පුදුමයට | විස්මයට
abacus=ඇබකසය | කුලුණු හිස | ගණක චතුරස්‍රය | ගණක රාමුව | ඝණක චතුරස්‍රය
abaft=අවරට | නැවක පසු භාගයෙහි | පස්සෙන්
abampere=ඇබ්ඇම්පියරය | ඇබැම්පියරය | නියැම්පියරය
abandon=අත සෝදා ගන්නවා | අතරමං කරනවා | අත්හරිනවා | දුරුකරනවා | ප්‍රතික්ෂේප කරනවා | පිටිපානවා | වගකීමක් නැති කම | වර්ජනය කරනවා | සිතුමනාපේ හැසිරීම | හැර දමනවා
abandoned=අතරමං කළ | අත් හළ | අත්හළ | අශිෂ්ට | ජඩ | ජරාවාස | පාලු | පාළු | පුරං | ලූ
abandonedly=අත් හැර දැමූ ලෙස | පාළුවට
abandonment=අත්හැර දැමීම | අත්හැරීම | ත්‍යජනය | පාළුවට හැරීම | විජභනය
abase=නින්දා කරනවා | නිවට වෙනවා | පහතට හෝ යටතට හෝ අවමානයට හෝ පමුණුවනවා | පහත් කරනවා
abasement=අවමන් කිරීම | නින්දා කිරීම | පහත් කිරීම | යටත් කිරීම
abash=අධෛර්ය්‍යයට භාජනය කරනවා | ලජ්ජා වෙනවා | ලජ්ජාවට භාජනය කරනවා
abashment=ලජ්ජාවීම
abate=අඩු කරනවා | අඩු වෙනවා | අවකරණය කරනවා | අවකරණය වෙනවා | අස් කරනවා | නවත්වනවා | පහළ දමනවා | බහිනවා | බැස යනවා
abate-jour=වහල ජනේලය | වහල වීදුරුව
abated=අඩු වූ | බැස ගිය
abatement=අඩු කිරීම | අඩුකිරීම | අඩුවීම | අවකරණය | නතර කිරීම | නැවැත්වීම | බැස යෑම
abater=අවකාරක
abattoir=මස් මඩුව
abaxial=අක්ෂයෙන් එහා | අවාක්ෂ
abba=එළු ලොමින් සෑදූ සිරියා රෙද්ද | ඔටු ලොමින් සෑදූ සිරියා රෙද්ද | සිරියා රෙද්දෙන් මැසූ කබාය
abbacy=තාපසාරාමයෙහි අධිපතිකම
abbatoir=මස් මඩුව | වධකාගාරය
abberration=අපේරණය
abbess=ආශ්‍රමාධිපතිනිය | කන්‍යාරාමාධිපති | කන්‍යාරාමාධිපතිනිය
abbevillian=අබෙවිලියානු
abbey=කන්‍යාරාමය | තාපසාරාමය | පල්ලිය | ප්‍රව්‍රත සමූහය | පැවිදි ආශ්‍රමය | මඩම | මඩමක පිහිටි පල්ලිය
abbortion=ගබ්සාව
abbot=ආශ්‍රමාධිපති තැන | තාපසාරාමයේ අධිපතියා | පල්ලියේ අධිපතියා | යතීන්ද්‍රයා
abbreviate=අඩු කරනවා | කෙටි කරනවා | කෙටිකරනවා | ලුහුඬෙන් කියනවා | සංක්ෂිප්ත කරනවා | සංක්ෂේපණය කරනවා | සංක්ෂේපයෙන් කියනවා | හකවනවා
abbreviated=සං ක්ෂිප්ත | සංක්ෂිප්ත
abbreviation=කෙටි කිරීම | කෙටි යෙදුම | කෙටි රූපය | කෙටි සටහන | සංක්ෂිප්තය | සංක්ෂේපණය | සංක්ෂේපනය | සැකෙවිය
abbreviatory=කෙටි | සංක්ෂිප්ත
abcess=විස්ඵෝටය
abcoulomb=ඇබ්කූලෝම
abdicate=අපත්‍යජනය කරනවා | නිලය අත්හරිනවා | රජකම අත්හරිනවා | රජකම අත්හැර යනවා
abdication=අත්හැරීම | අපත්‍යජනය | නිලය අත්හැරීම | රජකම අත්හැරීම | රජකම අත්හැරීම | සිහසුන අත්හැරීම
abdomen=උදරය | බඩ | යටිබඩ
abdominal=උදර | උදරමය | උදරීය | කුච්ඡිමය
abdominous=මහෝදර | ලොකු බඩ සහිත
abduce=පැහැර ගන්නවා | පැහැර ගෙන යනවා
abduct=උස්සාගෙන යනවා | පරාහරණය කරනවා | ප්‍රහරණය | පැහැර ගන්නවා | පැහැර ගෙන යනවා | පැහැරගෙන යනවා | බලත්කාරයෙන් හැරගෙන යනවා | බලෙන් ගෙන යනවා | රහසින් හැරගෙන යනවා
abduction=අපනයනය | අපහරණය | පරාහණය | පැහැර ගෙන යෑම | පැහැරගෙන යාම | බලාත්කාරයෙන් ගෙන යෑම
abductor=පරාහාරකයා
abeam=ගුවන් නැවක දික්භාගයට ලම්බාකාරව පිහිටි
abed=ඇඳෙහි | පර්ය්‍යංකස්ථව | පලක් බැඳ
abele=සුදු පොප්ලර්
aberrant=අපේරණ | අමාර්ගගාමී | ඉබා ගාතේ යන | නොමග යන | නොමඟ යන
aberrate=නිසි මගින් බැහැර යනවා | සමයම් කරනවා
aberration=අපේරණය | නොමග යාම | නොමඟ යෑම | භ්‍රංශය | මුළා වීම | මුළාව | වරද
abessive=රහිත | විරහිත
abet=අනුබල දෙනවා | වරදට අනුබල දෙනවා | වරදට පොළඹවනවා
abetement=අනුබල දීම
abeter=උදවු දෙන්නා | හවුල්කාරයා
abetment=අනුබල දීම | අනුබලදීම | වරදට අනුබල දීම | වරදට පෙළඹවීම
abetor=උදවු දෙන්නා | හවුල්කාරයා
abetter=අනුබල දෙන්නා | උදවු දෙන්නා | වරදට පොළඹවන්නා | හවුල්කාරයා
abettor=අනුබල දෙන්නා | උදවු දෙන්නා | වරදට පොළඹවන්නා
abeyance=අත්හිටීම | කලකට නතරවීම | තාවකාලික නැවැත්වීම | තාවකාලිකව නවතා තැබීම | තාවකාලිකව නැවතී තිබීම
abeyancy=කලකට අත්හිටවීම | තාවකාලික නැවැත්වීම | නතර වීම
abeyant=කලකට අත්හිටි | තාවකාලිකව නැවැත්වූ
abhayagiri=බගිරි | බයගිරිය
abhidhamma=බිදම් | විජම්
abhor=අප්‍රිය කරනවා | නුරුස්සනවා | පිළිකුල් කරනවා
abhorence=පිළිකුල
abhorent=නීච | පිළිකුල් කටයුතු | පිළිකුල් සහිත
abhorrence=අරුවය | පිළිකුල | පිළිකුළ
abhorrent=අප්‍රියජනක | නීච | නුරුස්නා | ප්‍රතිකූල | පිළිකුල් කටයුතු | පිළිකුල් සහිත
abhorrer=පිළිකුල් කරන්නා
abide=ඉන්නවා | ඉවසනවා | එකඟ වෙනවා | නවතිනවා | පවතිනවා | පොරොත්තුව සිටිනවා | බැඳෙනවා | රුස්සනවා | වාසය කරනවා
abided=ඉවසනවා | නවතිනවා | පවතිනවා | පොරොත්තුව සිටිනවා | රුස්සනවා | වාසය කරනවා
abiding=වෙනස් නොවන | ස්ථීර
abient=පරිහාරී
abietic=අබියෙටික
abigail=දාසිය | දාසී | පරිවාරක ස්ත්‍රිය | පරිවාරිකාව
ability=දක්ෂකම | පුළුවන්කම | පෝමන් | බලය | බැරිපුළුවන්කම | ශක්තිය | සපන්කම | සවිය | ස්ථාම | සාමර්ථයය | හැකිබව | හැකියාව | හුරුකම
abiogenesis=අවජනනය | අවාජ්ජනනය | සපපාතික උත්පත්තිය | සපපාතික උපත | ස්වයංජාතය
abiogenetic=අවජනක | සපපාතික | ස්වයංජාත
abiophysiology=අවකාය විද්‍යාව
abiosis=අවය
abiotic=අප්‍රාණික | අව
abject=අධම | තුච්ච | දුක්ඛිත | දුක්ඛිතයා | දුහ්ඛිත | දුහ්ඛිතයා | නිහීන | නීච | නීචයා | පහත්
abjection=තුච්ඡභාවය | දුක්ඛිතභාවය | දුහ්ඛිතභාවය | නිහීනත්වය | නීචභාවය
abjectly=නීච ලෙස
abjectness=දුක්ඛිතභාවය | දුහ්ඛිතභාවය | නීචකම | නීචභාවය | පහත්කම
abjuration=ප්‍රතික්ෂේප කිරීම
abjure=දිවුරා අත්හරිනවා | ප්‍රතික්ෂේප කරනවා
abklingen=අපහායනය
ablate=ගෙවී යනවා | ගෙවෙනවා
ablation=අපහරණය | ගෙවීයෑම
ablative=අවධි විභක්තිය | අවධි විභක්තියේ ඇති
ablaut=අජ්විපරිණාමය | ස්වර අනම්‍යය
ablaze=ඇවිළගත් | ඇවිළුණු | ගිනි ගත් | ගිනිගත් | දැල්වෙන | දිලිසෙන
able=ක්ෂම | දක්ෂ | ප්‍රබල | පිළිවන් | පුළුවන් | පෝමන් | වත් | ශක්තිමත් | ශක්‍ය | ශූර | සපන් | සමත | සමත් | සමර්ථ | හැකි
able-bodied=ශක්තිමත්
ablebodied=ශක්තිමත්
ablolute=ඒකාන්ත
ablow=පිපෙන
ablush=ලජ්ජාවෙන් මුහුණ රතු වී
ablution=නෑම | පරිත්‍ර කිරීම | පවිත්‍ර කිරීම | ශරීරකෘත්‍යය | ශුද්ධ කිරීම | ස්නානය කොට පිරිසිදු වීම
ablutionary=නා පිරිසිදු වන
ably=දක්ෂ ලෙස | පිපෙමින්
abmodality=අපමාතිය
abnegate=අයිතිවාසිකම අත්හරිනවා | ත්‍යජනය කරනවා | පිළිගැනීම අත්හරිනවා | මතය අත්හරිනවා
abnormal=අනියම් | අපසාමාන්‍ය | අප්‍රමත | අවප්‍රමාණ | අස්වාභාවික | අසාමාන්‍ය | පුදුම
abnormalism=අසාමාන්‍යභාවය
abnormality=අනියම් බව | අප්‍රමතිය | අසාමාන්‍යත්වය | අසාමාන්‍යය | විපරීතය | විශේෂය
abnormally=අනියම් ලෙසින් | අසාමාන්‍ය ලෙස | රියකට ගොඩ වී | විපරීතව
aboard=දුම්රියේ | නැවේ | යාත්‍රාවකට ගොඩ වී | යාත්‍රාවේ | වාහනයක
abode=ආල | ආවාසය | ආශය | ඉවසනවා | ඉවසුවා | එකඟ වූ | ගෙය | නවත්නවා | නැවැත්තුවා | නිවස | පවතිනවා | පැවතුනා | පොරොත්තුව සිටිනවා | පොරොත්තුව සිටියා | භවනය | රිස්සුවා | රුස්සනවා | වාසය | වාසය කරනවා | වාසය කෙරුවා | වාසස්ථානය | විමානය | හිඳි
abohm=ඇබ්සම | නියෝම
abolish=අවලංගු කරනවා | අහෝසි කරනවා | ආලෝපනය කරනවා | ඉවත් කරනවා | නැති කරනවා
abolition=අවලංගු කිරීම | ආලෝපනය | ඉවත් කිරීම | නැති කිරීම | නැතිකිරීම
abolitionist=අවලංගු කිරීමට ක්‍රියා කරන්නා
abomination=ගර්භාව | ද්වෙෂය | ද්වේෂය | පිළිකුල | පිළිකුළ | වෙෂය
abomination=ගර්භාව | ද්වෙෂය | ද්වේෂය | පිළිකුල | පිළිකුළ | වෙෂය
aboral=අපමුඛ | අපමෞඛ
aborigin=මෞලිකයා
aboriginal=ආදිවාසික | පළමුව ඇති වූ | ම්ලේච්ඡ | මුල් පදිංවකාර | රටක ආදියෙහි වූ
aborigine=ආදිවාසියා | මුල් පදිංවකාරයා | මුල් වැසියා
aborigines=ආදිවාසීහු | මුල් පදිංවකාරයෝ | මූලවාසීහු
abort=අසාර්ථක වෙනවා | ගප්සා වෙනවා | ගබ්සා කරනවා | ගබ්සා වෙනවා | නවත්වනවා | රෝධනය කරන්න | රෝධනය වෙනවා
aborted=රුද්ධ
abortion=ගප්සා කිරීම | ගප්සා වීම | ගප්සාව | ගබ්සා කිරීම | ගබ්සාව | ගර්භපාතය | නිෂ්ඵල වීම | රෝධනය | වෛඵල්‍යය
abortive=අසම්පූර්ණ | අසාර්ථක | කාලයට කලින් | නිෂ්ඵල | රුද්ධ | ව්‍යර්ථ | හිස්
aboulia=අබල්‍යතාව
abound=අධිකව පවතිනවා | ගහනව තිබෙනවා | බහුල වෙනවා | බහුලව තිබෙනවා
abounding=අධික | බහුල
about=අරබයා | අරභයා | අවට | එහා මෙහා | ගැන | පමණ | පිළිබඳ | වගේ | වටා | වටේ | සම්බන්ධව | සූදානමේ | ළඟ
above=අධි | ඉ | ඉහත | ඉහළ | ඉහළින් | උ | උඩ | උඩින් | උඩු | කලින් | කලින් කී | මතු | වඩා
above-board=අවංක | ප්‍රකට
above-mentioned=ඉහතකී | මෙකී | යථොක්ත
above-the-line=උපරි රේඛීය
abracadabra=දෙඩවිල්ලක් | ප්‍රලාප | ප්‍රලාපයක් | යන්ත්‍රයක ලියූ මන්ත්‍රයක් | විජ්ජාවක් බඳු සූත්‍රය
abradant=උල්ලේඛ
abrade=අවසූරනවා | උලනවා | උල්ලේඛ කරනවා | සූරනවා
abrading=ඉලුම්
abrasion=අපමර්ශනය | අපමර්ෂණය | අවසිරීම | අවසීරීම | උල්ලේඛනය | උල්ලේඛනය කිරීම | උල්ලේඛය | ගෙවී යෑම | ඝර්ෂණය | සීරී යෑම | සීරීම | සීරීමෙන් වූ තුවාලය | සීරුම | සීරුව
abrasive=අවසීරුම් ද්‍රව්‍යය | උල්ලේඛ | උල්ලේඛනය | උල්ලේඛය | ද්‍රව්‍යය | රළු | සීරීමට යොදන ද්‍රව්‍යය | සීරුම් ද්‍රව්‍යය | සූරන | සූරන ද්‍රව්‍යය
abraum=ඇබ්‍රම් වර්ණය
abreaction=අපසර්ජනය | කළිත් යටපත් කර තිබූ අදහසක් නිදහසේ ප්‍රකාශ කි
abreast=උරෙන් උර ගැසී | එක පමණට | එක පෙළට | පෙළට | ළඟලඟ
abriachanite=ඇබ්‍රියකනයිට්
abridge=අඩු කරනවා | කොට කරනවා | ලඝු කරනවා | ලුහු කරනවා | සංක්ෂිප්ත | සංක්ෂිප්ත කරනවා | සංක්ෂෙප කරනාව
abridged=සංක්ෂිප්ත
abridgement=ලුහු කිරීම | සංක්ෂිප්තය | සංක්ෂේපය
abridgment=කෙටි කිරීම | සංක්ෂිප්තය | සංක්ෂේපය | සාරය
abroad=එතෙර | ගෙදරින් පිට | පතළව | පිටරට | විශාලව
abrogate=අපලෝපනය කරනවා | අවලංගු කරනවා | අස් කරනවා | අහෝසි කරනවා | නිවේදනයකින් අවලංගු කරනවා | විලෝපනය කරනවා
abrogated=අපලුප්ත
abrogation=අපලෝපනය | අවලංගු කිරීම | අස් කිරීම | අහෝසිය | විලෝපනය
abrogative=අපලෝපනීය
abrupt=අනපේක්ෂිත | අසම්බද්ධ | ආකස්මික | ඒකපාත | ක්ෂණික | ප්‍රපාත වූ | රළු | හදිසි | හදිසියේ කෙළවර වන | හදිසියේ කෙළවර වන | හදිසියේ වෙනස් වන | හිටි අඩියේ
abruptly=ආකස්මිකව | බලාපොරොත්තුවක් නැතිව | හදිසියෙන් | හිටි අඩියේම
abruptness=ඒකපාතය | බලාපොරොත්තුවක් නැතිව සිදුවීම
abscess=ගජුව | ගඩුව | විස්ඵෝටය | සැරව | සැරව ගෙඩිය | සැරවගෙඩිය
abscess,bartholins=බාංතෝලින් විස්ඵෝටය
abscess,chronic=වරන්තන විස්ඵෝටය
abscess,cold=සිසිල් විස්ඵෝටය
abscess,lumbar=කටී විස්ඵෝටය
abscess,psoas=ප්‍රොථකයේ විස්ඵෝටය
abscind=කපා දමනවා
abscissa=තිරස් ඛණ්ඩය | තිරස් ඛණ්ඩාංකය | තිරස්ඛණ්ඩය | තිරස්ඛණ්ඩාංකය | පාටිකය
abscission=කපා හැරීම | කපාදැමීම | ඡේදනය
abscond=අපපලායනවා | කට්ටි පනිනවා | මඟ හරිනවා | මඟහැර පැන යනවා | රහසින් පළා යනවා | විසැඟවෙනවා | සැඟවිල්ලේ සිටිනවා | සැඟවී සිටිනවා | හදිසියෙන් පළා යනවා
absconded=අපපලායිත
absconder=අපපලායික | පැන ගොස් සැඟවී සිටින්නා | පැනගොස් සැඟවී සිටින්නා | මඟ හැර සිටින්නා | විසැඟවුණු තැනැත්තා
abseil=තද බෑවුමක් ඇති පර්වතයක් ඉහලින් ගැට ගසන ලද කඹය
absence=අප්‍රාප්තිය | නොපැමිණ සිටි කාලය | නොපැමිණි බව | නොපැමිණිකාලය | නොපැමිණීම | ප්‍රවාසය | පිට පදිංවිය | ළඟ නැති බව
absent=අනබිමුඛ | අවිද්‍යමාන | අවිද්‍යාමාන | අසම්මුඛ | නොපැමිණ සිටිනවා | නොපැමිණි | පිට සිටින | විරහිත | ළඟ නැති
absent-minded=අමතක වන | අමතක වනසුලු | අවසිහි | මතක නැති | සිත යොමු නොකරන | සිහි කල්පනාව අඩු
absentee=අප්‍රාප්තියා | නොපැමිණි | නොපැමිණි තැනැත්තා | ප්‍රවාසියා | පැමිණ නොසිටින්නා | ළඟ නැති
absenteeism=නොපැමිණියාව | නොපැමිණීමේ නැඹුරුව | ප්‍රවාසතාව | ප්‍රවාසිතාව | විරහිතතාව | සේවයට වාර්තා නොකිරීම
absentinence=පරිවර්ජනය | විරතිය | විරමණය
absentmindedness=නොතන්සිහියාව
absicht=අභිප්‍රාය
absinth(e)=පෙරූ මත්පැන් වර්ගයක්
absolute=අත්තනොමතික | අපණ්ණ | අබාධිත | අවිශේෂ | උදක් | ඒකාන්ත | කේවල | නියත | නිරපේක්ෂ | පරම | පුර්ණ | පූර්ණ | සම්පූර්ණ | ස්ථීර | ස්වාධීන | සීමා රහිත
absolute-temperature=නිරපේක්ෂ උෂ්ණත්වය
absolute.the=පරමය
absolutely=උදක් | නිසැකවම | පරම වශයෙන් | මුළුමනින් | සම්පූර්ණයෙන් | සම්පූර්ණයෙන් ම
absoluteness=කේවලතාව | පූර්ණත්වය
absolution=ක්ෂමාව | නිදහස | පව්සමාව | පාපමුක්තිය | පාපමෝචනය | විමුක්තිය | විශෝධනය
absolutism=නිරපේක්ෂතාවාදය | පරමවාදය | පරමාර්ථවාදය
absolve=නිදොස් කරනවා | පව්සමාකරනවා | වරදින් නිදහස් කරනවා | විමුක්ත කරනවා | විශෝධනය කරනවා
absolved=සමාහිත
absorb=අන්තර්ග්‍රහණය කරනවා | අවශෝෂණය කරනවා | අවශෝෂණය වෙනවා | අහනවා | ඇදගන්නවා | උරනවා | උරා ගන්නවා | උරාගන්නවා | බී ගන්නවා | බීගන්නවා
absorbability=අවශෝෂ්‍යතාව
absorbancy=අවශෝෂ්‍යතාව
absorbate=අවශෝෂිතය
absorbed=ගැලුණු | නිමග්න | නියැලි | විනිවේශිත
absorbency=අවශෝෂකතාව | අවශෝෂණතාව
absorbent=අවශෝෂක | අවශෝෂකය | උරාගන්න | උරාගන්නා | බීගන්න
absorber=අවශෝෂණකාරකය
absorbing=ප්‍රචුෂික | සිත් අලවන
absorptiometer=අවශෝෂණමානය
absorption=අන්තර්ග්‍රහණය | අන්තර්ග්‍රහනය | අවශෝෂණය | ඇලී සිටීම | උකහා ගැනීම | උකහාගැනීම | උරා ගැනීම | උරාගැනීම | තත්පර වීම | දැහැන | ධ්‍යානය | ප්‍රතිශෝෂණය | විලයනය | සංවිලයනය
absorptive=උරාගන්න සුලු
absorptivity=අවශෝෂකතාව | අවශෝෂණ බලය | අවශෝෂණතාව
abstain=මිදෙනවා | වළකිනවා | වැළකෙනවා
abstainer=වළකින්නා | වැළකෙන්නා
abstatfarad=නිස්ථිති පැරඩය
abstemious=කෑමෙහි පමණ දත් | මත්පැණින් වැලකුණු | මත්පැනින් වැළකුණු
abstention=උපවාසය | මිදීම | වැළකීම
absterge=පිරිසිදු කරනවා | පිස දමනවා | ශූද්ධ කරනවා
abstergent=ක්ෂාලකය
abstersive=පවිත්‍රකාරක | පිරිසිදු කරන
abstinenace=විරමණය
abstinence=පරිවර්ජනය | වර්ජනය | වැළකීම | විරමණය
abstinent=පරිවර්ජන | වළකින
abstract=අමුර්ත | අමූර්ත | ඇද ගන්නවා | උද්ධ්‍රැතය | උද්ධෲතය | උධෘතය | උපුටනය | උපුටා ගන්නවා | කේවල | තනි | දුරවබෝධ | නිබන්ධනය | නිබන්ධය | භාව | භාවසූචක | භාවාත්මක | වියුක්ත | විසංයුක්ත | වෙන් කර ගන්නවා | වෙන් කොට ගන්නවා | වෙන් කොට සලකනවා | වෙන් කොටගත් | සංක්ෂේපය | සාර සංග්‍රහය | සාරය | සාරාංශය | සාරාංශය ගන්නවා | හොරෙන් ගන්නවා
abstracta=අමූර්ත සංඥා | වියුක්ත සංඥා
abstracted=වෙන් කොට ගත්
abstractedly=වෙන් කර ගත් ලෙස
abstraction=අපහරණය | අමුර්තනය | අමූර්තනය | අස් කිරීම | ඇද ගැනීම | උපුටා ගැනීම | කල්පනා මාත්‍රය | ගංගා සංගමනය | වියුක්තනය | වියුක්තිකරණය | වියුක්තීකරණය | විසංයෝගය | සමාධිය | සාරෝද්ධාරය
abstractionism=අමූර්තනවාදය | අමූර්තනාභාසය | වියුක්තනාභාසය
abstractionist=අමූර්තනවාදියා | අමූර්තනවාදී
abstractions=අමූර්තන
abstractor=සාර සංග්‍රහ කාරක
abstracts=සාරාංශ | සාරාංශ ග්‍රන්ථ
abstriction=අවකෝචනය
abstruse=අමාරු | ගම්භීර | ගැඹුරු | ගුඩ | ගූඨ | තේරුම් ගැනීමට අපහසු | නොපැහැදිලි
abstrusely=නොපැහැදිලි ලෙස
abstruseness=ගැඹුරු බව
absurd=අභූත | අභූතරූපී | අයුක්ති සහගත | න්‍යායවිරොධ | නිරර්ථක | මෝඩ | විහිලු | හාස්‍යජනක
absurdity=අභූතය | අභූතරූපතාව | අයුක්ති සහගත වීම | නිරර්ථකත්වය | මෝඩකම
absurdly=හාස්‍යජනක ලෙස
abundance=අතිබහුලතාව | අතිශය | අධිකකම | බහුලත්වය | බහුලතාව | සම්පත්තිය | සමෘද්ධ බව | සුලභතාව
abundance=අතිබහුලතාව | අතිශය | අධිකකම | බහුලත්වය | බහුලතාව | සම්පත්තිය | සමෘද්ධ බව | සුලභතාව
abundancy=බහුලත්වය | බහුලතාව | සමෘද්ධිය
abundant=අතිබහුල | අධික | බහුල | බාහුල්‍ය | විපුල | සමෘද්ධිමත්
abundantly=අධික ලෙස | ඉහින් කනින් | කටගොණනක් | ගනසැරේට | සඩිහෙලේට
abuse=අක්‍රොශ කරනවා | අනිසි ලෙස යෙදීම | අනිසි ලෙස යොදනවා | අනිසිපාවිච්ය | අපයෙදුම | අපවාදය | අයථාභාවිතය | අයුතු ප්‍රයෝජන ගන්නවා | අයුතු ප්‍රයෝජනය | ආක්‍රොශය | ආක්‍රෝශය | දුෂ්ප්‍රයුක්ත කිරීම | දුෂ්ප්‍රයුක්තිය | දූෂ්‍ය කරනවා | නින්දාව | පරිභව කරනවා | පරිභවය | බනිනවා | බැණ දොඩවනවා | බැණ වැදෙනවා | බැණුම | බැනීම | වහස
abusive=අක්‍රොශකාරී | අනිසි ලෙස යෙදෙනසුලු | අපවාදාත්මක | නින්දා සහගත | නොනිසි | පරිභවසහගත
abusiveness=නින්දා සහගත බව
abut=නෙරා සිටිනවා | යා වෙනවා | යාව තියෙනවා | හේත්තු වෙනවා | හේත්තුව තියෙනවා
abutment=ආධාරය | යා බැම්ම | යා වූ කොටස | යාබැම්ම | යාව | හේත්තුව
abuttal=යාවීම
abutter=උදවු දෙන්නා | හවුල්කාරයා
abutting=යා වන | යාබද | හේත්තු වන
abvolt=ඇබ්වෝල්ටය
abysm=අගාධය
abysmal=අගාධ | අපාර | ආගාධ | ඉතා ගැඹුරු | පතුලක් නැති | පරතෙරක් නැති
abyss=අගාධය | පතුලක් නැති ගැඹුර | පතුලක් නැති විවරය | පාතාලය
abyssal=අගාධ | අගාධවාසී | අපාර
abyssinian=ඇබිසීනියානු
acacia=අකේෂියා | ඇකේෂියා නම් ගස් විශේෂයක්
academic=අකාර්ය්‍යක්ෂම | උගතුන්ට පමණක් සීමිත | ශාස්ත්‍රඥ | ශාස්ත්‍රාල | ශාස්ත්‍රාලයීය | ශාස්ත්‍රාලිය | ශාස්ත්‍රාලීය | ශාස්ත්‍රිය | ශාස්ත්‍රීය
academical=විද්‍යාලයකට අයත්
academician=විද්වතා | විද්‍යාලයකට අයත් පුද්ගලයා | ශාස්ත්‍රඥයා | ශාස්ත්‍රධාරියා
academicism=ශාස්ත්‍රාලවාදය
academy=විද්වත් පර්ෂද | විද්‍යාපීඨය | විද්‍යායතනය | විද්‍යාලය | විද්‍යාස්ථානය | ශාස්ත්‍රාලය
acajou=කජු ගස | කජු ගෙඩිය
acanaceous=කටු සහිත
acantha=කටුව
acanthus=අකැන්තස් මෝස්තරය | කටු සහිත පත්‍ර ඇති ශාකයක් | කටු සහිත පැළෑටිය
acapnia=එකැප්නියාව | නිර්ධූත්‍යය
acari=අකරිඩාවෝ
acarian=අකරිඩා ගෝත්‍රික
acarpous=ගෙඩි නැති | පල නොදරන | වඳ | විඵල
acarus=අකරිඩාවා
acatalepsy=තත්වාවබෝධය
acataleptic=තත්වානවබෝධකාරක
acatamathesia=අනවබෝධය
acataphasia=විභණ්‍යතාව
acatemathesia=තත්වානවබෝධය
acater=ආහාර සපයන්නා
acatour=ආහාර සපයන්නා
acaudal=වලිගය නැති
acaulescent=අස්කන්ධීය | කඳ නැති
acauline=අස්කන්ධිය | අස්කන්ධීය | කඳ නැති
accable=මන්දෝත්සාහී
accacia=ඇකේෂියා
accede=අනුමත කරනවා | එකඟ වෙනවා | එකතු වෙනවා | පිළිගන්නවා | යටත් වෙනවා | හිමි කරගන්නවා
accedence=අනුමතිය | එකඟත්වය | එකතුවීම
acceder=අනුමත කරන්නා | එකඟ වන්නා
accelerate=අධිවේගී කරනවා | ඉක්මන් කරනවා | කඩිනම් කරනවා | ත්වරණය කරනවා | ත්වරණය වෙනවා | ත්වරීත කරනවා | වේගය වැඩි කරනවා
accelerated=ත්වරිත | වේගය වැඩි කළ
acceleration=ඉක්මන් කිරීම | කඩිනම් කිරීම | ත්වරණය | වේගය වැඩි කිරීම
accelerator=ඇක්සලරේටරය | ත්වරකය | ත්වරණය
acceleratory=ත්වරක | වේගවත් කරන
accelerometer=ඇක්සලරෝමීටරය | ත්වරණමානය
accend=දල්වනවා
accension=දැල්වීම | ප්‍රාප්තිය | රාජ්‍යපද ප්‍රාප්තිය
accent=අවධාරණය | උච්චාරණ ලකුණ | උච්චාරණ විධිය | උද්දීපනය | උදාත්තය | දේශීය උච්චාරණ විධිය | ප්‍රාසය | බර කරනවා | බර කොට කියනවා | බර කොට දක්වනවා | ස්වරණය | ස්වරාඝාතය | හජනගා කියනවා
accented=උච්චාරණය කළ | ප්‍රස්ත
accentuate=ස්වරයන්ගේ උච්චාරණය දක්වනවා
accentuation=අවධාරණය | අවධාරණයෙන් කීම | උද්දීපනය | උදාත්තකරණය
accept=ඒත්තුගන්නවා | කර පින්නා ගන්නවා | ප්‍රතිග්‍රහණය කරනවා | පිළිගන්නවා | බාර ගන්නවා | බාරගන්නවා | භාර ගන්නවා
acceptability=ප්‍රතිග්‍රහණක්ෂමතාව | ප්‍රතිගෘහ්‍යතාව | පිළිගතහැකි බව
acceptable=පරිග්‍රාහක | ප්‍රාමාණික | ප්‍රිය | පිළිගත හැකි | පිළිගතමනා | භාර ගත හැකි
acceptance=පරිග්‍රහ | පරිග්‍රහණය | පරිග්‍රහය | ප්‍රතිග්‍රහණය | ප්‍රතිශ්‍රවණය | පිළිගැන්ම | පිළිගැනීම | පිළිගැනුම | පිළිණ | පොරොන්දු පත්‍රය | බාරගැනීම | භාර ගැනීම | ලැබීම | වැටහීම | සතුට | සම්මති | සම්මුතිය
acceptation=පිළිගැනීම | වචයක පිළිගත් අර්ථය | වචයක රූ අර්ථය
accepted=ප්‍රතිගෘහිත | පිළිගත් | බාරගත් | සම්මති
acceptilatio=ඇක්සෙප්ටිලාටියෝව | ණයෙන් නිදහස් වීම
acceptor=ප්‍රතිග්‍රාහක | ප්‍රතිග්‍රාහකය | ප්‍රතිග්‍රාහකයා | පිළිගන්නා | බාරගන්නා
access=කිට්ටුවීම | පරිශීලනය | ප්‍රවේශ වීමේ බලය | ප්‍රවේශ වීමේ මාර්ගය | ප්‍රවේශය | පිවිසුම | ලාභය | සම්ප්‍රවේශය
accessary=අවසහායක | උපකාරක | උපකාරකය | උපකාරී හේතුව | හවුල්කාරයා
accessibility=සුළභ වීම | ළඟාවිය හැකි බව
accessible=කිට්ටුවිය හැකි | ගම්‍ය | ප්‍රවේශ්‍ය | පිවිසිය හැකි | බලා ගත හැකි | සුගම | සුලභ | ළඟා විය හැකි
accessio=ආබද්ධය
accession=අනුබැඳුම | ආබද්ධය | පරිග්‍රහණය | ප්‍රවේශනය | ප්‍රවේශය | ප්‍රාප්තිය | රජ්‍යයට පැමිණීම | ලාභය | ළඟා වීම
accessorial=උදව්කාර | සහායක
accessories=අතිරේක | උපකාරක | උපාංග
accessory=අතිරේක | අනුබැඳි | අනුබැඳිය | අපසහායක | අමතර | අමතරය | අවසහායක | ආබද්ධ | උපකරණය | උපකාරක | උපකාරී වූ | උපාංග | උපාංගය | වරදට උදව්කාරයා | වැඩිපුර | සම්බන්ධයක් ඇති | සහකාරක | සහායක
accidence=නිපාතනවිධිය | නෛරුක්තිකවිධි | වරනැගීම
accident=අත්වැරැද්ද | අනතුර | අහම්බය | අහඹුව | ආකස්මිකත්වය | ආපාතය | උපලක්ෂණය | හදිසි අනතුර | හදිසිය
accident-prone=අනතුරුවලට බඳුන් විය හැකි | අනතුරුවලට භාජනය විය හැකි
accidental=අහම්බ | අහම්බෙන් සිදු වූ | අහම්ඹ | අහඹු | ආකස්මික | ආපාත | බලාපොරොත්තු නොවූ
accidentalism=ආකස්මිකවාදය
accidentally=අහම්බෙන් | බලාපොරොත්තු නොවූ ලෙස | හදිස්සියෙන් | හදිසියෙන්
accissibility=ගම්‍යතාව
accission=රාජ්‍ය ප්‍රාප්තිය
acclaim=ගෞරවයෙන් පිළිගන්නවා | ප්‍රීතිඝෝෂා කරනවා | ප්‍රීතිඝෝෂා පවත්වනවා | ප්‍රීතියෙන් පිළිගන්නවා
acclamation=අත්පොළසන් දීම | ප්‍රශංසාව | ප්‍රස්තවනය | ප්‍රීතිඝෝෂාව
acclimatation=අනුකූලනය
acclimate=දේශගුණයට පුරුදු කරනවා
acclimatise=දේශගුණයට හුරු වෙනවා | දේශයට හුරු වෙනවා
acclimatization=අනුකූලනය | අවස්ථානුකූලනය | දේශගුණයට පුරුදු වීම | දේශානුකූලනය | පරිසරයට පුරුදු වීම | හැඩගැස්ම
acclimatize=පරිසරයට පුරුදු කරනවා
acclivity=කඳු බෑවුම | නැගුම
accolade=අත්‍යන්ත වර්ණනාව | ගෞරවයක් පිරිනැමීම
accommodate=ඉඩ දෙනවා | ඉඩ සලසනවා | උදව් වෙනවා | උපකාර කරනවා | ගැළපෙන සේ යොදනවා | නවාතැන් දෙනවා | ප්‍රතියෝජනය කරනවා | සපයා දෙනවා | සලසනවා | සැලසෙනවා
accommodating=අවස්ථානුරූප වූ | වුවමනා ඉටු කරන | සහනයක් දෙන
accommodation=අනුග්‍රහය | අවසාරණය | ඉඩ සැලසීම | ඉඩකඩ | උපකාරය | උපයෝගි කිරීම | පතියෝජනය | ප්‍රතියෝජනය | පිළිසරණ | මුදලක් ණයට දීම | ව්‍යවස්ථාපනය | වාසස්ථානය | විසුම් ඉඩ | හැඩ ගැසීම
accommodative=අනුග්‍රාහක | ඉඩ සලසන | උපකාරක
accomodation=ප්‍රතියෝජනය
accompaniment=සමග පවත්නා දේ | සහායනය
accompanist=වාදකයා
accompany=ඇරලනවා | එකට යනවා | එක්ක එනවා | එක්ක යනවා | එක්ව යනවා | කැටුව යනවා | පවතිනවා
accompanying=අනුගාමී | සහගත | සහචර
accomplice=අපරාධ සහායක | අපරාධසහායක | අපසහායක | අපසහායකයා | වරදෙහි හවුල් කාරයා | සහාපරාධියා | හවුල්කාරයා
accomplish=ඉටු කරනවා | ඉටුකරනවා | ඉෂ්ට කරනවා | සම්පූර්ණ කරනවා | සලසනවා | සාදා දෙනවා | සිද්ධ කරනවා | සිදු කරනවා
accomplished=ඉටු කළ | ඉෂ්ට වූ | නිපුණ | ප්‍රවීණ | විශාරද | සිද්ධ කළ | හසළ
accomplishment=අර්ථසිද්ධිය | ඉටුකිරීම | කෞශල්‍යය | නිපුණත්වය | සම්ප්‍රසාධනය | සම්පාදනය | සමාප්තිය | සිද්ධිය
accord=අන්‍යෙන්‍ය ගැළපීම | අනුමතිය | අනුමතිය දෙනවා | එකඟ වීම | එකඟ වෙනවා | එකඟකම | එකඟත්වය | එකඟවීම | ඒකමතිය | ඒකමිතිය | කැමැත්ත | ගැළපෙනවා | ගිවිස ගන්නවා | ගිවිසුම | දෙනවා | ප්‍රදානය කරනවා | යොදනවා | සම්මුතිය | සම්මුතියට එනවා | හුරුකම
accordance=අනුකූලතාව | එකඟත්වය | සම්මුතිය
accordant=අනුකූල
accordian=සංගීත භාණ්ඩයක්
accordingly=අනුකූල වන ලෙස | අනුසාරයෙන් | ඉක්බිති | එපරිදි | එම නිසා | එසේ | යථා පරිදි
accordion=එකෝඩින් නම් සංගීත භාණ්ඩය
accost=ආචාර කරනවා | නිමතනවා | වරදට කැඳවනවා | වෙත ගොස් අමතනවා | ළඟට ගොස් අමතනවා
accouchement=දරුවන් වැදීම | ප්‍රසූතිය
accoucheur=අකුෂේ | වින්නඹු
account=අගය කිරීම | අයවැය ලේඛනය | කතාන්තරය | ගණන | ගණනය කරනවා | ගණන් ගන්නවා | ගණන් තබනවා | ගණන් දෙනවා | ගණන් පෙන්වනවා | ගිණුම | ගිණුම් | ප්‍රවෘත්තිය | වග | වගඋත්තර කියනවා | වටිනාකම | ව්‍යාස | වාර්තාව | විස්තරය | හේතුව
account-book=ගිණුම්පොත
account-payee=ආදායකයාගේ ගිණුමට
account-receivable=ලාබනීය ගිණුම | ලභ්‍ය ගිණුම
accountability=ගිණුම් කටයුතු භාවය | ගිණුම් කිරීමේ වගකීම | වගකිව යුතු බව | වගකීම
accountable=පරිමේය | වග කියයුතු | වගකිවයුතු | විස්තර කළයුතු
accountancy=ගණක ශාස්ත්‍රය | ගණකාධිකරණය | ගණන් තැබීමේ වෘත්තිය
accountant=ගණක | ගණකාධිකාරි | ගණකාධිකාරී | ගිණුම්කරු
accounting=ගණකාධිකරණය | ගණනය | ගණන් තැබීම | ගණන් බැලීම | ගිණුම් තැබීම | ගිණුම්කරණය
accoutre=පළඳවනවා | සන්නද්ධ කරනවා
accoutred=පැළඳ | සන්නද්ධව
accoutrement=ආයිත්තම් | ඇඳුම් කට්ටලය | යුධායුධ කට්ටලය | සන්නාහ
accptance=ප්‍රතිග්‍රහණය | පිළිගැනීම
accredit=පවරනවා | පැවරෙනවා | පිළිගන්නවා | බලය පවරනවා | බලය ලබා දෙනවා | විශ්වාසය ලබා දෙනවා
accreditation=පැවරීම | පිළිගැනීම
accredited=ප්‍රතීත | පැවරුණු | පිළිගත් | බලය ලත් | බලයලත්
accreditor=බලදායී
accrescence=වර්ධනය | වැම
accrescent=වර්ධනය වන | වර්ධමාන | වැඩෙන
accrete=එකට වැඩෙනවා | වර්ධනය කරනවා
accretion=අධිවර්ධනය | අධිවර්ධය | උපචයනය | උපවයනය | එකතුවීම | වර්ධනය | වැඩි වීම | වැම | විවර්ජනය | විවර්ධනය
accretive=වර්ධනය වන | වැඩෙන
accrual=උපවතිය | එකතුවීම | රැස්වීම | ලැබීම | සමාගණනය
accrue=අත් වෙනවා | අත්වෙනවා | උපචය වෙනවා | එකතු වෙනවා | රැස් වෙනවා | ලැබෙනවා
accubation=කවිච්වයක ඇල වෙනවා
acculturation=ආසංස්කෘතිකරණය | සංස්කෘතික සමායෝගය | සංස්කෘතිකරණය | සාංස්කෘතික සම්පර්කය
accumbent=උපස්ථ | කවිච්වයක ඇල වූ | සහහොත්
accumulate=එකතු කරනවා | එකතු වෙනවා | ක්‍රමයෙන් වැඩි වෙනවා | ගොඩ කරනවා | ගොඩ වෙනවා | ගොඩගැහෙනවා | තැන්පත් වෙනවා | රැස් කරනවා | රැස් වෙනවා | සංචය වෙනවා
accumulated=උපවත | එකතුවූ | රාසිභූත | සංවත | සමාවත | සමුච්වත
accumulation=උපචය | එකතුව | ගොඩ | රාශිභූත වීම | රාශිය | රැඳීම | රැඳුම | වැඩි වීම | සංචයන | සංචිතය | සම්මුච්වත වීම | සමාචයන | සමාචයනය | සමාචායනය | සමූහය
accumulative=උපයන | එකතු කරන | එකතු වන | රැස් කරන | සංචයන | සමාචයනීය
accumulator=ඇකියුමියුලේටය | ඇකියුමිලේටරය | ඇකියුමුලේටරය | පරිගණකයෙහි මතකය | රාශිභූතය | රැස් කරන්නා | සංචායකය | සමාචයකය | සමාචායකය | සමාවායකය
accuntable=ගණන් දිය හැකි | තේරුම් කළ හැකි | වගකිය යුතු
accuracy=ඉතා නිවැරදි බව | නිරවද්‍යුතාව
accural=උපවත | උපාචයනය
accurate=අඩු වැඩි නැති | නිරවද්‍යු | නිවැරදි | සත්‍ය | හරි
accurately=නිරවද්‍යුව | හරියකාරව | හරියටම
accurse=ශාප කරනවා | හවනවා
accursed=නින්දිත | විනාශයට කැප වූ | ශාප ලත්
accurst=නින්දිත | විනාශයට කැප වූ | ශාප ලත්
accusatio=ඇකියුසාටියෝ | විශේෂ චෝදනාව
accusation=අපවාදය | චෝදනාව | දෝෂාරෝපණය | වාදාරෝපණය
accusative=කර්ම විභක්තිය | කර්මය | චෝදනාත්මක
accusatory=චෝදනා පමුණුවන
accuse=චෝදනා කරනවා | දොස් පවරනවා | දෝෂාරෝපණය කරනවා | වරද තබනවා
accused=චුදිත | චුදිතයා | චූදිතයා | චෝදතයා | චෝදිතයා | විත්තිකාරයා
accuser=චෝදකයා | පැමිණිලි කාරයා
accusingly=චෝදනා මුඛයෙන්
accustom=ඇබ්බැහි කරනවා | පරිසරයට හුරු වෙනවා | පුරුදු කරනවා | පුහුණු කරනවා
accustomed=ඇබ්බැහිවෙලා | නිරන්තර | පළපුරුදු ඇති | පුරුදු | සාමාන්‍ය | හුරු පුරුදු
ace=අති දක්ෂ | අතිදක්ෂ ගගනයාත්‍රිකයා | අනුමාත්‍රය | ආසියා කොළය | ඉතා සුළු ප්‍රමාණය | ඒකකය | තිත | ලක්ෂ්‍යෙයෙ
acellular=සෛල රහිත
acephalous=අකපාලික | හිස නැති | හිස රහිත
acephaly=අකපාලික භාවය
acerbate=කෝපකරනවා
acerbic=කර්කශ
acerbity=කෝපය | රළු බව
acerose=දහයියා වැනි | වී නණ්ඩු වැනි | සුව්‍යාකාර
acerous=අං නැති | සුව්‍යාකාර
acervulus=පොදිත්ත
acetabulum=ආවාටය | ඇසිටැබුලම
acetaldehyde=ඇසිටැල්ඩිහයිඩ්
acetamide=ඇසිටැමයිඩ්
acetamino=ඇසිටැමයිනෝ
acetanilidum=ඇසිටැනිලයිඩම්
acetarsol=ඇසිටාර්සෝල්
acetate=ඇසිටික් අම්ලයේ ලවණය | ඇසිටේට්
acetic=ආම්ලික
acetification=ඇසිටිකරණය
acetifier=ඇසිටි උපකරණය
acetimeter=ඇසිටිමානය
acetimetry=ඇසිටිමිතිය
acetolysis=ඇසිටිවිච්ඡේදනය
acetone=ඇසිටෝන් | ද්‍රව වර්ගයක්
acetphenitidin=ඇසිට්පෙනිටිඩින්
acetylarsan=ඇසිටිලාසාන්
acetylation=ඇසිටිල්කරණය
acetylene=ඇසිටිලින් | ඇසිටිලීන්
acetylide=ඇසිටිලයිඩ්
acetylization=ඇසිටිල්කරණය
acetylize=ඇසිටිල් කරනවා
ache=ඇදුම් කනවා | ඇදුම් දෙනවා | කකියනවා | කඩුත්තුව | කැක්කුම | පුපුරුගහනවා | රිදුම | රිදෙනවා | වේදනාව
achene=චර්මලය
achenodium=ද්විචර්මලය
achieve=ඉටුකර ගන්නවා | ඉෂ්ට කරගන්නවා | කුළුගන්නවා | මුදුන් පත් කර ගන්නවා | මුදුන් පමුණුවනවා | මුදුන්පත් කරගන්නවා | සම්පූර්ණ කරනවා | සාක්ෂාත් කර ගන්නවා | සාක්ෂාත් කරනවා
achievement=ඉටු කර ගැනීම | ක්‍රියාව | කාර්ය සිද්ධිය | ජය | ජයග්‍රහණය | මස්තකප්‍රාප්තිය | සාධනය | සිද්ධිය
aching=ඇදුම් දෙන | කකියන | රිදෙන
achlamydeous=අපරිපුෂ්ප
achlorhydria=ඒක්ලෝහයිඩ්‍රියාව
achondroplasia=ආකස්ථ්‍යඝටනය | එකොන්ඩොප්ලේසියාව
achondroplasty=එකොන්ඩොප්ලේසියාව
achromatic=අවර්ණ | අවර්ණක | අවර්ණවත් | නිර්වර්ණ
achromatin=ඇක්‍රොමටින්
achromatism=අවර්ණතාව
achromatopsia=වර්ණාන්ධතාව
achromic=නිර්වර්ණ
achromobacteria=ඇක්‍රොමොබැක්ටීරියා
achy=කැක්කුමකින් පීඩා ලබන | රිදුමකින් පීඩා ලබන
acicula=සුවිය
acicular=සුවිරූපි | සූවරූපී
acid-neutralizer=අම්ල උදාසීන කාරකය
acidic=ආම්ලික
acidification=අම්ල බවට හැරවීම | ආම්ලීකරණය
acidify=අම්ල බවට හරවනවා | ආම්ල කරනවා | ආම්ල කිරීම | ආම්ලී කරනවා | ඇඹුල් කරනවා | ඇඹුල් වෙනවා
acidimetry=අම්ලමිතිය
acidity=අම්ල | අම්ල පිත | අම්ල බව | ආම්ලිකතාව | ඇඹුල්ගතිය | ඇඹුල්බව | පිත් ගතිය
acidometer=අම්ලතාමානය | අම්ලමානය
acidosis=ආම්ලිකතාව | ලේ වල හෝ ශරීර පටකවල අම්ලගතිය
acidotrophic=ආම්ලපෝෂක
acidotus=හිදිඅක්
acids=අම්ල
acidulate=අල්පාම්ල කරනවා | ආම්ලික බවට පත් කරනවා
acidulated=අල්පාම්ලිත
acidulation=අල්පාම්ලනය
acidulous=ආම්ලික
acidylate=අම්ලනය කිරීම
acidylation=අම්ලනය
acierate=වානේ බවට හරවනවා
acies=දාරය
aciform=වී නණ්ඩු ආකාර | සුවිරූපී
ack-ack=ගගනයානා නාශක | ගගනයානානාශක
acknow=හඳුනා ගන්නවා
acknowledge=ඒත්තු ගන්නවා | කෘතඥතාව ප්‍රකාශ කරනවා | දන්වා යවනවා | පිළිගන්නවා | පිළිදන්නවා | ලැබුණු බව හඟවනවා
acknowledgeable=පිළිගත හැකි
acknowledgement=කුවිතාන්සිය | දැන්වීම | පිළිගැනීම | පිළිදැනුම | භාර ගැනීම | ස්තුතිය
acknowledgment=කුවිතාන්සිය | පිළිගැනීම
acknowledgor=පිළිදන්නා
aclinic=අනානතික
acmaesthesia=ඇක්මීස්තීසියාව | නිර්සංවේදිතාව
acme=අග | අග්‍රය | අග්‍රස්ථානය | කූටය | කෙළවර | මුදුන | ශ්‍රේෂ්ඨත්වය
acmite=ඇක්මයිට්
acne=අණිය | අණීය | ඇක්නිය
acnode=උදුගැටය | ඒකලිත ලක්ෂ්‍යය
acoasma=ධ්වනි භ්‍රමය
acolyte=අතවැස්සා | ඇබිත්තයා
aconative=අයත්නික | අයාත්නික
aconite=අතිවිඩයම් | ඇකනයිට් | කහ
acorn=සක් ගසේ ගෙඩිය | සක්ගෙඩිය
acosmism=අවිශ්වවාදය | ජගත්මිථ්‍යාත්වවාදය
acotyledon=අකොටිලය | නිර්බීජපත්‍රිකය
acotyledonous=අකොටිල | නිර්බීජපත්‍රික
acoumeter=ධ්වනිමානය | ශ්‍රාවමානය
acount=කථාන්තරය | ගණන | ගිණුම | විස්තරය
acountablity=ගණන් දිය හැකි බව | වගකිවයුතු බව
acoustic=ධ්වනි | ධ්වනික | නිශාමන | ශබ්දය හෙවත් ශ්‍රවණය පිළිබඳ වූ
acoustical=ධ්වනි | ධ්වනික | ධ්වනිය පිළිබඳ | ධ්වානික | ශබ්දය පිළිබඳ
acoustician=ධ්වනිවිද්‍යාඥයා
acoustics=ධ්වනි විද්‍යාව | ධ්වනිකය | ධ්වනිචාරය | ධ්වනිය | ධ්වනිවිද්‍යාව | නාද විද්‍යාව | ශබ්ද ශ්‍රවණය | ශබ්දවිද්‍යාව | ශ්‍රවණ විද්‍යාව | ශ්‍රවණ විෂයක
acquaint=අඳුන්වා දෙනවා | දන්වනවා | හඳුන්වා දෙනවා
acquaint-anceship=ඇඳුනුම්කම
acquaintance=අඳුනන අය | අඳුනන්නා | ඇඳිනීම | දැනීම | හඳුනන්නා
acquainted=ඇඳින ගත් | සුපුරුදු | හඳුනන
acquest=අත්පත් කර ගැනීම
acquiesce=අනුඥානුමත කරනවා | අනුමත කරනවා | එකඟ වෙනවා | විරුද්ධ නොවෙනවා
acquiescence=අනුඥානුමතිය | අනුමත කිරීම | එකඟ වීම | විරුද්ධ නොවීම
acquiescent=එකඟ වන | එකඟ වෙන | යටත් වන | විරුද්ධ නොවන
acquirable=අත් කර ගත හැකි | ලබා ගත හැකි
acquire=අත් කර ගන්නවා | අත්කර ගන්නවා | අත්පත් කර ගන්නවා | අත්පත්කර ගන්නවා | අරගන්නවා | උපයා ගන්නවා | උපාර්ජනය කරනවා | ලබා ගන්නවා | ලැබෙනවා
acquired=අත්කරගත් | අර්ත | ආගන්තුක | ආශ්‍රයෙන් ලත් | උපාර්ත | පරිවත | ලබා ගත්
acquirement=අයිතිකරගැනීම | අයිතිය | උගත් දෙය | ලාභය
acquisition=අත්කර ගැනීම | අත්කරගැනුම | අත්පත් කර ගැනීම | උපාර්ජනය | ප්‍රතිග්‍රහණය | ලබා ගැනීම | ලාභය
acquisitive=උපාර්ජන | එකතු කරගන්නා | කර්ම විභක්ති | රැස්කරන
acquisitiveness=උපාර්ජකතාව | උපාර්ජ්‍යතාව | කෑදරකම | ධනලෝභය | මසුරු බව
acquist=අත්පත් කර ගැනීම
acquit=ණයෙන් නිදහස් කරනවා | දෝෂමුක්ත කරනවා | නිදහස් කරනවා | නිදොසනවා | නිදොස් කරනවා | නිර්දෝෂණය කරනවා | මුදා හරිනවා | වගකීමෙන් නිදහස් කරනවා
acquittal=චෝදනාවෙන් නිදහස් වීම | දෝෂමුක්තිය | නිදහස් කිරිම | නිදහස් කිරීම | නිදහස් වීම | නිදොස් කිරීම | නිදොසුව | නිර්දෝෂණය
acquittance=කිදහස් කිරීම | ණයකින් නිදහස් වීම | ණයෙන් නිදහස් කිරීම | ණයෙන් නිදහස් වීම | නිතරණය | නිදහස් කරන කුවිතාන්සිය | වගකීමකින් නිදහස් වීම | වගකීමෙන් නිදහස් වීම | සෘණමුක්තිය
acquitted=ණයෙන් නිදහස් කළ
acramine=ඇක්‍රමින්
acrandrous=අග්‍රපුමංගී
acrandry=අග්‍රපුමංගීතාව
acre=අක්කරය
acreage=අක්කර ගණන | අක්කර ප්‍රමාණය | ඉඩමක ගණන | බිම් ප්‍රමාණය
acred=ඉඩම් ඇති
acrid=උග්‍ර | කටුක | කර්කශ | කසට | කහට | තියුණු
acridine=ඇක්‍රිඩින්
acridity=කටුක බව | කහට
acriflavin=ඇක්‍රිප්ලේවින්
acrimonious=කටුක | කර්කශ
acrimony=කටුක බව | කර්කශ බව | කර්කශ භාවය | පරුෂකම | රොස් පරොස් බව
acrinyl=ඇක්‍රිනිල්
acritical=නිර්විචාරක
acro-agnosis=අග්‍රාඥතාව
acroaesthesia=කෝටිසංවේදිතාව
acroamatic=මුඛ පරම්පරාගත | රහස්‍ය
acrobarics=ගුවන් කරණම්
acrobat=කඹේ නටන්නා | කරණම්කාරයා | කරනම් ගසන්නා | පිනුම් කාරයා | පිනුම් ගසන්නා
acrobatic=කරණම්කාර | කරනම් ගසන | පිනුම් ගසන
acrobatics=කරණම් ගැසීම | කරනම් | පිනුම් ගැසීම | මිරණම්
acrocarpous=අග්‍රඵලින
acroccephlic=උච්චශීර්ෂ
acrofugal=අග්‍රාපසාරී
acrogamous=අග්‍රයෝගී
acrogenous=අග්‍රජන්‍ය | අග්‍රවර්ධි
acrography=අග්‍රක ලිපිය
acrogynous=අග්‍රජායාංගී
acrogyny=අග්‍රජායාංගීතාව
acrolith=අග්‍රශිලාව
acromegaly=ඇක්‍රොමෙගලිය | කූට විකටය | කෝටි වෘද්ධිය
acrometer=ඇක්‍රොමීටරය
acromion=අංස කූටය | අංසකූටය | අංසාණිය
acronarcotic=අබිමාදකය
acronychal=ඇඳිරි වැටෙන | තරු පායන
acronym=අග්‍රක නාමය | සංකේතනාමය
acronymic=සංකේතනාමික
acroparesthesia=අග්‍රපාරවින්දනය
acropetal=අග්‍රාභිසාරි
acrophobia=උච්චභීතිකාව | උච්ඡුය භීතිකාව
acrophony=අග්‍රක ධ්වනිය
acropolis=පුරාණ ග්‍රිසියේ ප්‍රාසාදය
acroscopic=අග්‍රාභිමුඛ
acrospire=අංකුර දලුව
across=එගොඩ | එතර | එහා පැත්තේ | විරුද්ධව | සරස | සරසට | සරස් | හරස් | හරහට | හරහා | හුලහට
acrostic=අක්ෂර බන්ධනය | විවක්ෂිතාක්ෂරබන්ධය
acrotism=නාඩි නොවැටීම
acryl=ඇක්‍රිල්
acrylic=අම්ලයේ ව්‍යත්පන්නයකින් නිපදවන ලද බහුයවීයකයක්
acrylyl=ඇක්‍රිලිල්
act=අංකය | කතිකාව | කර්මය | ක්‍රියා කරනවා | ක්‍රියාව | කිරීම | පණත | පනත | බල පවත්වනවා | රඟ දක්වනවා | රූපණය කරනවා | වැඩ බලනවා | හැසිරෙනවා
act-change=දර්ශන පරිවර්තනය
act-character=ක්‍රියා චරිතය
acta=නිල වාර්තා
actability=ක්‍රියා කළ හැකි බව
acthargel=ඇක්තාර්ජල්
acting=අභිනය | ක්‍රියා කරන | ක්‍රියා කිරීම | රඟ දැක්වීම | රඟ පෑම | රඟපාන | රඟපෑම | රූපණය | වැඩ කරන | වැඩ බලන | වැඩ බැලීම
actinic=ඇක්ටිනික්
actinism=ඇක්ටිනිතාව
actinium=ඇක්ටිනියම්
actinometer=ඇක්ටිනෝමානය | ඇක්ටිනෝමීටරය | ඇක්ටීනෝමානය
actinomorphic=අරරූපී
actinomorphous=අරරූපී
actinomycosis=ඇක්ටිනොමයිකෝෂියාව | ඇක්ටිනොමයිකෝසිස්
actinon=ඇක්ටිනොන් | ඇක්ටිනෝන්
actinostele=අරස්ථුණය
actinotherapy=ඇක්ටිනෝ වකිත්සාව
actinouranium=ඇක්ටිනෝයුරේනියම්
actinozoa=ඇක්ටීනොසොවා
action=අභිනය | කටයුත්ත | කම | කර්මය | ක්‍රියා කිරීම | ක්‍රියාමාර්ගය | ක්‍රියාව | ක්‍රියාව | කාර්යය | කිරිය | නඩුව | නීතිකෘත්‍යය | ප්‍රවෘත්තිය | පැවැත්ම | සටන | හැසිරීම
actionability=කඩුකරතාව | නඩු පැවරිය හැකි බව
actionable=නඩු පැවරිය හැකි
actionist=ක්‍රියා කරන්නා | නඩු පවරන්නා
activate=උනන්දු කරනවා | ක්‍රියාත්මක කරනවා | කූද්දනවා | සක්‍රිය කරනවා | සක්‍රියනය කරනවා
activated=සක්‍රිය කළ | සක්‍රියායිත
activation=සක්‍රිය කිරීම | සක්‍රියනය
activator=සක්‍රියකය | සක්‍රියකාරකය
activatory=සක්‍රියකාරී
active=අනලස් | ඉක්මන් |  | උද්‍යෝගී | කඩිසර | කර්මණ්‍ය | කර්මශීල | ක්‍රියාකාරක | ක්‍රියාකාරි | ක්‍රියාකාරී | ක්‍රියාවෙහි යෙදුනු | ක්‍රියාශීලී | කාර්යශීලී | ප්‍රාණවත් | සකර්මක | සක්‍රිය
actively=උනන්දුවෙන් | කඩිසර ලෙස | ක්‍රියාකාරීව | සක්‍රිය ලෙස
activin=ඇක්ටිවින්
activism=ක්‍රියාවාදය
activities=ක්‍රියාකාරකම් | කාර්ය | වැඩ කටයුතු
activity=උනන්දුව | කටයුත්ත | කඩිසර කම | ක්‍රියා කාර කම | ක්‍රියාකාරකම | ක්‍රියාකාරිත්වය | ක්‍රියාකාරීත්වය | ක්‍රියාව | කාර්ය ඛණ්ඩය | කාර්යපටිපාටිය | සක්‍රියතාව | සක්‍රියය | සක්‍රීයතාව | සකෘතිය
actor=ක්‍රියා කරන්නා | කාරකයා | නළුවා | නාට්‍යකරුවා | විද්දත්
actress=නළඟන | නාටිකාංගනාව | නාටිකාව | නිළිය
acts=කිරීම්
actual=ඒකාන්ත | තථ | තථ්‍ය | දැන් පවත්නා | නියම | විද්‍යාමාන | සත්‍ය | සත්‍ය වූ | සබා | සැබෑ
actuality=ඇතිසැටිය | තත්ත්වාකාරය | තත්වාකාරය | තථ්‍යතාව
actualize=පුබුදුවනවා | ව්‍යක්ත කරනවා
actually=ඇත්ත වශයෙන් | ඇත්තෙන්ම | ඇති සැටියෙන් | ඒකාන්තයෙන් | තත්වාකාරයෙන් | සැබවින්
actuarial=ආයුගණක | ආයුෂ ලේඛක
actuary=ආයුගණක | ආයුගණකයා | ආයුෂ ගණක | පරිගණකයා | වන සංඛ්‍යා ලේඛනඥ
actuate=ඔදයනවා | ක්‍රියා කරවනවා | ක්‍රියාත්මක කරවනවා | ක්‍රියාවෙහි යොදවනවා | පොළඹනවා | මුල පුරනවා
actuator=ඔදයනය
acturial=ආයුගණක
acuity=තියුණු බව | තීක්ෂණතාව | තීව්‍රතාව | සියුම් බව
aculeate=උල් | දළ සහිත | සකණ්ටක
aculeiform=තුණ්ඩරූපී
acumen=තීක්ෂ්ණභාවය | නිපුණත්වය | නිපුණතාව | විචක්ෂණභාවය | විනිවිද පෙනීම | සියුම් නුවණ | සුලය
acuminate=අතිතීව්‍ර | උල් කරනවා | තියුණු කරනවා
acupuncture=කටු වක්ත්සාව | කටු වකිත්සාව | කටුවකිත්සාව
acutangular=තීව්‍රකෝණික
acute=උග්‍ර | උල් වූ | තද | තියුණු | තීක්ෂ්ණ | තීක්ෂ්ණාග්‍ර | තීව්‍ර | දරුණු | සැර | සියුම්
acutely=සියුම් ලෙස
acuteness=තියුණු වීම
acyclic=අචක්‍රීය | අවක්‍රීය
acylation=ඇසිල් කරණය
acyloin=ඇසිලොයින්
aczol=ඇක්සෝල්
ad=ක්‍රිස්තු වර්ෂයෙන් | වෙළඳ දැන්වීම | ස්වාමිදරුවන්ගේ වර්ෂයෙන්
ad-infinitum=අනන්තයට
adage=ආප්තවාක්‍යය | ආප්තෝපදේශය | පැරණියන්ගේ කියමන
adagio=ස්වර මාන්ද්‍යුය | සෙමින්
adamant=තද | දැඩි | දියමන්තිය | දෘඩ | නොනැමෙන | මුරණ්ඩු | වජ්‍රපාෂාණය | වජ්‍රය
adamantine=අතිශයින් දැඩි | ඉතා තද | කිසිසේත් වෙනස් නොවන | දුර්භේද්‍යු | මුරණ්ඩු | වජ්‍රමය
adapt=අනුරූප කරනවා | අනුවර්තනය කරනවා | අනුහුරු කරනවා | අනුහුරු වෙනවා | උපයෝග කරනවා | යොදා ගන්නවා | යෝග්‍ය කරනවා
adaptability=අනුවර්ත්‍යතාව | උපයෝජ්‍යතාව | යොදා ගත හැකි බව
adaptable=අනුවර්තනීය | අනුවර්ත්‍ය | උපයොජ්‍ය | උපයෝජ්‍ය | කර්මණ්‍ය | යොදා ගත හැකි
adaptatation=අනුවර්තනය
adaptation=අනුරූපණය | අනුවර්තනය | අනුවාදය | අනුහුරුව | උපයුක්තය | උපයුක්තිය | උපයෝජනය | ඡායානුවාදය | යොදා ගැනීම | යෝග්‍ය කර ගැනීම
adapted=අනුවර්තිත | උපයෝජ්‍ය | සුදුසු ලෙස යොදා ගත්
adapter=අනුවර්තකය | අනුහුරුකුරුව | අනුහුරුව | ඇඩප්ටරය | උපයුක්තකය | උපයුක්තය
adapting=අනුහුරු කිරීම
adaption=අනුවර්තනය | යොදා ගැනීම
adaptive=අනුවර්තක | අනුවර්තී | උපයෝජ්‍ය
adaptometer=අනුවර්තනමානය
adaptor=අනුවර්තක | අනුවර්තකය | අනුහුරුකුරුව | උපයුක්තකය | උපයුක්තය
adatom=ඇඩැටම
adaw=යටත් කර ගන්නවා
adaxial=අභ්‍යක්ෂ | උපාක්ෂ
add=එකතු කරනවා | එක් කරනවා
added=ආකල්‍යය | එකතු කළ යුත්ත | එක්කළ
addeem=තීන්දු කරනවා | තීන්දු දෙනවා
addend=ආකල්‍යය | ආකලිත | එකතු කළ ප්‍රමාණය | එකතු කළ සංඛ්‍යාව
addenda=උපග්‍රන්ථ
addendum=අතිරේක | අතිරේකය | අධිකලනය | ආකලිත | උපග්‍රන්ථය | පරිශිෂ්ට | පරිශිෂ්ටය | වැඩි දුරට කීම
adder=ආකලකය | එකතු කිරීමේ යන්ත්‍රය | එකතුකුරුව
addict=ආසක්ත | ආසක්ත වෙනවා | ආසක්තයා | ඇලී ගැලී සිටිනවා | ඇලී ගැලී සිටින්නා | ඇලෙනවා | කැප වෙනවා | ගැලෙනවා,ධූර්ත | ධූර්තයා | ධූර්තියා | ප්‍රසක්තයා | මුළුමනින් යෙදෙනවා | සොජ | සොජා
addicted=ආසක්ත | ඇබ්බැහි වූ | ඇලුණු | ප්‍රසක්ත | බැඳුණු | වාල් වූ | සොජ | සොජ වූ
addictedness=ඇලුණු බව | ධූර්ත බව | සොජ බව
addiction=ආසක්ත වීම | ආසක්තවීම | ආසක්තිය | ඇබ්බැහි වීම | ධූර්තවීම
addictive=ඇලෙන ගැලෙන
addition=ආකලනය | උපාර්තය | එකතු කිරීම | එකතු වූ දෙය | එකතුව | නවාංගය | සංකලනය
additional=අතිරේක | අධික | අමතර
additionally=අතිරේක වශයෙන් | අමතරව
additive=ආකල | ආකලන | ආකලනය
additivity=ආකල්‍යතාව
addle=කිලිටු | කිලුට | කුණ | කුණු කරනවා | කුණු වූ | විකල් වූ | විකල් වෙනවා | ශූන්‍ය | හිස්
addled=යල්පැනපු
addoom=තීන්දු කරනවා
address=අන්දම හෝ ලීලාව | අමතනවා | ආමන්ත්‍රණය | ඇමතීම | කතාබහ | කථා කරනවා | කථාව | දක්ෂකම | නම ගම | නමගම | නිවේදනය | පිටනම | පියෙදීම | පියෙදුව | පියොදනවා | බාර කරනවා | යොමුව | ලිපිනය | ලිපිනය ලියනවා | ලියුම් ආදිය යවනවා | විලාසම | ස්තුතිපත්‍රය
addresse=අමතන්නා | ලිපි එවන්නා
addressee=ලිපි හිමියා
addressograph=ලිපින ලියන යන්ත්‍රය
addressor=අමතන්නා | ලිපි එවන්නා
adduce=ඉදිරිපත් කරනවා | ගෙන හැර දක්වනවා | ගෙනහැර දක්වනවා | සමානයනය කරනවා
adduced=ඉදිරිපත් කළ | සමානිත
adducent=ඉදිරිපත් කරන | ගෙනහැර දක්වන
adducer=ඉදිරිපත් කරන්නා
adducible=ඉදිරිපත් කළ හැකි | ඉදිරිපත් කළහැකි | සමානේය
adduct=ආකලිතය
adducter=අභිනායකය
adduction=අභිනයනය | ඉදිරිපත් කිරීම
adductive=ඉදිරිපත් කරන
adductor=අභිනායක
adeem=දායාදය අහෝසි කරනවා
adeism=අදේවවාදය
adelphicpolyandry=භාත්‍රිය බහුපුරුෂත්වය
adelphous=කලාපික
ademption=දායාද වාරණය | දායාදය අහෝසි කිරීම | ලෙගසිය වැරිම
adenine=ඇඩිනීන්
adenitis=ගණ්ඨිදාහය | ගණ්ඨී ප්‍රදාහය
adenoid=ඇඩිනොයිඩය | ඇඩිනොයිඩ් ග්‍රන්ථිය | ගණ්ඨ්‍යාභ | ග්‍රන්ථ්‍යාභ
adenoids=ග්‍රන්ථ්‍යාභ ප්‍රදාහය
adenoma=ඇඩිනෝමාව
adept=අති සමර්ථයා | අශෛක්ෂ | දක්ෂයා | නිපුණ | නිපුණු | ප්‍රවීණ | පුහුණු | භව්‍ය
adeptness=දක්ෂ බව | නිපුණත්වය | ප්‍රවීණත්වය
adequacy=ප්‍රමාණවත් බව
adequate=ප්‍රමාණවත් | සෑහෙන | සුදුසු
adequately=ප්‍රමාණවත් ලෙස | ප්‍රමාණවත්ව
adequateness=ප්‍රමාණවත් බව
adequation=සමර්ථනය
adfluxion=අභිස්‍යන්දනය
adglutinate=ශ්ලිෂ්ටවීම
adhatoda=ආඩතෝඩා
adhehypothesis=තදර්ථ උපන්‍යාසය
adhere=ආසක්ත වෙනවා | ඇලෙනවා | පිළිපදිනවා | සංසක්ත වෙනවා | ස්ථිරව සිටිනවා
adherence=ඇල්ම | ඇලීම | පිළිපැදීම | බද්ධතාව | විශ්වාසය
adherent=ඇලී සිටින | පාක්ෂික | පාක්ෂිකයා | පිළිපදින | භක්තිකයා | සංසක්ත
adherer=පාක්ෂිකයා | පිළිපදින්නා
adhesion=ආසක්තිය | ඇලීම | පිළිපැදීම | සංලග්නය | සංසක්තිය
adhesive=ආසක්ත | ආසක්ත ද්‍රව්‍යය | ඇලෙන | ඇලෙන සුලු | පාප්ප | මැලියම් | ලාටු | සංලග්න | සංසක්ත
adhesiveness=ආසක්තතාව | ඇලෙන ගතිය
adhesives=ආසක්තක | ඇලවුම් ද්‍රව්‍ය
adhibit=අමුණනවා | භාරගන්නවා
adhibition=ඇමිණීම | බාර ගැනීම
adhocracy=ආවස්ථික වාදය
adiabatic=ස්ථීරතාපී
adiactinic=ප්‍රතිඇක්ටිනික්
adiapheron=අත්‍යවශ්‍ය නොවූ ව්‍යවහාරය
adiate=උරුමය ප්‍රතිග්‍රහණය කරනවා | උරුමය බාර ගන්නවා
adiathermanous=අපාරතාපක
adichogamy=සමපරිණතිය
adicity=සංයුජතාව
adient=අභිහාරී
adieu=ආයුබෝවන් | ආශිර්වාද කිරීම | දේවාශීර්වාද ලැබේවා | සමුගැනීම | ස්වස්ති
adion=ඇඩායනය
adipic=මහත | මේදස්වී
adipocellulose=ඇඩිපොසෙලියුලෝස්
adipose=තරබාරු | තුල | පින | මහත | මේදස්වී | ශරීරයෙහි තෙලෙන් සෑදුණු
adiposity=තරබාරු කම
adit=දෝනා කට | දෝනාව
adjacency=අසල පිහිටීම
adjacent=අසල පිහිටි | ආසන්න | ඊළඟ | එක ළඟ | තදාසන්න | බද්ධ | යාබද
adjacent-channel=යාබද නාලිය
adjectival=ගුණාත්මක | පටිපාටිය
adjectivally=නාම විශේෂණ වශයෙන්
adjective=ගුණපදය | ගුණවචනය | නාමවිශේෂණ | නාමවිශේෂණය | විශේෂණය
adjectively=නාම විශේෂණ වශයෙන්
adjoin=යා කරනවා | යා වෙනවා | යාබද | යාව තිබෙනවා | සම්බන්ධ වෙනවා
adjoined=ආබද්ධ
adjoining=ආසන්න | තදාශ්‍රිත | නිබද්ධ | යා | යා වූ | යාබද | යාව
adjoint=සම්බද්ධය
adjourn=අත්හිටුවනවා | කලකට අත්හිටවනවා | කල් තබනවා | කල් දමනවා | විරාමය කරනවා
adjournment=අඩාලව කල් තැබීම | කල් තැබීම | කල් දැමීම | විරාමය
adjudge=තීන්දු කරනවා | තීරණය කරනවා | පසිඳනවා | විනිශ්චය කරනවා
adjudgement=තීන්දුව | පසිඳුම
adjudgment=තීන්දුව
adjudicate=අභිනිර්ණය කරනවා | තීන්දු කරනවා | තීරණය කරනවා | නියම කරනවා | විනිශ්චය කරනවා | විනිශ්චය කරනවා | විනිසනවා | විභාග කරනවා
adjudication=අභිනිර්ණය | තීන්දු කිරීම | තීරණය | නියම කිරීම | විනිශ්චය | විනිශ්චය කිරීම | විනිශ්චයනය | විනිසීම
adjudicator=අභිනිර්ණක | ප්‍රාශ්නික | විනිශ්චය කරන්නා
adjudocator=විනිශ්චයකරුවා
adjugate=සම්බද්ධය
adjunct=අනුබද්ධ | අනුබද්ධය | අමතර දෙය | එකතු කළ දෙය | ගුණපදය | ප්‍රතිබද්ධ | පූරණ | පූරණය | විශේෂණ පදය | සහකාර
adjunction=අනුබද්ධ කිරීම
adjunctive=අනුබද්ධ
adjunctively=අනුබද්ධ වශයෙන්
adjunctly=අනුබද්ධ වශයෙන්
adjuration=උදක්ම ඉල්ලීම | දිවුරවීම | ශපථනය
adjuratory=දිවුරවන
adjure=උදක්ම ඉල්ලනවා | දිවුරවනවා
adjuring=දිවුරවන
adjust=අනකූල කරනවා | අනුයෝජනය කරනවා | ආරවුලක් බේරනවා | ගලපනවා | ගළපනවා | පිළියෙල කරනවා | සකසනවා | සකස් කරනවා | සමාදාන කරනවා | සැකසීම | සීරුමාරු කරනවා | සීරුමාරු කිරීම | හරි ගස්සනවා | හරිගස්සනවා | හැඩ ගැසෙනවා
adjustable=ගැළපිය හැකි | සකස් කළ හැකි | සැකසිය හැකි | සැකැසිය හැකි | සීරුමාරු | සීරුමාරු කළ හැකි
adjustable-mirror=සීරුමාරු කළ හැකි දර්පණය
adjustable-square=රූටවන මට්ටම් ලෑල්ල
adjuster=ඇජස්ටරය | ගළපන්නා | පරීක්ෂක | සකස් කරන්නා | සැකසුම් යන්ත්‍රය | හරි ගස්සන්නා
adjusting=සැකසීම | සැකසුම් | සීරුමාරු
adjustment=අනුකුලනය | අනුකූලනය | ගැලපීම | ගැළපීම | යථාවත් කර ගැනීම | සකස් කිරීම | සමාධානය | සමායෝගය | සැකසීම | සැකසුම | සැකැසීම | සැකැසුම | සීරු මාරුව | සීරුමාරු කිරීම | සීරුමාරුව | හරි ගැස්සීම | හැඩ ගැසීම
adjutage=අපස්‍රාවකය
adjutancy=සහායක බව
adjutant=අණ දෙන නිලධාරියාගේ සහායක | අණ දෙන නිලධාරියාගේ සහායකයා | විශාල කොක්කු විශේෂයක් | සහකාරයා
adjuvant=උපකාරක | උපකාරකය | උපවර්ධකය | සහකාරකය | සහායක | සහායකයා
adman=දැන්වීම් පළ කරන්නා | වෙළඳ දැන්වීම් කරු
admeasure=කොටස් කරනවා | ප්‍රමාණ කරනවා
admeasurement=කොටස් බෙදීම | විභජනය
adminiotrant=පාලක
administer=අද්මිනිස්ත්‍රාසනය කරනවා | ක්‍රියාවෙහි යොදනවා | පරිපාලනය කරනවා | පාලනය කරනවා | පාලනය දෙනවා | බෙදා දෙනවා | සකස් කොට දෙනවා | සපයා දෙනවා
administrable=පාලනය කළ හැකි | බූදල් කළ හැකි
administrant=පාලකයා
administrate=පාලනය කරනවා
administration=අද්මීනිස්ත්‍රාසනය | අද්විනිස්ත්‍රාසනය | අවචරණය | ආණ්ඩුව | තන්ත්‍රය | පරිපාලනය | පාලක මණ්ඩලය | පාලනතන්ත්‍රය | පාලනය | ශාසනය | සංවිධානය
administrative=පාලක | පාලන | සංවිධානාත්මක
administrator=අද්මිනිස්ත්‍රාත්කාරයා | අද්මිනිස්ත්‍රාසි කාරයා | අද්මිනිස්ත්‍රාසිකරු | කළමණාකාරයා | පරිණායක | පරිපාලක | පරිපාලකයා | පාලකයා | බලකාරයා | බූදල් බලකාරයා | භෝජක
administratrix=අද්මිනිස්ත්‍රාසිකාරිය | පාලිකාව
admirable=ප්‍රශංසනීය | ප්‍රශසනීය | මනහර | මනෝහර
admirably=ප්‍රශංසනීය ලෙස | මනෝහර ලෙස
admiral=නාවික සේනාපති | නාවුක සේනාධිපති | නාවුක සේනාධිපතිගේ නැව
admiralship=නාවික සේනාපති ධූරය
admiralty=නෞකා බලස්ථානය
admiration=අගය කිරීම | උතුම් කොට සැලකීම | ප්‍රසාදය
admire=අගය කරනවා | උතුම් කොට සලකනවා | ගෞරවයෙන් සලකනවා | ප්‍රශංසා මුඛයෙන් සලකනවා | ප්‍රසාදය දැක්වීම | ප්‍රීතියෙන් සලකනවා
admirer=ගෞරවයෙන් සලකන්නා | ප්‍රශංසා කරන්නා | ප්‍රසාදියා
admissable=ඉදිරිපත් කළ හැකි | ඒත්තු ගත හැකි | පිළිගත හැකි
admissibility=ආවිශ්‍යතාව | ඇතුළත් කර ගත හැකි බව | ඇවීසියාව | පිළිගත හැකි බව | පිළිගත හැකි බව
admissible=ආවිශ්‍ය | ඇවිසි | පිළිගත හැකි | බාරගත හැකි
admission=ආවිශ්‍යය | ඇතුල් කර ගැනීම | ඇතුල් වීම | ඇතුල් වීමට ගාස්තුව | ඇතුල්වීම | ඇතුල්වීමට අවසරය | ඇතුල්වීමේ ගාස්තුව | ඇතුලු කිරීම | ඇතුළත් කිරීම | ඇවිසිය | ඒත්තු ගැන්වීම | පිවිසුම | පිළිගැනීම | බාර ගැනීම | භාර ගැනීම
admit=ආවේශනය කරනවා | ඇතුල් කර ගන්නවා | ඇතුල් කරනවා | ඇතුළත් කරනවා | ඇතුළු කරගන්නවා | ඇවිසිනවා | ඒත්තු ගන්නවා | පිළිගන්නවා | බාර ගන්නවා | වැද්ද ගන්නවා
admittable=ඇතුල් කර ගත හැකි | පිළිගත හැකි | බාර ගත හැකි
admittance=ඇතුල් වීමේ අවසරය | ඇතුල් වීමේ බලය | ඇතුල්වීම | ප්‍රවේශය | ප්‍රවේශ්‍යතාව
admitted=ඇතුළු කළ | ඒත්තු ගත් | පිළිගත්
admittedly=ඇත්තට ම | ඇත්තටම | නිසැකව ම | නිසැකවම
admix=කලවම් කරනවා | කලවම් වෙනවා | මිශ්‍ර කරනවා | මිශ්‍ර වෙනවා
admixture=අනුපාතය | කලවම | මිශ්‍රණය | සංකරය | සම්මිශ්‍රණය
admonish=අවවාද කරනවා | ඔවා දෙනවා | දැනමුතුකම් දෙනවා
admonishment=අවවාදය
admonition=අනුශාසනය | අනුශාසනාව | අවවාදය | උපදේශය
admonitive=අවවාදාත්මක
admonitor=අනුශාසකයා | උපදේශකයා
admonitory=අවවාදාත්මක | උපදේශාත්මක
adnascens=අහිලග්නතාව
adnascent=අභිලග්න | අභිලග්නව වැඩෙන
adnate=අභිලග්න | ආලග්න
adnation=අභිලග්න
adnexed=උපලග්න
ado=කරදරය | කලබලය | කලහය | කෝලාහලය
adobe=ඇඩෝබ් | මෝඩ ගඩොල | මෝඩ ගඩොල්
adolescence=ගැටවර බව | ගැටවර විය | ගැටවර සමය | තරුණ කාලය | තරුණ වයස | නව යෞවනය | නවයොවුන් විය | නවයෞවනය | යුවනෝදය | යොවුන් විය | යෞවනය | යෞවනෝදය
adolescent=ගැටවර | ගැටවරයා | තරුණ | තරුණයා | නව යෞවන | නවයොවුන් | නවයොවුන් ගැටවර | නවයෞවන | නවයෞවනය | නවයෞවනයා | නහඹු | නැහැඹි | යුවනෝදය | යුවනෝදිත | යොවුන් | යෞවන | යෞවනයා | යෞවනෝදය | යෞවනෝදිත
adopt=අපත්‍යීකරණය කරනවා | උපයොදනවා | කුලවද්දනවා | තෝරා ගන්නවා | දරුකමට හදා ගන්නවා | පිළිගන්නවා | භාර ගන්නවා | යොදා ගන්නවා | සම්මත කරනවා
adoptable=තෝරාගත්
adopted=අපත්‍යීකෘත | හදා ගත්
adoptee=අපත්‍යීකෘතයා
adopter=පිළිගන්නා | යොදා ගන්නා | හදාගන්නා
adoptio=ඇඩොප්ටියොව | නිල කුලවැද්දුම
adoption=අපත්‍යීකරණය | කුලවැද්දුම | තෝරා ගැනීම | දරුකමට හදාගැනීම | දාරක ග්‍රහණය | ප්‍රතිග්‍රහණය | පිළි ගැනීම | පිළිගැනීම | භාර ගැනීම | භාරගැනීම | යොදා ගැනීම | සම්මත කිරීම
adoptionism=අපත්‍යීකරණය
adoptive=අපත්‍යීකාරක | කුලවද්දන
adoptor=අපත්‍යීකාරකයා
adorable=අත්කෘෂ්ට | උත්කෘෂ්ට | උපාස්‍ය | උසස් | ප්‍රපූජ්‍ය | පූජනීය
adorably=උසස් ලෙස | පූජනීය ආකාරයෙන්
adoration=උපාසනය | උසස් භක්තිය | නමස්කාරය | ප්‍රපුජන්‍ය | මහත් ආදරය | සමර්ජණය
adore=අගය කරනවා | ආදර ගෞරව කරනවා | උපාසනය කරනවා | ගෞරව කරනවා | නමස්කාර කරනවා | ප්‍රපූජනය කරනවා | මහත් ආලයෙන් සලකනවා | වඳිනවා
adored=පූජා කරන ලද
adorer=උපස්ථ | උසස් කොට සලකන්නා | ගෞරව කරන්නා | ප්‍රපූජක | ප්‍රේම කරන්නා | පූජා කරන්නා
adorn=අලංකාර කරනවා | ගවසනවා | පලඳිනවා | පළඳනවා | පළඳවනවා | සරසනවා | සැරසෙනවා | හොබවනවා
adorned=ප්‍රතිමණ්ඩිත | මණ්ඩිත | ලකුළු | විභූෂිත | සමලංකෘත | සැදුණු | හං | හන් | හෙබි
adornment=අලංකාර කිරීම | අලංකාරය | ප්‍රසාධනය | පැළඳවීම | භූෂණය | විභූෂණය | සැරසීම | සැරසුම
adpress=තද කරනවා | වද්දනවා | හිප්පවනවා
adpressed=ආලග්න
adrad=බියකරු | භයංකර | භයානක
adred=බියකරු | භයංකර | භයානක
adrenal=අධිවෘක්ක | වකුගඩුවබද
adrenalectomy=අධිවෘක්ක විච්ඡේදනය
adrenalin=ඇඩ්‍රිනලින් | ඇඩ්‍රෙනලින් නම් හෝමෝන
adrenin=ඇඩ්‍රිනින්
adret=හිරු මූණත
adretto=හිරු මූණත
adrift=අසරණ | නිදහස් | නිදැල්ලේ | නිරාලම්බව | පාවෙන | පාවෙමින් අසරණව | පිළිසරනක් නැතිව | බැම්මෙන් මිදී පාවෙන
adrogatio=අදිකුලවැද්දුම
adrogation=අදිකුලවැද්දුම | පුත්‍රොක්තිය
adrogator=පුත්‍රවක්තෘ
adroit=චතුර | දක්ෂ | නිපුණ | පේශල | විචක්ෂණ | හපන්
adroitness=දක්ෂභාවය
adry=පිපාසයෙන් | පිපාසිත | වියළි | වියළිව
adscendent=උද්‍රෝහක
adsorb=අධිශෝෂණය කරනවා | අධිශෝෂණය වෙනවා | උරා ගන්නවා
adsorbate=අධිශෝෂිතය
adsorbent=   අධිශෝෂක | අධිශෝෂකය
adsorption=අධිශෝෂණය
adsorptive=අධිශෝෂක
adstringent=කහට
adtidote=අගද
adularia=ඇඩියුලේරියා
adulate=ඉච්චා කියනවා | බොරුවට පසසනවා
adulaterate=කලවම් කරනවා | බාල කරනවා
adulation=අධික ප්‍රශංසාව | ඉච්චාව | චාටුව | වංචනික ප්‍රශංසාව
adulator=ඉච්චාකාරයා
adulatory=ඉච්චා සහගත | ප්‍රශංසාත්මක
adult=දැනුම් තේරුම් ඇති | මේරූ | වයසක | වයස් පිරුණු | වයස්කයා | වයස්ථයා | වැඩිවිය පැමිණි තැනැත්තා | වැඩිහිටි | වැඩිහිටියා | වෘද්ධ | සුහුඹුලා
adulterant=බාල කිරීමට මිශ්‍ර කරන දෙය | බාලකාරකය
adulterate=අපමිශ්‍ර කරනවා | කලවම් කරනවා | කළවම් කරනවා | බාල කරනවා
adulterated=අපමිශ්‍රිත | කළවම් | බාලකළ
adulteration=අපමිශ්‍රණය | බාල කිරීම | බාලකිරීම
adulterator=යමක් බාල කරන්නා
adulterer=අනාචාරයේ හැසිරෙන්නා | අනාචාරියා | පරදාර සේවනය කරන්නා
adulteress=පරපුරුෂ සේවනය කරන්නී
adulterine=අනාවාරජ
adulterous=අනාචාරි | පරදාර කර්මයෙහි යෙදුණු | පරදාර සේවනයේ යෙදෙන | බාල කරන
adultery=අනාචාරය | කාමමිථ්‍යාචාරය | පරදාර සේවනය
adulthood=වැඩිහිටි බව | වැඩිහිටිබව
adumbrate=ඉඟියෙන් පෙන්නුම් කරනවා | කලින් අඟවනවා | ඡායාවක් පෙන්වනවා | මුවා කරනවා
adumbration=ඇඟවීම | ඡායාවක් දැක්වීම | මුවා කිරීම
adust=තැවුණු | තැවෙනවා | දැවුණු | දැවෙනවා | පිළිස්සුණු | පිළිස්සෙනවා
advalorem=වටිනාකම අනුව
advance=අත්තිකාරම | අභික්‍රමණය | ආක්‍රමණය | ඉදිරි | ඉදිරිපත් කරනවා | ඉදිරියට පමුණුවනවා | ඉදිරියට යනවා | ඉදිරියට යාම | ඉදිරියට යෑම | උසස් වෙනවා | ණය දෙනවා | ණය මුදල | ණයට මුදල් දෙනවා | දියුණු කරනවා | දියුණු වෙනවා | දියුණුව | ප්‍රගතිය | ප්‍රගමනය | පැමිණෙනවා | පෙර යවනවා | පෙරට ගැනීම | බැංකු ණය | මිල නැගීම | මිල වැඩි කිරීම | සච්චකාර
advanced=ඉදිරියට පැමිණි | ඉහළ | උසස් | දියුණු | දුර ගිය | දුරගිය | ප්‍රගත
advancement=අත්තිකාරම | අභිවර්ධනය | උන්නතිය | උසස් වීම | කලින් මුදල් දීම | දියුණුව | ප්‍රගතිය | පූර්ව දීමනාව | වැඩි දියුණුව
advantage=ජය | ලාභය | ලාභයක් සලසනවා | වාසිය | වාසියක් සලසනවා
advantageous=ප්‍රයෝජනවත් | ලාභ ඇති | ලාභ ලැබෙන | වාසි ඇති | වාසිදායක | වාසිසහගත | වැඩදායක
advection=අභිවහනය
advective=අභිවාහී
advene=එකතු වෙනවා | ළඟාවෙනවා
advent=පැමිණීම | ළඟා වීම
adventism=ක්‍රිස්තුස්වහන්සේගේ සහසු වර්ෂය අත ළඟ යැයි දෙසන
adventist=ජේසු ධර්මය අදහන්නා
adventitious=අනියම් | අහම්බෙන් ඇති වන | අහඹු | ආගන්තුක | පිටස්තර
adventive=ආගන්තුක | තාවකාලික
adventure=අනතුරකට මූණ පානවා | අවදානම | දුෂ්කර වූ ක්‍රියාව | නිර්භීත වූ ක්‍රියාව | ප්‍රයත්නය | ප්‍රයාණය | වික්‍රමය
adventurer=කපටි පුද්ගලයා | වික්‍රමිකයා | සූර පුද්ගලයා
adventuresome=අවදානම් සහිත
adventuress=කපටි ස්ත්‍රිය
adventurist=අවදානම් ප්‍රයත්න දරන්නා
adventuristic=අවදානම් සහගත
adventurous=අනතුරු සහිත | නිර්භීත | සාහසික
adverb=ක්‍රියා විශේෂණය | ක්‍රියාවිශේෂණය
adverbial=ක්‍රියා විශේෂණ | ක්‍රියාවිශේෂණ
adversaria=බාලපොත | මිශ්‍ර සටහන්
adversarius=ප්‍රතිපාක්ෂික
adversary=එදිරිකාරයා | පසමිතුරා | ප්‍රතිපාක්ෂික | ප්‍රාතිකූලිකයා | විරුද්ධකරු | විරුද්ධකාරයා
adverse=අහිතකර | එදිරි | දුහ්ඛිත | පටහැනි | ප්‍රතිකූල | ප්‍රතිකූලක | පීඩාකර | විරුද්ධ | සතුරු | හානිකර
adversely=විරුද්ධව
adverseresult=රිටුදොස
adversity=අහේතුව | ආපත්තිය | ආපදාව | විපත | විපත් කාලය
adversus=එදිරිව
advert=මතක් කරනවා | මනෝයෝජනය කරනවා | යොමු කරනවා | සිහියට නඟනවා
advertence=අප්‍රමාදය | අවධානය | සිත යොමු කිරීම
advertency=අවධානය | උනන්දුව
advertent=අවික්ෂිප්ත | නොපමා
advertise=දන්වනවා | දැන්වීම් පළ කරනවා | පතළ කරනවා | ප්‍රකාශ කරනවා | ප්‍රචාරණය කරනවා | ප්‍රචාරය කරනවා | ප්‍රසිද්ධ කරනවා | විඥාපනය කරනවා | විනවනවා
advertisement=දැන්වීම | නිවේදනය | ප්‍රකාශ කිරීම | ප්‍රකාශය | ප්‍රචාරක දැන්වීම | ප්‍රචාරකය | ප්‍රචාරණය | ප්‍රචාරය | විඥාපනය | විනැවුම
advertisements=දැන්වීම් | ප්‍රචාරය
advertiser=දැන්වීම් පළ කරන්නා | දැන්වීම්කරුවා | ප්‍රචාරක | ප්‍රචාරකයා
advertisetment=පළ කිරීම | වෙළඳ දැන්වීම
advertising=දැන්වීම් ප්‍රචාරය | ප්‍රචාර කිරීම | ප්‍රචාර කිරීම | ප්‍රචාරණය | ප්‍රචාරය | වෙළඳ ප්‍රචාරණය
advertisment=වෙළඳ දැන්වීම
advesary=එදිරිකාරයා | විරුද්ධකාරයා
advew=බලනවා
advice=අනුශාසනය | අනුශාසනාව | අවවාදය | ආදේශය | උපදෙස් | උපදේශය | ඔවදන් | ඔවා | කල්පනාව | කියමන | ගුණදැනමිතිකම | ගුරුකම | ගුරුහරුකම | දැනමිතිකම | දැනමුතුකම | දැන්වීම | නිවේදනය | පාඩම | වදන | ශාසනය
advisability=ඥානාන්විතභාවය | යෝග්‍යතාව | සුදුසු බව
advisable=අනුශාසනීය | උපදේශණීය | උවත | ඥානාන්විත | නුවණට හුරු | යෝග්‍ය | සුදුසු
advisably=කල්පනා කොට බලා | සනෑකමින් | සාවධානව
advise=අනුශාසනය කරනවා | අවවාද කරනවා | උපදෙස් දෙනවා | ඔවා දෙනවා | දැනුම් දෙනවා | සැල කරනවා
adviser=අනුශාසක | උපදේශක | උපදේශකයා
advisor=අනුශාසක | උපදේශක | පෙරෙවියා
advisory=උපදෙස් දෙන | උපදේශක | උපදේශාත්මක
advocacy=අධි නීතීඥ කාර්යය | අධිනීතිඥ කාර්යය | පක්ෂව කථා කිරීම | වෙනුවෙන් කථා කිරීම
advocate=අද්වකාත් | අධවාචනය කරනවා | අධිනීතිඥ | අධිනීතිඥයා | අධිනීතිඥවරයා | අධිවක්කෘ | අධිවදන් දෙනවා | අධිවාචකයා | නීතිවේදියා | පක්ෂව කථා කරනවා | පක්ෂවාදියා | වෙනුවෙන් කථා කරනවා
advowson=පල්ලිභාර අයිතිය
adynamia=ශක්තිහීනතාව
adytum=ඇතුල්ගැබ
adz=වෑය
adze=අහිනවා | වාශීය | වාසිය | වෑ | වෑය
aechynite=ඊකනයිට්
aecial=ඊසි
aecidial=ඊසි
aecidiolum=ඊසිඩියෝලය
aecidiospore=ඊසිඩිබීජාණුව
aecidium=ඊසිය
aeciospore=ඊසිඩිබීජාණව
aecium=ඊසිය
aecology=පිසර විද්‍යාව
aedes-albopictus=ඊස් ඇල්බොපික්ටස්
aedes-vittatus=ඊස් විටාටස්
aegerite=ඊගරයිට්
aegirite=ඊගරයිට්
aegis=අනුග්‍රහය | අනුබලය | ආරක්ෂාව | පලිහ
aegrotat=අසනීප වී විභාගයට පෙනී නොසිටි සරසවි සිසුවකුට දෙන සහතිකය
aenigmatite=ඊනිග්මටයිට්
aeolian=වායව | සුළඟින් උසුලනු ලබන
aeolotropic=අසමවර්ත | අසමසාර්වදිශ | අසාර්වදිශ
aeon=කප | කල්පය | කාලාන්තරය | දීර්ඝකාලය | යුග | යුගය
aeonite=ඉයොනයිට්
aequalitas=සාමානත්වය
aequilateral=සමපාද
aequum=සාම්‍යය
aerate=වායු ගන්වනවා | වායු පුරවනවා | හුළං කවනවා
aeration=වාකැවීම | වාතනය | වාතය වැද්දීම | වායු කැවීම | වායු පිරවීම
aereation=වා කැවීම | වාතනය
aerenchyma=වාතස්තරය
aerial=අද්‍රව්‍ය | අහස් | අහස් කම්බිය | අහසෙහි වූ | ආකාශ | ඇහැසි | ඇහැසිය | ඉතා සියුම් | උස්ව | උස්ව පිහිටි | ගුවන් | ගුවන් කම්බිය | නභෝගත | වායව | වායුමය
aerie=මාංශභක්ෂක කුරුල්ලන්ගේ කූඩුව | රාජාලි කූඩුව
aeriform=පුහු | වායුමය | වායුරූපමය
aerobatics=ගුවන් කරණම්
aerobatics=ගුවන් කරණම්
aerobe=වායුවියා | සවායු වියා | සානිලයා
aerobic=සවායු
aerobiont=සවායු වියා
aerobioscope=එයරොබියොස්කෝපය
aerobiosis=සවායුව | සවායුවනය
aerobiotic=සවායුවි
aerobomb=ගුවනින් හෙළන බෝම්බය
aerobus=ගුවන් බසය
aerodrome=අහස් යාත්‍රාංගනය | ගගන යාත්‍රාංගණය | ගගනයාත්‍රාංගණය | ගුවන් තොට | ගුවන් තොටුපළ | ගුවන් තොටුපොල
aerodynamics=වායු ගති විද්‍යාව | වායු ගතිකය | වායුගති විද්‍යාව | වායුගතිකය | වායුගතිවිද්‍යාව
aerofoil=වාපත
aerogram=වායු ලේඛය
aerogramme=ගුවන් ලියමන
aerograph=වායු ලේඛනිය
aerography=වායුගුණ විද්‍යාව | වාරෝඛනය
aerolite=අහසින් වැටෙන ගල | උත්පාතය | උල්කාපාතය | එයරොලයිට්
aerolith=උල්කාපාතය
aerolithology=උල්කාපාතවිද්‍යාව
aerology=වායු විද්‍යාව
aerometal=එයරොමෙටල්
aerometer=වායුඝනත්වමානය
aeromorphosis=වාතරූපනය
aeron=එයරොන්
aeronaut=අහස්‍යාත්‍රිකයා | ගගනගාමියා | ගුවන් නැවියා
aeronautical=ගගනගාමී
aeronautics=අවකාශ තරණය | අහස්නැව් පැදවීමේ ශාස්ත්‍රය | ආකාශ යාත්‍රා විද්‍යාව | ගගනයාත්‍රාවිද්‍යාව | වායු තරණය
aerophilous=වාතකාමි
aerophobia=ගගනභීතිකාව
aerophyte=වාතශාකය
aeroplane=අහස් යානය | ගගන යාත්‍රාව | ගගනයාත්‍රාව | ගුවන් නැව | ගුවන්‍යානය
aeroplankton=වායව ප්ලවාංග | වායුප්ලවාංග
aeroscope=එයරොස්කෝපය
aerosiderite=එයරොසිඩරයිට්
aerosite=එයරොසයිට්
aerosol=ඉතා කුඩා අංශු වායුවක විසිර තිබීමේ ක්‍රමය | ඉතා කුඩා අංශු වායුවක විසිර තිබෙන පද්ධතිය | එයරොසොලය
aerospace=ආකාශතලය | නභෝ ගර්භය | නභෝගර්භය | වායුගෝලය
aerosphere=වායුගෝලය
aerostatics=වායුස්ථිතිවිද්‍යාව | වායුස්ථීති විද්‍යාව
aerotactic=වාතසාර්වසාරි
aerotaxis=වාතසාර්වසරණය
aerotherapeutics=වායුවකිත්සාව
aerotonometer=එයරොටොනොමීටරය
aerotropic=වාතාවර්තී
aerotropism=වාතාවර්තනය
aerugo=එෘගෝ | ලෝහ මල
aery=මාංශ භක්ෂක කුරුල්ලන්ගේ කූඩුව
aesthesia=සංජානන හා සංවේදන ශක්තිය | හැඟීම් ඇතිවීම
aesthesiogenic=සංවේද ජනක
aesthesiometer=සංවේද මානය
aesthete=කලාකාමියා | රසඥයා | රසික | රසිකමානියා | රසිකයා
aesthetic=රසික | සංවේද්‍යු | සුන්දර | සෞන්දර්ය | සෞන්දර්ය්‍ය පිළිබඳ වූ | සෞන්දර්යාත්මක
aesthetician=සෞන්දර්යවාදියා
aesthetics=රසඥානය | ශෝභාශාස්ත්‍රය | සෞන්දර්ය විද්‍යාව | සෞන්දර්ය ශාස්ත්‍රය
aestival=ග්‍රීෂ්ම | ගිම්හාන
aestivation=ගිම්හානතරණය | පරිවින්‍යාසය
aetaerio=සමුච්චය
aetario=සමුච්චය
aethalium=ඊතැලියම
aethatlium=ඊතැලියම
aether=ඒතරය
aetiology=කාරණ විමර්ශනය | හේතු විද්‍යාව | හේතු විමර්ශනය | හේතුවිද්‍යාව
aeviternity=අනන්ත කාලය | සදාතනය
afar=ඈත | ඈතට | ඈත්වූ | ඈතින් | එපිටින් | දික් | දුරට | දුරින | දුරින්
affability=ප්‍රියවාදී බව | මිත්‍රශීලිභාවය | සුහදත්වය
affable=කාරුණික | ප්‍රියවාදී | ප්‍රියශීලී | මිත්‍රශීලී | විනීත | සුහද
affably=ප්‍රියශීලිව
affair=කටයුත්ත | කරුණ | ක්‍රියාව | කාර්ය | කාර්යය | කාරිය | කුළුපගකම | පලහිලව්ව | පළහිලව්ව | වැඩේ | සම්බන්ධය
affairs=කටයුතු | තොරතුරු | වැඩපල
affect=ආදරය දක්වනවා | ආවේදනය | කම්පා කරනවා | ක්‍රියා කරනවා | ගුණාගුණ දෙනවා | බල පානවා | බලපානවා | බලපෑම | බලාපොරොත්තු වෙනවා | බොරුවට පෙන්වනවා | මවා පානවා | වැදී යනවා | සිතට වදිනවා
affectation=අහංකාරකම | ආටෝපය | ආරෝපණය | දම්බය | මවාපෑම | රැවටිල්ල
affected=උජාරු | උඩඟු | වැදුණු | විකෘත | වෙනස් වූ
affecting=අනුකම්පා උපදවන
affection=අනුරාගය | ආදරය | ආබාධය | ආවේදනාව | දයාව | භාවය | රෝගය | වාත්සල්‍ය | වින්දනය | ස්නේහය
affectionate=ආදරණීය | දයාබර | ප්‍රේමවන්ත | හිතෛෂී | හුරතල්
affective=ආවේදනාත්මක | ආවේදනික | උද්වේගවත් | ක්‍රියාකාරී | බලපාන | වත්තවේගික
affectivity=ආවේදනාත්මකතාව | ආවේදනිකතාව
affeer=තක්සේරු කරනවා
afferent=අභිවාහී | ආවාහී
affiance=ප්‍රතිඥාව | පොරොන්දුව | විවාහ ගිවිස ගන්නවා | විවාහ ගිවිසනවා | විවාහ ගිවිසුම | විවාහ පොරොන්දුව
affiation=අනුබද්ධනය | දරුබව නියම කිරීම
afficted=සිත් ඇදුණු
affiction=ලෙඩ දුක් | විපත්තිය | සන්තාපය
affictive=ලෙඩ දුක් සහිත
affidavit=දිවුරුම් පත්‍රය | දිවුරුම් ප්‍රකාශය | දිවුරුම් පෙත්සම | දිවුරුම්පත | දිවෘම් ප්‍රකාශය | දිවෘම් පෙත්සම
affiliate=අනුබද්ධ කරනවා | දරුකමට පවරනවා | දරුකමට බාර ගන්නවා | සම්බන්ධ කර ගන්නවා | සම්බන්ධ කරනවා
affiliated=අනුබද්ධ | ආබන්ධිත
affiliation=අනුබද්ධ කිරීම | අනුබද්ධකිරීම | අනුබැඳිය | සම්බන්ධ කිරීම
affine=ආබඳන | ආබඳනය | විවාහ ඥාතියා
affinity=ආකර්ෂණය | එකඟකම | නෑකම | බන්ධුත්වය | බන්ධුතාව | විවා නෑකම | විවාහනෑකම | සබඳකම | සම්බන්ධය | සමානකම | සාම්‍යය
affirm=තරයේ කියනවා | තහවුරු කරනවා | ප්‍රතිජානනය කරනවා | සත්තක කරණවා | සහතික කරනවා | සහතික ලෙස කියනවා | සහතික වෙනවා | ස්ථිර කරනවා
affirmant=සත්තකකරු
affirmation=තහවුරු කිරීම | ප්‍රතිජානනය | ප්‍රතිඥාව | සත්තක කිරීම | සත්තකය | සත්‍ය ස්ථාපනය | සහතික කිරීම | සහතික කොට කීම | සහතික ප්‍රකාශය
affirmative=අස්ත්‍යර්ථ | අස්ත්‍යර්ථක | අස්ත්‍යර්ථය | තරයේ කියන | ප්‍රතිජානක | ප්‍රතිජානන | සත් | සත්තක | සත්‍යර්ථ | සහතික ලෙස කියන
affirmatory=සහතිකකොට කීම
affirmed=සත්තක කරන ලදි | සත්තක කළ | සහතික කරන ලදි | ස්ථිර කරන ලදි | ස්ථිර කළ
affix=අනුබන්ධය | අමුණනවා | අලවනවා | උපසර්ගය | එකතු කරන ලද්ද | එකතු කරනවා | තබනවා | පදාංශය | ප්‍රත්‍යය | යා කරනවා
affixed=සම්බද්ධ
affixture=අමුණන ලද්ද | අමුණුම | අලවන ලද්ද | එකතු කිරීම | එකතුකිරීම
afflated=සිත් ඇදුණු
afflatus=දේව වරප්‍රසාදය | දේවානුභාවය වැද්දවීම | හුස්ම පිඹීම
afflict=දුකට පමුණුවනවා | දුක් පමුණුවනවා | පීඩා කරනවා | හිංසා කරනවා | හිරිහැර කරනවා | හිරිහැරයට පමුණුවනවා
affliction=කරදරය | ගහට | ගැහැට | පීඩාව | පීළනය | සන්තාපනය | හිරිහැරය | හොළ
afflictive=වේදනාදායී
affluence=ඉසුර | පොහොසත්කම | සම්පත | සමෘද්ධිය
affluent=අතු ගංගාව | අතුගඟ | ආඩ්‍ය | ඉසුරුමත් | ගලාබසින | ධනවත් | පොහොසත් | සමෘජ | සමෘද්ධිමත්
afflux=අභිස්‍රාවය | ගැලීම | ප්‍රවාහය | සමූහය
affluxion=අභිස්‍යන්දනය
afforce=ප්‍රබල කරනවා | ශක්තිමත් කරනවා
afforcing=ප්‍රබලකාරක
afford=ඉස්පාසු ඇතිව සිටිනවා | උපයනවා | දරනවා | දෙනවා | ධනය ඇතිව සිටිනවා | වුවමනා කාලය ලැබෙනවා | සපයනවා | සලසනවා
afforest=කැලෑ බවට හරවනවා | කැලෑ වවනවා | වන වවනවා
afforestation=කැලෑ වැවීම | වන රෝපණය | වන රෝපනය | වනරෝපණය
affray=කලභය | කලහය | ගුටිබැට හුවමාරුව | දබරය | භය කරනවා | සංඩු සරුවල
affreightment=නැව් කුලී ගිවිසුම
affright=බියට පත් කරනවා | භය | භය කරනවා | භීතිය | මහත් භය
affrightted=මහත් භය සහිත
affront=අවඥාව | අවමානය | නිග්‍රහය | නින්දා කරනවා | නිර්භයව මූණ පානවා | ප්‍රසිද්ධියේ කරන නින්දාව | හෙළා දැකීම
afghan=ඇප්ගන්කාරයා | ඇ්ගනිස්ථානයේ වැසියා
aficionado=ආධුනිකයා | උද්‍යුෝගිමත් අනුගාමිකයා
afield=ඈත | ඈතින් | එලිමහනෙහි | කුඹුරෙහි | දුර | දුරින්
afire=ගිනිගත්
aflame=ඇවිලගත් | ගිනි ගත් | දැවෙමින්
afloat=ඉලිප්පෙන | ඉලිප්පෙමින් | ණයෙන් නිදහස් වූ | දිය මතුපිට | දියත් | දියත්ව | නැවෙහි | පාවෙන | පාවෙමින් | පාවෙමින් තිබෙන විට
afluxion=අභිස්‍යන්දනය
afoliate=විපත්‍රී
afoot=අරඹා | පයින් | පයින් යමින් | මුල පුරා
afore=ඉදිරියෙහි | ඉහත | කල් ඇතිව | පෙර | මුලින්
afore-mentioned=යට කී
aforementioned=ඉහතකී | පූර්වෝක්ත | පෙරකී | යටකී
aforesaid=ඉහත කී | ඉහතකී | උක්ත | පූර්වොක්ත | පූර්වෝක්ත | යට කී | යටකී
aforethought=කලින් සිතූ | චේතනා සහගත | පූර්ව චේතනාව | පෙර සිතූ
afraid=තැති ගැනුණු | නොකැමැති | බිය පත් | භය | භය වූ | භීතියට පත් | සැක | සැක සහිත
afresh=අභිනවයෙන් | අමුතුවෙන් | අලුතින් | අලුතෙන් | නැවත | යළි
africa=අප්‍රිකාව
african=අප්‍රිකානු | අප්‍රිකානුවා | අප්‍රිකාවට අයිති
afrikaans=අප්‍රිකාන් භාෂාව
afrikaner=සුදු අප්‍රිකානුවා
afro=අප්‍රිකා
afront=ඉදිරියෙන් | කරට කර
aft=අනුව | ඇති වූ | ගැන | පස්සෙන් | පස්සේ | පසුපස | පසුපසින් | පසුව | පසුව ඇති වන | පිටුපස | පිටුපසින්
after=අනතුරුව | අනුව | ඇති වූ | ගැන | පස්සෙන් | පස්සේ | පසු | පසුව | පසුව ඇති වන | පහු | මතු | සම්බන්ධව
after-ages=මතු පරම්පරා
after-bay=පසුවැව
after-birth=ගැබ මල | මදැමහ
after-blow=පසු පිඹුම
after-effect=පශ්චාත් ආවරණය | පශ්චාත් ඵලය | පශ්චාත්ඵලය
after-glow=අස්තාලෝකය
after-math=ආනිසංසය
after-most=ඉතා පස්සෙහි වූ
after-noon=අපරභාගය | පස්වරුව
after-piece=පසු රැඟුම
after-ripening=පශ්චාත් පරිණතිය
after-sensation=පශ්චාත් සංවේදනය | පසු විඳුම
after-thought=පසු කල්පනාව
after-ward=අනතුරුව | ඉක්බිති | පසු කාලයෙහි
after-wards=අනතුරුව | ඉක්බිති | පසු කාලයෙහි
after-world=පරලොව
afterbirth=දලබුව | වැදෑමහ
aftercare=පශ්චාද්භාරය
aftercooler=පසු සිසිල් කුරුව
afterdamp=අවවායු
aftereffect=පශ්චාත්ඵලය
afterglow=පසු දිලියුම
afterimage=පශ්චාත් ප්‍රතිබිම්බය
afterlife=ඊළඟ උපත | පරලොව විතය
afterlifetime=පශ්චාත් විතව්‍යය
aftermath=විපාකය
afternoon=අපරභාගය | අවර | පස්වරුව
afterthought=අලුත් අදහස | පසුව ආ අදහස
afterwards=නැතකින් | පස්සේ | පසුව
afterword=පසු වදන | පසුවදන
aftlight=අපරාලෝකය
again=ආපසු | තවත් | දෙවනුව | නැවත | පන | ප්‍රති | පිළි | පුන | පුනර් | පුනහ් | යළි | යොර | වැලිත් | වැළි
against=ඉදිරිපිට | උ | එදිරිව | පරා | පරි | විපක්ෂ | විරුද්ධ වූ | විරුද්ධව | හේත්තු වී | හේත්තුව | ළඟ
agalmatolite=ඇගැල්මටොලයිට්
agamete=විජන්මාණුව
agamy=විසංයෝගතාව
agape=අගාපය | විවෘතව | විස්මිතව
agar=ඒ ගාර් | ඒගාර්
agaric=අගරික්
agate=අගත්ති | අගන්ති | අගස්ති | මැණික් වර්ගයක්
agathology=හිතවේදය
agathon=හිතබව
age=ආ | ආයුෂ | ආයුෂය | කාල | කාලපරිච්ඡේදය | කාලය | දිරාපත් වෙනවා | දීර්ඝ කාලය | පරම්පරාව | මහලු වයස | මහලු වෙනවා | යුගය | වය | වයස | වයසට යනවා,වයහ් | විය | සමය
age-group=වයස් ගණය
age-hardening=විය දැඩියම
age-old=ඉතා පුරාණ | ඉපැරණි
aged=ඇවිරිදි | ජරාජීර්ණ | පැරණි | මහලු | වයස්ගත | වයසැති | වියපත් | සංකඩ | හැවිරිදි
ageing=අවෑම | ඇවෑම | පැරණි | මහලු | වයසැති | විය දැඩි වීම | වියැයීම | වීය යෑම
ageism=වයසට වෙනස්කම් කිරීම
ageless=කවදාවත් නාකි නොවන | කවදාවත් පැරණි නොවන | නාකි නොවන | පරණ නොවන | හැම විට තරුණ
agelong=දිගු කලක සිට පවතින | වරන්තන
agency=අනුයොතත්වය | ඒජන්සිය | කටයුත්ත | කර්තෘත්වය | කාර්යාංශය | නියෝජනය | නියෝජ්‍යත්වය | නියෝජිත ආයතනය | නියෝජිත ධූරය | ප්‍රතීකාරකත්වය | බලය | ව්‍යාපාරය | ශක්තිය | හේතුව
agenda=න්‍යාය පත්‍රය | න්‍යායපත්‍රය | වැඩ සටහන
agent=අනුයෝජිතයා | ඒජන්ත | කතු | කර්තෘ | ක්‍රියා කරන්නා | කාරක | කාරකය | කාරකයා | නියෝජිත | නියෝජිතයා | ප්‍රතිනිධි | ප්‍රතීකාරකයා | සාධකය | හේතුව
ageotropic=සෘණ ගුරුත්වාවර්තී
ageusis=විරසතාව
agglomerate=අභිපිණ්ඩිතය | ඒකරාශී වෙනවා | කැටි කරනවා | කැටි වෙනවා | පිණ්ඩිත | පිණ්ඩිතය | යමහල් කැට | යමහල්කැටය | රාශිභූත | රාශීභූත | රැස් කරනවා | රැස් වෙනවා
agglomerate.=සම්පිණ්ඩිත
agglomerated=ආකීර්ණ ජනාවාසය
agglomeration=අභිපිණ්ඩය | පිණ්ඩය | රාශිය | සම්පිණ්ඩනය
agglutinant=ආලග්නකය | ශ්ලේෂකය
agglutinate=අලවනවා | අලුක් සමාස සාදනවා | ඇලිසිටිනවා | ඇලෙනවා | ශ්ලිෂ්ට වෙනවා | ශ්ලිෂ්ටවීම | සම්බන්ධ කරනවා | සමාස කරනවා
agglutinated=ග්ලිෂ්ට | ශ්ලිෂ්ට | සංලග්න
agglutination=ශ්ලිෂ්ට වීම | ශ්ලේෂණය | සංලග්නනය
agglutinative=සංලග්න
agglutinin=ඇග්ලුටීනින් | සංලග්නකය
agglutinogen=ඇග්ලුටිනෝජන් | සංලග්නජය
aggrace=අනුග්‍රහ කරනවා | අනුග්‍රහය | කරුණාව | කරුණාව දක්වනවා
aggradation=උත්ක්‍රමණය
aggrade=උත්ක්‍රමණය කරනවා
aggrandise=වැඩි කරනවා | විශාල කරනවා
aggrandize=අලංකාර කරනවා | තත්ත්වය උසස් කරනවා | ධනය උසස් කරනවා | බලය උසස් කරනවා | වැඩි කරනවා | වැඩි කොට දක්වනවා | විශාල කරනවා
aggrandizement=උසස් කිරීම | සමුන්නතිය
aggrate=ස්තුති කරනවා
aggravate=උග්‍ර කරනවා | උග්‍ර වෙනවා | බරපතළ කරනවා | බරපතළ වෙනවා | වැඩි කරනවා
aggravating=බරපතල
aggravation=උග්‍රකරණය | ගුර්වීකරණය | බරපතල වීම
aggregate=එකතු කරනවා | එකතු වෙනවා | එකතුව | ඓක්‍යය | මුළු | මුළු ගණන | සංහතිය | සමෂ්ඨීය | සමස්තය | සමස්තිය | සම්හාරය | සමාභාර | සමාභාරය | සමාහාරය | සමුච්චය | සමුහය | සමූහනය කරනවා | සමූහය | සියල්ල
aggregated=සමුහස්ථ
aggregates=සංස්කාර
aggregation=ඒකරාශි කිරීම | රාශිය | සම්භාරය | සමාහරණය | සමුහනය | සමූහනය | සමූහය
aggregrate=එකතු කරනවා | එකතු වූ | එකතු වෙනවා | එකතුව | එක් කරනවා | මුළු ගණන | රාශිය | රාශීභූත | රැස් කරනවා | සමස්ත
aggresin=ඇග්‍රෙසින්
aggress=ආක්‍රමණය කරනවා | ආරවුල පුරවනවා | පහර දීම අරඹනවා
aggression=ආක්‍රමණය | ආරවුල් ඇති කිරීම | කලහයක මුල පිරීම | චණ්ඩභාවය | සටනක මුල පිරීම
aggressive=ආක්‍රමණකාරී | ආක්‍රමණශීලී | ආක්‍රමණික | ආරාවුලට කැමති | කලහකාරී | චණ්ඩ
aggressiveness=ආක්‍රමණකාරිත්වය | ආක්‍රමණකාරීත්වය | ආක්‍රමණිකත්වය | චණ්ඩතාව
aggressivenesss=කලහකාරී බව
aggressor=ආක්‍රමණිකයා
aggrieve=කනගාටුවට පත් කරනවා | දුකට පත් කරනවා | පීඩාවට පත් කරනවා | පීඩාවට පත් වෙනවා | වේදනා විඳිනවා
aggrieved=අතෘප්ත | දුකට පත් | දුකට පත් වූ | පීඩාවට පත් | පීඩාවට භාජන වූ
aghast=ත්‍රස්ත වූ | තැති ගත් | විස්මයට පත්
agile=ඉක්මන් | කඩිසර | ජව සම්පන්න | ජවසම්පන්න | තුරිත | ශීඝ්‍ර | සුචල්‍ය
agility=උලැගිකම | කඩිසර බව | ශීඝ්‍රතාව | සුචල්‍යතාව
aging=ඇවෑම | පදම් කිරීම | පැරණි | මහලු | වයස්ගත විම | වයසැති | වියැයීම
aginst=එරෙහිව
agiotage=විදේශ විනිමය හෝ කොටස් වෙළඳ පොළේ සමපේක්ෂණය
agism=වයසට වෙනස්කම් කිරීම
agistor=තණකැවුම්කරු
agitate=අලළනවා | අවුස්සනවා | උද්ඝෝෂණය කරනවා | කලතනවා | කලබල ඇති කරනවා | කලඹනවා | කලහ ඇති කරනවා | කළඹනවා | විවාද ඇති කරනවා
agitated=වික්ෂිප්ත
agitation=ආන්දෝලනය | ආලෝලනය | ආවේගය | උද්ඝෝෂණය | කලබලය | කලහය | ක්ෂෝහය | කැළඹීම | වික්ෂෝභ | වික්ෂෝභනය
agitator=ආන්දෝලක | ආන්දෝලකයා | ආලෝලකයා | උද්ඝෝෂක | උද්ඝෝෂකයා | කලබල කරන්නා | කලබලකාරයා | කලහකාරයා | කළඹනය | කළඹන්නා | මන්ථකය
agitolalia=ත්වරිත ලපනය
aglow=දීප්තිමත් | බබළන | බබළමින් | බැබළෙන | බැබළෙමින් | රක්තවර්ණ | රත් වූ
aglucone=ඇග්ලුකෝන්
aglycone=ඇග්ලයිකෝන්
agnail=නියපොත්තෙහි ඉරී ගිය සම
agname=අමතර නම
agnate=පියපස නෑයා | පුංඥාතියා | පුරුෂ ඥාතියා | පුරුෂපරම්පරා ඥාතියා | සගෝත්‍ර
agnates=පුංඥාතීහු | පුමුපසනෑයෝ
agnatic=පියපස නෑදෑ | පුංඥාතික | පුරුෂ ඥාති
agnation=පියපස නෑකම | පුංඥාතිත්වය | පුංඥාතීත්වය | පුමුපසනෑකම | පුරුපක්ෂ ඥාතිත්වය | පුරුෂ ඥාතිත්වය | පුරුෂපරම්පරා ඥාතිත්වය
agnetite=ඇග්නටයිට්
agnise=පාපෝච්චාරණය කරනවා | පිළිගන්නවා | භාරගන්නවා
agnoiology=අවිද්‍යා විභාගය
agnosia=අසංඥතාව
agnostic=අඥේයවාදියා | නාස්තික දෘෂ්ටිකයා
agnosticism=අඥෙය වාදය | අඥෙයවාදය | අඥේය වාදය | අඥේයවාදය
agnosy=අඥත්වය
ago=අතීතය | ඉස්සර | ඉහත | පෙර
agog=කලබල | කලබල සහිත | නොඉවසිල්ලෙන් බලාපොරොත්තු වන | නොඉවසිලිමත් | සෝත්කණ්ඨ
agoing=යමින්
agone=ඉස්සර | ඉහත | පෙර
agonic=අකෝණික
agonise=බලවත් වේදනා උපදවනවා
agonising=දුක් උපදවන
agony=කටුක වේදනාව | මරනාන්තික දුක | මහත් ප්‍රයත්නය | මහත් පීඩාව | මාරාන්තික දුක | විසාද | සන්තාපය
agoraphobia=අංගණ භීතිකාව | අංගණභීතිකාව | අංගන භීතිකාව
agrammatalogia=අව්‍යාකරණතාව
agrammatism=අව්‍යාකරණතාව
agranulocytosis=අවකණිකාසයිටතාව
agraphia=අලේඛතාව
agraphobia=අංගන භීතිකාව
agrarain=කෘෂි | කෘෂිකර්ම | ගොවි | ගොවිජන
agrarian=කෘෂිකාර්මික | ගොවිජන
agree=එකග වෙනවා | එකඟ වෙනවා | ඔබිනවා | කතා වෙනවා | කැමති වෙනවා | ගිවිසිනවා | ප්‍රතිඥාදෙනවා | පොරොන්දු වෙනවා | යෝග්‍ය වෙනවා | සම්මත වෙනවා | සමාන වෙනවා | සීහෙනවා
agreeability=එකඟ විය හැකි බව | ප්‍රියස්වභාවය
agreeable=අනුකූල | ඉටු | ඉෂ්ට | එකඟ | එකඟ විය හැකි | කල් | කල්‍යාණ | කලු | ප්‍රිය | ප්‍රියදර්ශී | ප්‍රියමනාප | මනෝඥ | සැපදායක | සුදුසු
agreeableness=මනාපතාව
agreeably=අභිමත සේ | එකමුතු වන ලෙස | සතුටු සේ
agreeing=එකඟ වන | එකඟවීම
agreement=අනුකූලතාව | එකඟත්වය | එකඟතාව | එකඟවීම | ඒකමතිය | කතිකාව | කැමැත්ත | ගිවිසීම | ගිවිසුම | ප්‍රතිඥාව | පොරොන්දු පත්‍රය | පොරොන්දුව | සම්මතිය | සම්මුතිය | සමානකම | සහමතිය | සුදුසුකම
agressor=ආක්‍රමණිකයා
agrestial=ගම්බද වැවෙන
agrestic=ගම්බද
agribusiness=කෘෂිව්‍යාපාරය
agricluture=කෘෂිකර්මය | ගොවිතැන
agricultural=කෘෂිකර්ම | කෘෂිකාර්මික | ගොයි | ගොවි | ගොවිකම්
agriculturalist=ගොවියා
agriculture=කෘෂිකර්මය | කෘෂිකර්මාන්තය | ගොයිකම | ගොවිකම | ගොවිතැන | ගොවිතැන් කිරීම
agriculturist=කෘෂිකාර්මිකයා | ගොවියා
agrimony=කහ මල් ඇති ගස් විශේෂයක්
agriology=ග්‍රාමීයචාරිත්‍රවිද්‍යාව
agrise=බියවද්දනවා | භය කරනවා
agrize=බියවද්දනවා | භය කරනවා
agro-chemical=කෘෂිරසායන
agrobiology=කෘෂිවවිද්‍යාව
agrochemical=කෘෂිරසායන
agroforestry=කෘෂිවනවගාව
agroindustry=කෘෂිකාර්මික කර්මාන්ත
agrology=කෘෂිපාංශුවිද්‍යාව
agronomics=ශස්‍යවිද්‍යාව
agronomy=ශෂ්‍ය විද්‍යාව | ශස්‍ය විද්‍යාව | ශස්‍යවිද්‍යා
agrophilus=කෙත් ලැදි
agrostography=තෘණ විස්තරය
agrostologist=තෘණ විද්‍යාඥයා
agrostology=තෘණ විද්‍යාව | තෘණවිද්‍යාව
aground=ගොඩ ඇනී | බිම ඇනී
agryze=බියවද්දනවා | භය කරනවා
aguacate=අලිගැටපේර
ague=ගැහෙන උණ | ශිතජ්වරය
ague-cake=බඩදිව ඉදිමීම
aguilarite=ඇග්විලරයිට්
aguise=අඳිනවා | පළඳිනවා | සැරසෙනවා
aguize=අඳිනවා | පළඳිනවා | සැරසෙනවා
agynous=අජායාංගී
ah=අනේ | අහා | අහෝ | අහෝ හා | කුමක්ද | පුදුමයි | සතුටුයි | හා
ah.=ජූ
aha=අහා | ඔහෝ | ඔහෝ එහෙමද යසයි | තද සතුට හෝ නිග්‍රහය | යසයි
ahead=ඉදිරියට | ඉදිරියෙන් | කලින් | කෙළින් | පෙරටුව | මුලින්
aheap=ගොඩගැසී
aheight=උසකට
aheliotropic=සෘණ සෞරාවර්තී
ahem=ඇහුණ ද | මේ බලන්න | සයි
ahigh=උසට
ahimsa=අහිංසාව
ahode=ආලය
ahoy=සයි | හූ
aichmophobia=ශුලභීතිකාව
aid=අත්වැල | ආධාරකය | ආධාරය | උදව් කරනවා | උදව්කාරයා | උදව්ව | උදවු කරනවා | උදවු කාරයා | උපකාර දරනවා | උපකාරය | පිහිට | පිහිට වෙනවා
aide=පුද්ගලික සහායක
aide-de-camp=ආරක්ෂක නිලධාරියා | ආරක්ෂක මුලාදෑනියා | පෞද්ගලික ආරක්ෂකයා | සේනාපතියාගේ සහකාරයා
aide-memoire=උපදේශකය
aider=ආධාර කරන්නා | ආධාරකාරයා | උදව්කාරයා
aidless=අසරණ | උදවුවක් නැති | පිහිටක් නැති
aidose=ලජ්ජාව | හිරිය
aids=ආධාර
aiguille=කුඩා විදුම් කටුව | හිදි කුළ | හිඳි කුළ
aikinite=අයිකිනයිට්
ail=අමාරුවෙන් පසු වෙනවා | අසනීප වෙනවා | අසනීපය | පීඩා කරනවා | පෙළීම | පෙළෙනවා | රෝගය | ලෙඩ | ලෙඩ වෙනවා | ලෙඩින් පෙළෙනවා
ailanto=කල්දුමය
aileron=පාර්ශවික සමබරතාවය පාලනය කිරීම සඳහා ගුවන් යානා තටු
ailing=අසනීපයෙන් පසුවන | පෙළෙන | රෝගී | ලෙඩ
ailment=අපහසුව | අසනීපය | ආබාධය | රෝගය | ලෙඩ
aim=අදහස | අපෙක්ෂාව | අභිප්‍රාය | අභිමතාර්ථය | අරමුණ | අරමුණ කරනවා | අරමුණු | ඉලක්කය | ඉෂ්ටාර්ථය | උත්සාහ කරනවා | එල්ල කරනවා | එල්ලය | කුරුමානම | කුරුමානම් අල්ලනවා | කුරුමානම් කරනවා | පරමාර්ථය | බලාපොරොත්තු වෙනවා | බලාපොරොත්තුව | මාන | මාන අල්ලනවා | මාන බලනවා | මානනවා | මානම | යොමු කරනවා | ලක | ලක් | ලක්ෂ්‍යය | ව්‍යවසාය
aimiessly=නිකමට
aiming=මෑනීම | මෑනුම
aimless=අරමුණක් නැති | ඉබාගාතේ යන | නිකං | පරමාර්ථයක් නැති | බලාපොරොත්තුවක් නැති
aimlessly=ඉබා ගාතෙ | ඉබාගාතේ | නිදැල්ලේ
ainu=අයිනු | අයිනුවා | ජපන් භාෂාව | ජපන් මනුෂ්‍ය වර්ගයක්
air=අන්තරීක්ෂය | අව්වේ තබනවා | අවු වද්දනවා | අහස | ආකාශය | ආඩම්බර ගතිය | එලියේ තබනවා | ගුවන | ගුවන් | තාලය | ප්‍රකට කරනවා | ප්‍රකාශ කරනවා | පෙනුම | මඳ පවන | ලීලාව | වාතය | වායුව | වේළෙන්නට තබනවා | සමීර | සමීරණ | සුළං වදින්ට සලසනවා | සුළඟ | සුළඟට අල්ලනවා | හුළඟ
air-arm=ගුවන් ප්‍රහාරක කණ්ඩායම
air-base=ගුවන් නැව් කඳවුර
air-brake=වායුරෝධකය
air-brick=කුහරගඩොල | සිදුරු ගඩොල
air-cleaner=වායු ශෝධකය
air-compressor=වායුසම්පීඩකය
air-conditioning=වා සමනය | වායුසමීකරණය
air-cooling=වාතයෙන් නිවීම
air-crew=ගුවන් සේවක පිරිස
air-current=වාත ප්‍රවාහය
air-cushion=වාත කොට්ටය
air-damping=වාත පරිමන්දනය
air-ejector=වා නෙරපනය
air-exhauster=වා පිටකුරුව
air-filter=වා පෙරහන
air-gun=සුළං තුවක්කුව
air-intake=වාත චූෂණය
air-less=නිර්වායු | වාතාශ්‍රය නැති | සුළං නැති
air-lock=වා ඇවුරුම
air-power=ගුවන් බලය
air-preheater=වාත පූර්වතාපකය
air-pressure=වායු පීඩනය
air-raid=ගුවන් ප්‍රහාරය
air-tight=වායුරෝධක | වායුවාරක | සංවෘත | සුළං නොයන
air-worthy=ගුවන් ගමනට සුදුසු
airbase=ගුවන් නැව් කඳවුර
airborne=වාසර
airbrush=වාතෙල්ල
aircraft=අහස් යානය | අහස්‍යානය | ගුවන්නැව
airfilter=වා පෙරහන
airfoil=වාපත
airgun=සම්පීඩන වායු තුවක්කුව
airily=වග විභාගයක් නැතිව | සැහැල්ලුවෙන්
airiness=වාතාශ්‍රය ඇති බව | වාතාශ්‍රය සහිත බව
airing=එළිමහනේ හැසිරීම | ප්‍රකට කිරීම | සුළං වැදීම
airless=නිර්වාත
airlift=ගුවනින් ගෙනයනවා
airline=ගුවන් ගමන් මාර්ගය | ගුවන් ප්‍රවාහන සමාගම
airliner=මගී ගුවන්නැව | මගී ගුවන්‍යානය
airmail=ගුවන් තැපැල්
airman=අහස්නැවියා | ගුවන්නැවියා
airplane=ආකාශයාත්‍රාව | ගුවන් නැව | ගුවන් යානය | ගුවන්නැව | ගුවන්‍යානය
airport=ගුවන් නැව් තොට | ගුවන්තොට | ගුවන්තොටුපළ | ගුවන්නැව්තොට
airpump=වායු පොම්පය
airship=ගුවන් නැව | ගුවන්නැව
airstrip=ගුවන් ධාවනපථය
airtight=වාතපරිරෝධක | වාතරෝධක | වායුරෝධක
airway=වාමඟ
airworthiness=ගගනාර්හතාව | ගුවන් යෝග්‍යතාව
airy=අසාර | උස්ව පිහිටි | වාතාශ්‍රය ඇති | වාතාශ්‍රය සහිත | වැදගැම්මකට නැති | ශීඝ්‍ර | සැහැල්ලු | සියුම්
aisle=අන්තරාලය | ආසන අතර ප්‍රවේශය | ප්‍රවේශමාර්ගය | මැදිමඟ
ait=කුඩා දූපත | දූව
aithalium=ඊතැලියම
aitiogenic=පරතේජක
ajar=අඩක් වැසුණු | අඩවල් | අඩවල් කරන ලද | ටිකක් ඇරුණු
ajutage=අපස්‍රාවකය
akene=චර්මලය
akenium=චර්මලය
akimbo=අත් ඉඟෙහි තබාගෙන
akin=එකිනෙකට සම්බන්ධී | නෑකම් ඇති | නෑදෑ වූ | සමාන | සමාන ජාතික | සමානව | සමීපව | හුරු
akinesia=අචලතාව
akinesis=අවාලකතාව
akinete=අකෛනීටය | අචලකය
akonate=විකශිකයෝ
al-fresco=එළිමහනෙහි
al-right=අනතුරු රහිතයි | සතුටුදායකයි | සනිපයි | හරි | හොඳයි
ala=පක්ෂය | වරල | වාජය
alabandite=ඇලබැන්ඩයිට්
alabaster=ඇලබැස්ටර් | කිරිගරුජ වැනි | සිනිඳු | සුමට
alack=අහෝ
alack-a-day=විපතක මහත
alacrity=උනන්දුව | කඩිසරකම | යුහුසුලු බව | ශීඝ්‍රතාව
alalia=අලාපතාව
alamandite=ඇලමැන්ඩයිට්
alanine=ඇලනීන්
alap=ආලාපය
alar=පක්ෂ
alarm=අනතුරු ඇඟවීම | අනතුරු ඇඟවීමේ සංඥාව | අනතුරු දන්වනවා | අනතුරු නිවේදනය | අනතුරු හඟවනවා | කුලප්පුව | ගිනි පත්තු වෙනවා | චකිතය | චකිතය උපදවනවා | ත්‍රාසය | තැතිගැන්ම | බිය වෙනවා | බිය සන | බියසන | භය | භය උපදවනවා | භය වද්දනවා | භයට පත් කරනවා | සත්ත්‍රාසය
alarmed=තැති ගැනුණු | භය වූ
alarming=තැතිගන්වන | බියසුලු | භය උපදවන
alarmingly=භයජනක ලෙස
alarmist=බිය ගෙන දෙන්නා | භය උපදවන්නා
alarum=අනතුරු නිවේදනය
alas=අඳෝමයි | අප්පේ | අපොයි | අය්‍යෝ | අහෝ | අහෝ | නපුර | ස | හහා
alas!=දෙයියෝ සාක්කි
alas.=ඇන්නෑවේ
alaskite=ඇලස්කයිට්
alate=පක්ෂමාන | සපක්ෂ
alavangoo=ගල් ඉන්න | යකඩඉන්න
alavngoo=නාරස්න | නාරාසනය
alb=පය දක්වා ක්‍රිස්තියානි පූජකයින් අඳින සුදු ඇඳුම
albacore=විශාල මත්ස්‍ය විශේෂයක්
albane=ඇල්බන්
albanose=ඇල්බනෝස්
albatross=ඇල්බට්‍රොස් නම් පක්ෂියෙක්
albedo=අල්බේදෝව | ඇල්බීඩෝව | ඇල්වේතතාව | සුදු බව | සුදුව
albeit=එතකුදු වුවත් | එසේදවුවත් | එහෙත්
albene=ඇල්බෙන්
alberene=ඇල්බරීන්
albertista=ඇල්බට්වාදීහු
albertite=ඇල්බටයිට්
albinism=ඇලිබව | ඇළි බව | ඇළිබව
albino=ඇලි සතා | ඇලියා | ඇළි මිනිහා | හැළි මිනිසා | හැළි වඳුරා
albite=ඇල්බයිට්
albrecht=සල්බ්‍රෙක්ට්
albucid=ඇල් බියුසිඩ්
album=අලවන පොත | ඇල්බමය | පින්තූර අලවන පොත | මුද්දර අලවන පොත
albumen=ඇල්බියුමන් | බිත්තර සුදු මදය | බිත්තරයේ සුදුමදය | ශ්වේත කල්ක | සුදු සාරු
albumin=ඇල්බියුමින්
albuminate=ඇල්බියුමිනේට්
albuminose=ඇල්බියුමිනෝස්
albuminous=ඇල්බියුමන් | ඇල්බියුමින් අඩංගු | හ්‍රූණපෝෂ
albuminuris=ඇල්බියුමින් මූත්‍රතාව
albumoscope=ඇල්බියුමිනේක්ෂය
albumose=ඇල්බියුමෝස්
albuninometer=ඇල්බියුමින්මානය
alburnum=එලය | එළය | ඵලය
alchemical=ආදිරසායනික
alchemist=ආදිරසායනඥයා | රස විද්‍යාඥයා | රසවිද්‍යාඥයා
alchemistic=ආදිරසායනික
alchemy=ආදිරසායනය | රසවිද්‍යාව | සින්දුරම් ශාස්ත්‍රය | සින්දූරම් ශාස්ත්‍රය
alcheringa=කින්නර යුගය
alclad=ඇල්ක්ලැඩ් | ඇල්ක්ලෑඩ්
alcogel=ඇල්කොජෙලය
alcohol=ඇල්කොහොලය | ඇල්කොහොල් | මත්බීම | මද්‍යසාර | මද්‍යසාරය | සුරා
alcoholate=ඇල්කොහොලේටය
alcoholic=ඇල්කොහොලීය | බේබද්දා | මතට හුරු වූ තැනැත්තා | මද්‍යසාරය | මද්‍යු | මද්‍යුසාරියා | මද්‍යුසාරී | සුරා සොජා | සුරාධුර්තියා | සුරාධූර්තයා | සුරාවට ගිජු වූ | සුරාසොජ | සුරාසොජා
alcoholism=මදිරාබාධය | සුරාධූර්ත්වය
alcoholmeter=ඇල්කොහොල්මානය | මද්‍යුසාරමානය
alcoholometer=ඇල්කොහොල්මානය
alcoholysis=ඇල්කොහොල් විච්ඡේදනය
alcohometry=ඇල්කොහොල්මිතිය | මද්‍යුසාරමිතිය
alcomax=ඇල්කොමැක්ස්
alcosal=ඇල්කොසොලය
alcove=කාමරයක වෙන් කළ කුඩා කොටස | කුටීරය | ලතාගෘහය
alcumite=ඇල්කියුමයිට්
aldalcoketose=ඇල්ඩැල්කොකීටෝසය
aldehyde=ඇල්ඩිහයිඩ | ඇල්ඩිහයිඩ්
alder=ශාක විශේෂයක්
alderman=නගරසභිකයා | නියෝජිතයා | පුරදෙටුවා
aldolase=ඇල්ඩෝලේස්
aldrey=ඇල්ඩ්‍රේ
ale=බීර වර්ගයක්
aleatory=වාසනාව නිසා ලැබෙන අහඹු තේරීම
alembic=අතීතයේදී ආසවනය කිරීම සඳහා භාවිතා කළ උපකරණය | ආසූත පාත්‍රය
alerosphere=වායුගෝලය
alert=අනතුරු අඟවනවා | අනතුරු දැන්වීමේ සංඥාව | අප්‍රමත්ත | තියුණු | පරීක්ෂාකාරී | යුහුසුලු | විපරම | විපරම් සහිත | සිහිබුද්ධි ඇති | සෝදිසිය | සෝදිසියෙන් තබනවා | සෝදිසියෙන් සිටින
alertness=පරීක්ෂාකාරී බව | සාවධාන බව
aleurometer=ඇලියුරෝමීටරය
aleurone=ඇලියුරෝන්
alexandrists=ඇලෙක්සැන්ඩ්‍රියානුවෝ
alexandrite=ඇලෙක්සැන්ඩ්‍රයිට්
alexandrolite=ඇලෙක්සැන්ඩ්‍රොලයිට්
alexia=අපාඨ්‍යතාව
alfalfa=සතුන්ට දෙන තෘණ වර්ගයක්
alfresco=එලිමහනෙහි
alga=අල්ගා පැළෑටිය | ඇල්ගාව | ඇල්ගී පැළෑටිය | මල් හට නොගන්නා ජලීය පැලෑටියක්
algae=අල්ගා පැළෑටිය | අල්ගේ | හරිතප්‍රද සහිත සරල ශාක
algarite=ඇල්ගරයිට්
algaroth=ඇල්ගරොත්
algebra=වීජ ගණිතය | වීජගණිතය | වීජය
algebraic=වීජ | වීජගණිත | වීජීය
algebraical=වීජ | වීජ ගණිතාකූල | වීජීය
algebraically=වීජ වශයෙන්
algebraization=වීයකරණය | වීයනය
algedonic=වේදනස්වාදික
algesia=පීඩා වෙද්‍යතාව
algesimeter=පීඩා වෙද්‍යුතාමානය
algin=ඇල්න්
alginate=ඇල්නේට්
algodonite=ඇල්ගොඩොනයිට්
algol=ඇල්ගොල් | පරිගණක යන්ත්‍ර භාෂාව
algolagnia=පීඩා කාමුකත්වය
algolichen=ඇල්ගොලයිකනය
algolichenes=අල්ගොලිකෙනේස්
algologist=ඇල්ගී විද්‍යාඥයා
algology=ඇල්ගී විද්‍යාව | මුහුදු පැළෑටි විද්‍යාව | සමුද්‍රශාකවිද්‍යාව
algometer=පීඩාමානය
algophobia=පීඩා භීතිකාව | වේදනාභීතිකාව
algorism=ඇල්ගොරිතම
algorithm=ඇල්ගොරිතම | ගණිතයේ එන විශේෂ රීති ක්‍රමයක්
alias=අන්වර්ථ නාමය | අනුකල්පය | නැතහොත් | නොහොත් | බොරු නම | වෙනස් නමින් | වෙනස් වූ නම | වෙනුවට යොදන නම | හෙවත්
alibate=ඇලුමිනියිස් කිරීම
alibi=අන්‍යත්‍රතාව | අන්‍යස්ථානිකභාවය | නොතැනියාව | නොසිටි බව
alicyclic=ඇලිචක්‍රීය
alidade=ඇලිඩේඩය | දර්ශන රේඛකය | දර්ශරේඛකය | දර්ශරේඛය
alien=අන්‍ය | අන්‍යජාතික | ජාතී | තමන්ට අයිති නැති | පර | පරකීය | පරදේශක්කාර | පරදේශි | පරදේශිකයා | පරදේශියා | පරා | පිට කෙනෙක් | පිට දේසක්කාරයා | පිටත්තරයා | බැහැරියා | විජාති | විජාතික | විදේශික | විදේශිකයා | විදේශී | විරුද්ධ | වෙනස්
alienable=අත්හළ හැකි | අන්සතු කළ හැකි | පාවා දිය හැකි
alienate=අන් සතු කරනවා | අන්සතු කරනවා | අන්‍යයෙකුට පවරා දෙනවා | පවරණවා
alienation=අන්සතු කිරීම | අන්සතු වීම | අන්සතුකිරීම | අසහසම්බන්ධය | අසහාසම්බන්ධය | කලකිරවීම | තිරෝභූතිය | දූරස්ථ භාවය | පරාරෝපණය | පිටස්තර වීම | විදූරණය
alienee=අන්සතුව ලබන්නා | දේයලාභියා
alienor=අන්සතු කරන්නා | අන්‍යදායකයා
aliens=විදේශිකයෝ
aliform=පත්‍රාකාර
alight=අවතරණය | අහසින් බසිනවා | ගිනිගත් | දැල්වූ | දිලිසෙන | පත්තු කළ | පත්තු වෙන | පහතට එනවා | බසිනවා | බහිනවා | බැබළෙන | මොලවනවා | ලගිනවා | වහනවා | වාහනයකින් බසිනවා | හදිසියෙන් දකිනවා | හදිසියෙන් හමු වෙනවා
align=ඉදියුම් කරනව | එකතු වෙනවා | එකෙල්ල කරනවා | එල්ලෙට ගන්නවා | ගලපනවා | පෙළගැසෙනවා | පෙළට ගන්නවා | පේළි යට තබනවා | හරි කෙළින් තබනවා
aligned=ඉදියැවූ
aligning=ඉදියුම | එකෙල්ල කිරීම
alignment=ඉදියුම | ඉදියුම් | එකෙල්ල | එල්ලෙට ගැනීමට | ගැලපීම | පෙළ ගැන්නුම | පේලියට තැබීම
alike=එක්බඳු | එකාකාර | එම පමණට | එලෙසට | ඒකාකාර | වැනි | සම | සමව | සමාන | සමානව
aliment=ආහාර | ආහාරය | පෝෂණ ද්‍රව්‍යය
alimentary=ආහාර පිළිබඳ | පෝෂණීය | පෝෂ්‍යදායී
alimony=දික්කසාද දීමනාව | දීමනාව | පෝෂණය | වීරහදේයය
aline=එකතු වෙනවා | පෙළගැසෙනවා | පේළි යට තබනවා | හරි කෙළින් තබනවා
alineation=එකෙල්ල | පෙළට ගැනීම | පෙළට තැබීම
aliped=පක්ෂපාද | පක්ෂපාදය
aliphatic=ඇලිපැටික,
aliqnot=කතික
alite=ඇලයිට්
aliter=වෙනත් විධියක්
aliunde=අන්‍යස්මාන්
alive=කඩිසර | දැනුවත්ව සිටින | නොයෙක් දෙයින් ගහන | පණ ඇති | පණපිටින් | ප්‍රාණීන්ගෙන් ගහන | ව | වත් වන
alizarine=ඇලිසරීන්
alkah=ක්ෂාරය | ක්ෂාරීය
alkali=ක්ෂාර | ක්ෂාර ද්‍රව්‍යය | ක්ෂාරය | යවකාර ලුණු
alkalimeter=ක්ෂාරමානය
alkalimetry=ක්ෂාරමිතිය
alkaline=ක්ෂාර | ක්ෂාරමය | ක්ෂාරිය | ක්ෂාරී | ක්ෂාරීය
alkalinity=ක්ෂාරත්වය | ක්ෂාරීයතාව
alkality=ක්ෂාරීයතාවය
alkalize=ක්ෂාර කරනවා
alkaloid=ඇල්කලොයිඩය | ඇල්කලොයිඩ් | ක්ෂාරාභය
alkalometry=ක්ෂාරමිතිය
alkamine=ඇමයිනො ඇල්කොහොල්
alkanes=ඇල්කේන
alkanisation=ඇල්කේනීකරණය
alkenes=ඇල්කීන
alkenyl=ඇල්කීනිල්
alkines=ඇල්කයින
alkone=ඇල්කෝන්
alkoxide=ඇල්කොක්සයිඩ්
alkoxy=ඇල්කොක්සි
alkyl=ඇල්කිල්
alkylation=ඇල්කිල්කරණය
alkyle=ඇල්කිල්
alkylene=ඇල්කිලීන්
alkylidene=ඇල්කිලින්
alkylogens=ඇල්කිලෝජන
all=ඇම | එක්කොම | ඔක්කොම | නඛීල | මුළුමනින් | මුළුල්ල | විශ්ව | සකල | සමස්ත | සමස්ථ | සර්ව | සව් | සහමුලින් | සැම | සැවොම | සෑම | සියල්ල | සියල්ලෙන් | සියලු | සියෝ | සේරම | හැම | හෑම
all-embracing=සකලාංග
all-inclusive=සියල්ල අඩංගු
all-pervading=අනාවරණ
all-round=සර්වප්‍රකාරයෙන්
allachaesthesia=පරත්‍ර සංවේදීතාව
allaesthesia=පරත්‍ර සංවේදීතාව
allanite=ඇලනයිට්
allay=අඩු කරනවා | මනවා | සංසිඳවනවා | සංසිඳුවනවා | සනසනවා | සමහන් කරනවා
allegation=කියමන | කියා පෑම | චෝදනාව | දෝෂාරෝපණය | ප්‍රෝක්තිය
allege=කියා සිටිනවා | කියාපානවා | ගෙනහැර පානවා | චෝදනා කරනවා | දෝෂාරෝපණය කරනවා | ප්‍රවචනය කරනවා | ලිහිල් කරනවා | සංසිඳුවනවා | ස්ථිර ලෙස කියනවා
allegeance=සංසිඳවීම | සමනය කිරීම
alleged=කළැයි කියන | චෝදනා ලද | ප්‍රෝක්ත
allegiance=අවනතභාවය | අවනතවීම | පක්ෂපාතකම | පක්ෂපාතිත්වය | බැඳී සිටීම | රාජපාක්ෂික භාවය | රාජපාක්ෂිකභාවය
allegorical=රූපක
allegory=අන්‍යාලාපය | උපදේශකථාව | උපමා කථාව | උපහැරණය | දෂ්ටාන්තය | දෘෂ්ටාන්තය | රූපක කථාව | රූපකය
allegro=ඉක්මන් | ද්‍රුත
allele=ඇලීලය
allelomorph=ඇලීලය
allelomorphic=ඇලීල | ඇලීලරූප
allelomorphism=ඇලීලතාව
allelotrope= මිතප්‍රයෝගය
allelotropism=මිතප්‍රයුක්තතාව
alleluia=දෙවියන් වහන්සේට ස්ත්‍රෝත්‍ර වේවා
allergia=අසාත්මිකතාව
allergic=අසාත්මික
allergin=අසාත්මිකාරකය
allergy=අසාත්මිකතාව
alleviate=අඩු කරනවා | මර්දනය කරනවා | සහනය සලසනවා | සැහැල්ලු කරනවා
alleviation=අඩු කිරීම | අඩුකිරීම | සහනය
alleviatory=සැහැල්ලු
alley=උද්‍යාන පථය | උපවීදිය | පටු පාර | පටුමඟ | පෙත්මඟ | මුඩුක්කුව
alleys=සමාවක්‍ර
alliaceous=ඇලියසීය
alliance=ගිවිසුම | මිත්‍රකම | මිත්‍රත්වය | මිත්‍රසම්මුතිය | විවාහ සම්බන්ධය | සංගම් සමුහය | සන්ධානය | සම්බන්ධය | සාමග්ගිය
allied=එක්සත් | මිත්‍ර | මිත්‍ර වූ | සමානකම් ඇති
allies=මිත්‍රපක්ෂය | මිත්‍රරාජ්‍ය
alligator=කිඹුලා
allineation=එකෙල්ල | පෙළට ගැනීම | පෙළට තැබීම
alliteration=අනුප්‍රාසය | ශබ්දරසය | ශබ්දාලංකාරය
allobarbitonum=අලොබාබිටොනම්
allocate=අනුමත කරනවා | ඉඩ හරිනවා | නියම කොටස දෙනවා | නියම ස්ථානය දෙනවා | පවරනවා | බෙදා වෙන් කරනවා | වෙන් කර තබනවා | වෙන් කරනවා | වෙන්කරනවා
allocated=අනුමත
allocation=ආවන්ටනය | පැවරීම | පුස්තකාල ද්‍රව්‍ය වෙන් කිරීම හා ප්‍රතිපාදනය | බෙදා දීම | විබෙදිය | විභාජනය | වෙන් කර දීම | වෙන් කළ කොටස | වෙන් කළ මුදල | වෙන් කිරීම | වෙන්කිරීම
allocheiria=අන්‍යත්‍රය
allochiria=අන්‍යත්‍රය
allochroite=ඇලොක්‍රොයිට්
allochromy=අන්‍යවර්ණත්වය
allochthonous=ආර්ත | විදේශජ
alloclasite=ඇලෝක්ලසයිට්
allocutus=ව්‍යාහරණය
allodial=ඇලොඩියල | පූර්ණ අයිතිය සහිත
alloerotism=පරත්‍රකාමුකත්වය
allogamous=පරසංසේවත
allogamy=පරසංසේචනය
allogene=නිලීන ඇලීලය
alloisomerism=ත්‍රිමෘන් සමාවයවිකතාව
allokurtic=විෂමචක්‍රිම
allomerism=අන්‍යාවයවිකතාව
allomerization=අන්‍යාවයවිකීභවනය
allonge=අලවනය | යාකරය
allonym=ආරූඩ නාමය
allopathy=ඇලෝපතික වෛද්‍යය | බටහිර වෙදකම | විෂම චිකිත්සාව | විෂමප්‍රතිකාරය
allopsychosis=පරත්‍ර සයිකෝසියාව | පරාත්ම මනෝවිකාරය | පරාත්ම විකාරය
allot=ඉඩදෙනවා | කොටස් කර දෙනවා | කොටස් කරනවා | නියමකරනවා | වෙන් කර දෙනවා | වෙන්කොට දෙනවා
allotment=කට්ටිය | කැබැල්ල | කෑල්ල | කොටස | බිම්කට්ටිය | බෙදා දීම | බෙදා දුන් කොටස | විභාජනය | වෙන්කරදීම
allotrope=බහුරූපය | බහුරූපිකයා
allotropic=බහුරූපික | බහුරූපී
allotropism=බහුරූපතාව
allotropy=බහුරූපතාව | බහුරූපික | බහුරූපිතාව | බහුරූපී
allotted=බෙදා දුන් | වෙන් කළ
allottee=කට්ටි හිමියා | කට්ටිකරුවා | කැබැලි හිමියා | කොටස ලැබූ අය | කොටස්ලාභී | ලැබුම්කරු | විභාජන ලැබුම්කරු | විභාත
allotter=පවරනය | පවරන්නා
allotype=අපරදර්ශය
allow=අනුදන්නවා | අනුමත කරනවා | අවසර දෙනවා | ඉඩ අරිනවා | ඉඩ දෙනවා | ඉඩ හරිනවා | ඉඩදෙනවා | ඒත්තු ගන්නවා | කල්පනාවට ගන්නවා | වෙන් කරනවා
allowable=අනුදතහැකි | අවසර දිය හැකි
allowance=අනුදතුව | අවසර දීම | ඉඩ හැරීම | ඉඩහැරීම | දීමනාව | ප්‍රතිභාගය | වාසිය | විවේතනය
allowed=අනුඥාත | අනුමත
alloy=කලවම | කලවම් කරනවා | දූෂ්‍ය කරනවා | මාත්තු | මාත්තු අඩු කරනවා | මාත්තු අඩු කිරීම | මිශ්‍ර ලෝහය | මිශ්‍රලෝහය | ලෝහ මිශ්‍රණය
alloying=මිශ්‍රලෝහ සෑදීම
allspice=සුගන්ධ ද්‍රව්‍යයක්
allude=ව්‍යංගයෙන් කියනවා | සඳහන් කරනවා
allure=අලවනවා | ආකර්ෂණය | ඇද ගන්නවා | ඇදෙනවා | පෙළඹවීම | පෙළඹෙනවා | පොළඹවනවා | මෝහනය | වසඟ කරනවා | විවත්‍රාංගය
allurement=ආකර්ෂණය | පෙළඹවීම | මෝහනය
alluring=පෙළඹවන
allusion=ඉඟිලෑම | ව්‍යංගය | සඳහන
allusive=ඉඟි කරන | සඳහන් කළ හැකි | හැඟවෙන
alluvial=දියළු
alluvial-clay=දියළු මැටි
alluvion=දියලුව | දියළු පස
alluvium=දියළු පස | දියළුව | බොර පස
ally=එකතු වෙනවා | පක්ෂය ගන්නවා | පාක්ෂිකයා | බැඳෙනවා | මිතුරා | මිතුරු වෙනවා | සම්බන්ධ වෙනවා | සහායයා | ස්වපාක්ෂිකයා
almanac=පංචාංගය | ලිත
almandine=රබහ
almighty=සර්වබලධාරී
almirah=අල්මාරිය
almond=කොට්ටම්බා | රට කොට්ටම්
almoner=දන් බෙදන්නා | දානාධිකාරී
almonry=දන් බෙදන තැන
almost=ඇති නැති තරම් | ඉතා කිට්ටුවෙන් | තව ඩිංගකින් | මුළුමනින් පාහේ | සම්පූර්ණයෙන් වාගේ | සම්පූර්ණයෙන්ම වාගේ
alms=දක්ෂිණාව | දන | දන් | දාන | දානය | පිනට දෙන දෙය
alms-gathering=පිණ්ඩ පාතය
alms-giving=දන්දීම | දානය | පිනටදීම | භික්ෂාව
alms-hall=දන්ගේ | දානශාලාව
almsman=දන් ලබන්නා
almucanter=ඇල්මුකැන්ටරය
alneon=ඇල්නියොන්
alnico=ඇලුනිකෝ
alocacia=හබරල
alocasia=හබරල
alodial=පූර්ණ අයිතිය සහිත
aloe=අගිල් | කෝමාරිකා
aloes=කෝමාරිකා සාරු
aloft=ඉහළ | ඉහළින් | උඩ | උඩට | උඩින් | උසක | මුදුනෙහි
alogia=අගද්‍යතාව
alone=උදකලා | උදක් | උදෙකලා | උදෙකලාව | එකලාව | තනි | තනියම | තනිව | තනිවම | පමණක් | මාත්‍රයක් | වෙන්ව | හුදකලා | හුදකලාව | හුදු | හුදෙකලා
aloneness=තනිකම | හුදෙකලාව
along=ඔස්සේ | දිගට | දිගේ | පසින්
alongside=දිගේ | පැත්තක | පැත්තකින්
alongst=දිගට
aloof=අහකින් | දුරින් | නොසැලකිලිවන්ත | පැත්තකට වී | වෙන්ව
aloofness=නොසැලකිලි බව | පැත්තකට වී සිටීම
alopecia=ඇලොපීසියාව | තට්ටය | මුඩු බව
aloud=තදින් | මහ හන් | සුප්‍රකාශව | හජ නගා | හයියෙන්
alp=උස් කන්ද
alpaca=ඇල්පකා | බැටළුවාගේ කෙස්
alpax=ඇල්පැක්ස්
alpestrine=අනුඇල්පයින්
alpha=ඇල්පා | ග්‍රීක් හෝඩියේ මුල් අකුර
alphabet=අක්ෂරමාලාව | අකාරාදිය | මලපත | ලිප | ලිපි | වර්ණමාලාව | සෝඩිය | හෝඩිය
alphabetical=හෝඩිය අනුව වූ
alphabetically=අකාරාදියේ පිළිවෙළට | හෝඩියේ පිළිවෙළට
alphabetising=අකාරාදිකරණය
alphanumeric=අක්ෂර සංඛ්‍යා | අක්ෂරාංක | අකුරු හා ඉලක්කම් දෙවර්ගයම අන්තර්ගත
alphatron=ඇල්පාට්‍රෝනය
alpine=ඇල්පයින් | ඉතා උස්ව පිහිටි | උස්ව පිහිටි | කඳුකර
already=කල් තබා | කලින් | කලින්ම | දැනුත් | මෙලහකට | මෙලහට | මේ වන විටත්
alright=හොඳයි
alsatian=සුනඛ විශේෂයක්
alsineae=අල්සිනේ
also=අමතරව | එසේම | තවත් | ත්
alstonite=ඇල්ස්ටොනයිට්
altaite=ඇල්ටෙයිට්
altar=අල්තාරය | පා තව්ව | පුදසුන | පූජාසනය
altarpiece=අල්තාර මණ්ඩලය
altazimuth=උන්නත දිගංශමානය
alter=අපර | මඳක් වෙනස් කරනවා | විවර්තනය කරනවා | වෙනස් කරනවා | වෙනස්වෙනවා
alterable=වෙනස් කළහැකි
alteration=මෝදනය | විකප්ප | විකාරය | විකෘතිය | විවර්තනය | වෙනස | වෙනස් කිරීම | වෙනස් වීම
alterative=මෝදකය
altercate=කලහ කරනවා | දබර කරනවා | පොර අල්ලනවා | විවාද කරනවා | හබ කරනවා
altercation=කලහය | දබරය | හබ කිරීම
altermative=හෝ
alternando=ඒකාන්තර ක්‍රමයෙන් | විපර්යායයෙන්
alternant=විපර්යස්තය
alternate=අනුකල්ප | අනුකල්පය | එකක් ඇර එකක් | ඒකාන්තර | ඒකාන්තරව යොදනවා | ප්‍රත්‍යාවර්තක | මාරුවෙන් මාරුවට ඇති | මාරුවෙන් මාරුවට කරනවා | මාරුවෙන් මාරුවට යොදනවා | මාරුවෙන් මාරුවට වෙනවා | විකල්ප | විකල්පය | විපර්යස්ත
alternating=ප්‍රත්‍යාවර්තන | පෘත්‍යාවර්තන
alternation=ඒකාන්තරණය | පරිවර්තනය | ප්‍රත්‍යාවර්තනය | විකල්පය | විපර්යාය
alternative=ඒකාන්තර | ඒකාන්තරික | පක්ෂය | විකල්ප | විකල්පය | විලෝමය | වෛකල්පික | වෛකල්පිත
alternatively=මාරුවෙන් මාරුවට | විකල්පයෙන්
alternatives=විකල්ප
alternatly=එකක් හැර එකක් ළෙස
alternator=ප්‍රත්‍යා වර්තකය | ප්‍රත්‍යාවර්තකය
although=එසේ වුවත් | එහෙත් | ත් | නමුත්
altimeter=ඇල්ටිමීටරය | උච්චමානය | උච්චමාපකය | උච්චාමානය
altiplane=උස්තැන්න
altiscope=පරීක්ෂය
altitude=උච්චය | උන්නතාංශය | උස
altitudes=උස් ප්‍රදේශ
alto=ඉතා උස් පුරුෂ ස්වරය හා ඉතා පහත් ස්ත්‍රී ස්වරය | තාරස්වරය
altogether=එකතුව | එහෙමපිටින් | මුළුමනින් | සහමුලින් | සහමුළින් | සියල්ල ම
altruism=පරහිතකාමිත්වය | පරහිතකාරිත්වය | පරාර්ථකාමය | පරාර්ථකාමිත්වය | පරාර්ථචර්යාව | පරාර්ථය ම තැකීම
altruist=පරහිතකාමී බව
altruistic=පරහිතකාරී
alu=අංකගණිත තර්ක ඒකකය | ඒඑල්‍ය
alum=ඇලම් | සීනක්කාරම් | සීනක්තාරම්
alumel=ඇලුමෙල්
alumian=ඇලුමියන්
alumina=ඇලුමිනා | ඇලුමිනියම් ඔක්සයිඩ්
aluminate=ඇලුමිනේට්
aluminiferous=ඇලුමිනියම්ධර
aluminite=ඇලුමිනයිට්
aluminium=ඇලුමිනියම | ඇලුමිනියම් | ඇලුමිනියම් නම් ලෝහ වර්ගය
aluminize=ඇලුමිනියම් ආලේප කරනවා
aluminosilicate=ඇලුමිනෝසිලිකේට්
aluminosis=ඇලුමිනියාව
aluminothermy=ඇලුමිනොතාපත්වය
aluminum=ලෝහ වර්ගයක්
alumite=ඇලුමයිට්
alumna=ආදිශිෂ්‍යාව
alumni=අත වැසියෝ | උපාධිධරයෝ
alumnus=අතවැසියා | ආදිශිෂ්‍යයා | උපාධිධරයා | ඡාත්‍රයා | විද්‍යාසේවියා
alundum=ඇලන්ඩම්
alunite=ඇලුනයිට්
alunogen=ඇලුනෝජන්
alveary=කන්සිල | මීවදය
alveolar=ගර්ත්‍ය | ගර්තික | දන්තමූලජ | මූර්ධජ
alveolate=ගර්තික
alveole=ගර්තය
alveoli=ගර්ත
alveolus=ගර්තය
alvite=ඇල්වයිට්
alway=නිතර | නොනැවත | සැමදා | සැමවිට
always=අනවරතයෙන් | තිස්සේ | දවහ | නිතර | නිති | නිබඳ | නිරතුර | නොනැවත | සතන | සදහට | සැමදා | සැමවිට | හැමවිට
alyssicarpus=අස්වැන්න
alyssum=මල් ගසක්
am=ඉඳිමි | වෙමි යන අරුත | සිටිමි
amain=මුළු වේගයෙන් | මුළු ශක්තියෙන්
amalgam=කලවම | කවලම | රසදිය මිශ්‍ර ලෝහ | රසදිය මිශ්‍ර ලෝහය | සංයෝගය | සංරසය
amalgamate=එක් කරනවා | ඒකාබද්ධ කරනවා | මිශ්‍ර කරනවා | මුසු කරනවා | සංරස කරනවා | සංසර්ජනය කරනවා | සම්බන්ධ කරනවා
amalgamation=ඒකාබද්ධ කිරීම | ඒකාබද්ධ වීම | සංකලනය | සංගත කිරීම | සංරසීකරණය | සංසර්ජනය | සම්බන්ධනය | සම්බන්ධය
amalgamator=සංරසීකාරකය
amanuenses=ලිපිකරුවෝ | ලේකම් වරු | ලේඛකයෝ
amanuensis=පිටපත් ලියන්නා | ලිපි ලියන්නා | ලිපිකරුවා | ලේකම් | ලේඛක
amaranth=තම්පලා
amass=එක්කාසු කරනවා | ගොඩ ගසනවා | ගොඩ ගහගන්නවා | ගොඩ ගහනවා | රැස් කරනවා
amateur=අවෘත්තීය | ආධුනික | ආධුනිකයා | කලාකාමී | කලාප්‍රියයා | කෝඩුකාරයා | නවකයා | නොපුරුදු අය | රමකයා
amateurish=අදක්ෂ | අසම්පූර්ණ
amative=ප්‍රෙමශීලි | ප්‍රේමාතුර | රාගශීලී | රාගික
amatol=ඇමටොල්
amatory=කාමුක | රතිකාමී | රාගාන්විත
amaurosis=ඇමොරෝසියාව
amaze=පුදුමයට පත් කරනවා | භයට පමුණනවා | මවිත කරනවා | වික්ෂේපයට පමුණනවා | විමතියට පත් වෙනවා | විස්මයට පත් වෙනවා | විස්මයට පමුණනවා
amazed=භයට පමුණුවන | මවිත කරන | වික්ෂේපයට පමුණුවන | විස්මයට පමුණුවන
amazement=මවිත කිරීම | මවිතය | විස්මය
amazing=භයට පමුණුවන | මවිත කරන | වික්ෂේපයට පමුණුවන | විස්මයට පමුණුවන
amazon=යුධකාමී ස්ත්‍රී | යෝදි
amazonite=ඇමසොනයිට්
ambalama=අම්බලම
ambassador=තානාපති | රාජදූතයා
ambassadorial=තානාපති සේවය හා සම්බන්ධ
amber=අරුණ වර්ණය | අරුණු වර්ණය | ඇම්බර | ඇම්බර් | කහ පාටට හුරු | කහපාටට හුරු | තෘණමණි
ambergris=තල් මසුන් බඩේ හැදෙන සුවඳ ජාතියක් | තල්මසුන්ගේ බඩවැලේ ඇති වන සුවඳ වර්ගයක් | නිවර්තන කලාපීය මුහුදු මත ඇති වන සුවඳ වර්ගයක්
amberite=ඇම්බරයිට්
ambi=උභය
ambidexter=දෙපිටකාට්ටුවා
ambidexterity=දෑත ම හුරුකම
ambidexterous=දෑතහුරු
ambidextrality=දෑත් හුරුව
ambidextrous=දෙපිටකාට්ටු
ambience=වාතාවරණය
ambient=පරිමණ්ඩිත | වටේ | හාත්පස | හාත්පස පැතුරුණු
ambiguity=අනේකාර්ථය | අර්ත ව්‍යාකුල බව | උභයාර්ථතාව | උභයාර්ථය | බහු අර්ථතාව | බහුඅර්ථතාව | බහුරුත් බව | බහුරුන් බව | වක්‍රෝක්තිය | ව්‍යාකූලත්වය | සංදිග්ධතාව | සංශය
ambiguous=අර්ථ දෙකක් ඇති | අස්පෂ්ට | උභයාර්ථ | උභයාර්ථවාචී | දෑත කැපෙන | නොපැහැදිලි | බහ්වර්ථ | බහුරුත් | සංදිග්ධ | සැක සහිත
ambilataral=උභය පාර්ශ්වික
ambilateral=උභයපාර්ශ්වීය
ambit=පරිමාණය | මණ්ඩලය | විෂය | විෂයසීමාව | සීමාව
ambition=අභිලාෂය | උන්නතිකාමය | උසස් වීමේ ආශාව | කීර්තියට අභිලාෂය | දියුණුවීමේ ආශාව | පරමාර්ථය | බලයට අභිලාෂය | මනදොළ | මනෝරථය | මහේච්ඡාව | විගීෂාව | හිවියැටිය
ambitious=කැමති | මහාඅපේක්ෂා සහිත | මහේච්ඡ
ambivalence=උභයවේගිතාව | උභයාවේගිකතාව | උභයාවේගිතාව | සැකමුසු හැඟීම
ambivalent=උභයවේගිතාව | දෙගිඩියාව | විපිළිසරය
ambivence=උභයවර්තිකයා
ambiversion=උභය වර්තනය | උභයවර්තනය
ambivert=උභයවර්තකයා
amble=ඇවිදිනවා | පැද්දි පැද්දී යනවා | හීන් පිම්මෙන් දුවනවා | හෙමින් යනවා
amblygonite=ඇම්බ්ලිගොනයිට්
amblyomma=ඇම්බිලියෝමා
amblyopia=ඇමබිලියෝපියාව | හීනවාක්ෂුසය
amblyscope=තිමිරේක්ෂය
ambocepter=ඇම්බොසෙප්ටරය | උභයග්‍රාහකය | ප්‍රතිශක්ති දේහය
ambrion=ඇම්බ්‍රියොන්
ambrite=ඇම්බ්‍රයිට්
ambron=ඇම්බ්‍රෝනය
ambrosia=අම | අමෘතය | දිව්‍ය භෝජනය | දෙවියන්ගේ ආහාරය | සුධා | සුධා භෝජනය
ambrosiac=අමාර්තකය
ambrosial=අමෘතමය | ඉතා ප්‍රණීත
ambulacral=චරණාර
ambulance=ගිලන් රථය | ගිලන්‍රථය | ගිලන්‍රිය
ambulate=සංචාරණය කරනවා | සක්මන් කරනවා
ambulatory=ඇවිදින | පරිගාමි | පිරිගැමි | සක්මණේ යෙදුන් | සක්මන | සක්මන් | සක්මන්ගත | සක්මන්මළුව
ambuscade=පහර ගැසීමට රකිනවා | පහර දීමට රකිනවා | පහර දීමට රැක සිටීම | රහසින් රැකසිටීම | සැගවී සිට පහර දෙනවා | සිටින තැන | සිටින සේනාව
ambush=පහර දීමට රැක ඉන්නවා | පහර දීමට රැක සිටිනවා | පහර දීමට රැක සිටීම | රහසින් රැකසිටීම | රැක සිට පහර දෙනවා | රැක සිටින තැන | සිටින තැන | සිටින සේනාව
ambushment=පහර දීමට රැක සිටීම | රැක සිට පහර දීම
ameba=ක්ෂුද්‍ර ප්‍රාණි විශේෂයක්
amechanical=අයාන්ත්‍රික
ameer=ඇ්ගනිස්තානයේ රජ | මුස්ලිම් රටවල රජදරුවෙක්
ameliorate=දියුණු කරනවා | දියුණු වෙනවා | වැඩි දියුණු කරනවා
amelioration=දියුණු කිරීම | වැඩි දියුණුව
ameliorative=දියුණු වන
amen=එසේ වේවා | ඒ එසේ වේවා | සාධු
amenable=අවනත | අවවාදයට නැමෙන | කීකරු | නම්‍ය | නැමෙනසුලු | වගකියයුතු | විනීත | විනේය | ශික්ෂාකාමී | සුඛනම්‍ය | සුනම්‍ය | හීලෑ
amenably=කීකරු ලෙස
amenage=හීලෑ කරනවා
amend=වරද හරිනවා | සංශෝධනය කරනවා | සකස් කරනවා
amendable=ඇහුම්කන් දෙන | නම්‍ය | නැමෙන
amendment=අතුරු යෝජනාව | වඩා යහපත් කිරීම | වෙනස් කිරීම | ශුය | සංශෝධකය | සංශෝධනය | හරිගැස්සීම
amendo=හානිසහනය
amends=වන්දි ගෙවීම | වරද පිරිමැසීම | හානිසහනය | හිලව්ව
amenities=පහසුකම් | මනෝඥ ලක්ෂණ | සැපපහසුකම් | සුව පහසුකම් | සුවපහසුකම්
amenity=අනුකූලතාව | ප්‍රසන්නකම | ප්‍රසන්නභාවය | මනොඥභාවය | රම්‍යතාව
amenkment=සංශෝධනය
amenorrhaea=අනාර්තවය | ඇමිනෝරියාව
amenorrhoea=ඔසප් නොවීම
ament=අමනයා | ඇමෙන්ටම | පුච්ඡය
amentaceous=පුච්ඡරූපී
amentia=අමනස්‍යය | සිහිවිකල බව | සිහිවිකලබව
amentiferous=පුච්ඡධර
amentiflorae=අමෙන්ටිප්ලෝරේ
amentum=ඇමෙන්ටම
amerce=අහිමි කරනවා | දජුවම් කරනවා | දඩ ගසනවා
amercement=ඉච්ඡා දණ්ඩය
amerciament=ඉච්ඡා දණ්ඩය
america=අමෙරිකාව
american=ඇමෙරිකානු
americium=ඇමෙරිසියම් | විකිරණශීලීතාවෙන් යුත් කෘත්‍රිම ලෝහමය මූලද්‍රව්‍යයක්
amerindian=ඇමරින්දියානු | ඇමරින්දියානුවා
amesite=අණුමයික්‍රෝනය | ඇමෙසයිට්
amethocaine=ඇමිතොකේන්
amethopterin=ඇමිතොප්ටෙරින්
amethyst=අමතේස්ත | අඹතේස්ත
ametrometer=දෘෂ්ටිභ්‍රමමානය
ametropia=දෘෂ්ටිභ්ර්රමය
amharic=ඉතියෝපියානු භාෂාවක්
amiability=ඉතා ප්‍රිය උපදවීම
amiable=ආදරණීය | ඉතා ප්‍රිය උපදවන | ගුණවත් | දයාන්විත | මිත්‍රශීලී
amiableness=ගුණවත්කම
amicable=මිත්‍ර | මිත්‍රවත් | සමගි සම්පන්න | සුහද | හිතවත්
amicably=මිත්‍ර ලීලාවෙන් | සමගියෙන්
amid=අතර | අතරේ | මධ්‍යයේ | මැද
amidase=ඇමයිඩේස්
amidation=ඇමයිඩ්කරණය
amide=ඇමයිඩය
amidopyrine=ඇමිඩොපයිරින්
amidoxyl=ඇමයිඩොක්සිල්
amidships=නැව මැද
amidst=අතර | අතරේ | මධ්‍යයෙහි | මැද
amimia=අනිඟියාව
amination=ඇමයිනීකරණය
amine=ඇමයින් | රසායන සංයෝගයක්
amino-acid=ඇමයිනෝ අම්ලය
aminoid=ඇමයිනොයිඩ්
aminopterin=ඇමිනොප්ටෙරීන්
amir=ඇගනිස්තානයේ රජ | මුස්ලිම් රටවල රජදරුවෙක්
amiss=අනිසිව | අනුවත | වරදවා | වැරදි | වැරදි ලෙස | වැරදියට | සදොස් | සදොස්ව
amissible=නැති විය හැකි
amitosis=සරල විජානනය | සරල විභාජනය
amitotic=සරල විභාජක
amity=මිත්‍රත්වය | යාළුකම
amixia=නුමුහුම
ammeter=ඇමීටරය
ammine=ඇම්මයින්
ammino=ඇම්මයිනො
ammiolite=ඇම්මයොලයිට්
ammite=ඇම්මයිට්
ammonal=ඇමෝනැල්
ammonate=ඇමෝනේට්
ammonia=ඇමෝනියා | ඇමෝනියා වායු මිශ්‍ර දිය | ඇමෝනියා වායුව | වාෂ්පශීල ක්ෂාරය
ammoniacal=ඇමෝනීය
ammonification=ඇමොනීකරණය | ඇමෝනීකරණය
ammonifying=ඇමෝනි කිරීම | ඇමෝනීකාරී
ammonite=අත්තක් මෙන් හැඩ වූ පොසිල | ඇමොනයිට් | ඇමොනීටයා
ammonium=ඇමෝනියම්
ammonobacteria=ඇමෝනොබැක්ටීරීයා
ammonolysis=ඇමෝනියා විච්ඡේදනය
ammophilous=වාලුකාමි
ammunition=උණ්ඩ | තුවක්කු | පතරොම් | වෙඩි බෙහෙත්
amnesia=අවසිහිය | විස්මෘතිය | සමාව දෙනවා
amnesty=දඩසමාව | පොදු සමාව | පොදුසමාව | රාජ්‍ය සමාව | රාජ්‍යසමාව | සමාව දෙනවා
amnion=ඇම්නියන | උල්බය
amniotic=ඇම්නියන | උල්බ
amoeba=ඇමීබා | ඒක සෛල ඡීවියා | ක්ෂුද්‍ර ප්‍රාණි විශේෂයක්
amoebiasis=ඇමීබයසියාව
amoebicide=ඇමිබානාශකය
amoeboid=අමීබාභ | ඇමීබාකාර
amok=අමොක් | අමොක් උන්මාදය | උමතු වැටී | දුටු දුටුවන් මරමින් | වියරු වැටී | වියරුවී
among=අතර | අතරින් | අතරෙන් | අතරෙහි | අතුරෙහි | අන්තර | අස්සෙහි | අස්සේ | කෙරෙහි
amongst=අතර | අතරෙහි | අතුරෙහි | අන්තර් | අන්තහ් | අන්තෝ | කෙරෙහි
amoral=අව්‍යාකෘත | ආචාරශීලී නොවූ | නිරාචාරවත් | නිරාචාරී | විශීල
amoralism=නිරාචාරවාදය
amorino=කුමර මල්සර
amorist=ප්‍රේමවන්තයා
amorous=අනුරාගී | කාමුක | ප්‍රේමාතුර | ශෘංගාරී
amorousness=අනුරාගය | කාමුක බව
amorphism=අස්විටිකතාව | නිහැඩවීම
amorphophallus=ඇමෝපොපැලස්
amorphous=අනියතාකාර | අස්ඵටික | අස්ඵුටික | නියම හැඩහුරුකමක් නැති | නිරූපමය | නිහැඩ | විරූපී
amorphousness=අස්ඵටික වීම
amortisation=ක්‍රමක්ෂය | ක්‍රමපක්ෂයය | කාලික ණය නිදහස් කිරිම
amortization=ක්‍රමක්ෂය | ක්‍රමක්ෂයය
amortize=ක්‍රමක්ෂය කරනවා | ණය හිලව් කරනවා
amosite=ඇමොසයිට්
amount=එකතු වෙනවා | එකතුව | එකතුව වශයෙන් ලැබෙනවා | එකතුවෙනවා | ගණන | ගණිනවා | පමණ | පලඟ | ප්‍රතිඵලය | ප්‍රමාණය | මුදල් ප්‍රමාණය | මුළු ගණන | මුළු මුදල | වටිනාකම | වටිනාකම වශයෙන් ලැබෙනවා | විතර | සංඛ්‍යාව | සලකනු ලබනවා
amour=ප්‍රේමසම්බන්ධය
amp.=ඇම්පි
ampelite=ඇම්පෙලයිට්
amperage=ඇම්පියරතාව
ampere=ඇම්පියරය
ampere-hour=ඇම්පියර පැය
ampere-meter=ඇමීටරය
ampere-turn=ඇම්පියර වටය
amperometer=ඇමීටරය
amperometry=ඇම්පියරොමිතිය
amphetamine=ඇම්පෙටමින්
amphi=උභය
amphiathroses=උභපාර්වය
amphibia=උභයවීහු
amphibian=උභයචර | උභයවි | උභයවී
amphibious=උභය වි | උභයචර | උභයචාරී | උභයවී | භූජලචර
amphibology=බහු අර්ථතාව
amphiboly=වාක්ඡලය
amphichroic=උභයවර්ණක
amphichromatic=උභයවර්ණක
amphicribral=උභය ප්ලෝයමීය
amphicryptophyte=උභය ගුප්ත ශාකය
amphigastrium=අම්පිගස්ත්‍රිය | ජඨරපත්‍රය
amphigynous=උභයජායාංගී
amphimixis=දෙමුහුව | සංයෝගතාව
amphinereid=උභය ශාකය
amphioxus=ඇම්පියොක්සස්
amphiphyte=උභයශාකය
amphiprotonic=උභයප්‍රෝටෝනික
amphitheatre=අර්ධමණ්ඩල රංගපීඨය | මණ්ඩල මාලය | මණ්ඩලමාලය | රංගපීඨය | රංගභූමිය | රංගාවාටය
amphithecium=අම්පිතීසිය | බහිෂ්කලාපය
amphitrichous=උභයකේශරී
amphitropous=අඩකුරු
amphivasal=උභය ශෛලමය | උභය ශෛලමීය
amphora=ඇම්පෝරාව | ග්‍රීසියේ හෝ රෝමයේ භාවිත කරන මිටවල් දෙකක් ඇ
amphoteric=උභයගුණී
ample=ප්‍රමාණවත් | විපුල | විශාල | සෑහෙන | හොඳටම සෑහෙන
amplexicaul=ආලිංගික
amplidyne=ඇම්ප්ලිඩයිනය
amplification=වර්ධනය | වැඩි දියුණු කිරීම | විශාල කොට දැක්වීම | විස්තර කොට දැක්වීම | විස්තර දැක්වීම | විස්තාරණය | විස්තාරය
amplified=වර්ධිත
amplifier=වර්ධකය | විකාශන යන්ත්‍රය | විස්තාරකය | ශබ්ද වාහිනිය | ශබ්දවාහිනිය
amplify=වර්ධනය කරනවා | විකාශනය කරනවා | විස්තර කරනවා | විස්තාරණය කරනවා | විස්තීරණය කරනවා
amplifying=වර්ධක
amplitude=විශාලත්වය | විස්තාරය
amply=ප්‍රමාණවත්ව | සෑහෙන පරිදි
ampoule=එන්නත් කිරීමට ඇති ද්‍රාවණය බහා ඇති මුද්‍රා තබන ලද
ampulla=කුම්බිකාව | පලිඝය
amputate=අතු කපා දමනවා | අවයව කපනවා | අවයව කපා දමනවා | ඡේදනය කරනවා
amputation=අංගච්ඡෙදනය | අංගඡේදනය | ඡේදනය කිරීම | විශසනය
amuck=දුටු දුටුවන් මරමින් | වියරු වැටී
amulet=කවචය | පරිත්‍රය | යන්තරය | යන්ත්‍ර | සුරය
amulet-stone=යන්ත්‍රගල
amuse=විනෝද වෙනවා
amusement=ප්‍රමෝදනය | බහුරූ | විනෝදය | විනෝදාත්මක ක්‍රියාව | සෙල්ලම
amusia=ඇමියුසියාව
amusing=විනෝදජනක | විනෝදය උපදවන | හාස්‍ය ජනක | හාස්‍යජනක
amyctic=කසනය
amygdalase=ඇමිග්ඩලේස්
amygdalin=ඇමිග්ඩලින්
amylaceous=පිෂ්ට
amylase=ඇමයිලේස් | ඇමිලේස්
amylobacter=ඇමිලොබැක්ටර්
amylocellulose=ඇමයිලොසෙලියුලෝස්
amylodextrin=ඇමයිලොඩෙක්ස්ට්‍රින්
amyloerythrin=ඇමයිලොඑරිත්‍රින්
amylograph=ඇමිලොමානය
amyloid=පිෂ්ටමය
amyloidal=පිෂ්ටමය
amylolysis=ඇමිලො විච්ඡේදනය
amylolytic=ඇමයිලොලිටික | ඇමිලොවිච්ඡේද
amylopectin=ඇමයිලොපෙක්ටින්
amyloplast=පිෂ්ට ලවය | පිෂ්ටලවය
amylose=ඇමයිලෝස්
amylosin=ඇමයිලොප්සින්
amylostatolith=පිෂ්ට තුලාශ්මය
amylum=ඇමයිලම්
an=එක්
anabasine=ඇනබසීන්
anabasis=ප්‍රතිප්‍රාන්ත ගමන
anabatic=උඩුමුවා | උඩුසර | ප්‍රතිප්‍රාන්ත
anabolic=සංවෘත්ති
anabolism=උක්ඛිත්තිය | සංවෘත්තිය
anabolite=සංවෘත්තිජය
anachronism=කාල විරෝධය | කාලව්‍යතික්‍රමය
anaclastic=වර්තක
anaclinal=ප්‍රත්‍යභිනතිය | ප්‍රත්‍යවපාතය
anaclitic=ආදිසංගික
anaconda=ඇනකොන්ඩා නමැති දැවැන්ත සර්පයා
anacrogynous=අනග්‍රජායාංගී
anadromous=ප්‍රතිස්‍රෝතගාමි | ප්‍රතිස්‍රෝතගාමී
anaemia=නීරක්තිය | පාණ්ඩුව | රක්තහීනතාව | ලේ අඩුකම
anaemic=පිපිහළු | ලේ අඩු
anaerobe=නිර්වායු ජීවියා | නිර්වායු වියා | නිර්වායුවියා | නිර්සානිලයා
anaerobic=නිර්වායු | නිර්වායුවී
anaerobiosis=නිර්වායු ජීවනය
anaerobium=නිර්වායු ජීවියා
anaesthesia=නිර්වින්දනය
anaesthesis=නිර්වින්දනය
anaesthetic=නිර්වින්දක | නිර්වින්දකය | නිර්වින්දන | නිශ්චේතක | නිශ්චේතකය | නිෂචේතකය | වේනාව වළකන
anaesthetist=නිර්වින්දකයා | වර්ණ විපර්ය්‍යය
anaglyph=උන්නත රූප
anaglyphoscope=උන්නතරූපේක්ෂය
anaglyptoscipe=උන්නතරූපේක්ෂය
anagoge=ගූඩ අර්ථකථනය
anagogic=ආලාක්ෂික | සාමුක්කංසික
anagogie=සාමුක්කංසික
anagram=වර්ණ විපර්යාසය | වර්ණවිපර්යාසය
anal=ගුද
analcime=ඇනල්සයිම්
analcite=ඇනල්සයිට්
analect=සුභාෂිත වාක්‍යය
analema=ඇනලේමාව
analgesia=අනර්දනය | රුජානසනය
analgesic=නිර්වේදනික | රුජා නසන | රුජා නැසීම
analgic=නිර්වේදනික
analog=ප්‍රතිසමය
analogic=සාදෘශ්‍ය
analogical=ආනුෂංගික | තුල්‍යරූප | සමානකම් ඇති | සාදෘශ්‍ය | සාදෘශ්‍යක | සාදෘශ්‍යමූලක | සාදෘශ්‍යය
analogism=සාදෘශ්‍ය තර්කය | සාදෘශ්‍යතර්කය | සාදෘශ්‍යවාදය
analogous=ආනුෂංගික | තුල්‍යරූප | ප්‍රතිසම | සම | සමකාර්ය | සමාකාර | සමාන | සමානකම් ඇති | සාදෘශ්‍ය
analogue=ප්‍රතිසම | ප්‍රතිසමය | සමකාරකය | සමකාර්යතාව | සමාන වස්තුව | සමානවස්තුව | සසාදෘශ්‍යය | සාදෘශ්‍යය
analogy=උපමිතිය | ප්‍රතිසමතාව | ප්‍රතිසමය | ප්‍රතිසාම්‍යය | සදෘශීකරණය | සමකාර්යතාව | සමාකාරය | සාදෘශ්‍යය | සාම්‍යය
analysable=විශ්ලේෂණය කළ හැකි | විශ්ලේෂණීය | විශ්ලේෂ්‍ය
analyse=බෙදා වෙන්කරනවා | විග්‍රහ කරනවා | විභාග කරනවා | විශ්ලේෂණය කරනවා
analyser=විශලේෂකය | විශ්ලේෂකය
analysis=බෙදා වෙන් කිරීම | ව්‍යාකෘතිය | විග්‍රහ කරනවා | විග්‍රහය | විභජනය | විභාගය | විශලේෂණය | විශ්ලේෂණය
analyst=රස පරීක්ෂක | රසපරීක්ෂක | විශ්ලේෂක | විශ්ලේෂකයා
analystic=විග්‍රහාත්මක | විශ්ලේෂී
analytic=තාත්වික | ප්‍රභේද පරික්ෂා කරන | විශ්ලේෂ | විශ්ලේෂී | විස්තර විභාග දක්වන
analytical=තාත්වික | ප්‍රභේද පරීක්ෂා කරන | විග්‍රහාත්මක | විශ්ලේෂක | විශ්ලේෂණ | විශ්ලේෂණාත්මක | විශ්ලේෂණීය | විශ්ලේෂි | විශ්ලේෂී | විස්තර විභාග දක්වන
analytically=විශ්ලේෂණයෙන් | විස්තර විභාග වශයෙන්
analyticity=විශ්ලේෂණීයත්වය | විශ්ලේෂතාව
analyze=බෙදා වෙන්කරනවා | විභාග කරනවා | විශ්ලේෂණය කරනවා
analyzer=විශ්ලේෂකය
anamaloscope=විෂමේක්ෂය
anamnesis=ප්‍රතිස්මරණය | ප්‍රතිස්මෘතිය | ස්මරණය | සිහිකිරීම
anamorphosis=විරූපිතය
ananassativa=අන්නාසි
anant=විලම්බිතව
anapaest=වායු ගණය | වියුගණය | සගණය
anaphase=වියෝග කලාව | වියෝගකලාව
anaphasis=වියෝගකලාව
anaphia=විස්පර්ශය
anaphoresis=ඇනෝඩාගමනය
anaphylactic=අසංරක්ෂිත
anaphylaxis=අසංරක්ෂණත්වය | අසංරක්ෂත්වය
anaptyxis=ස්වරභක්ති
anarchic=අවුල් වියවුල් ඇති
anarchism=අරාකවාදය | අරාජකත්වය | අරාජිකත්වය | ස්වෛරී වාදය | ස්වෛරීවාදය
anarchist=රජයත් නීතියත් අවලංගු කරන්නා
anarchosyndicalism=අරාජසම්මේලවාදය
anarchy=අරාකත්වය | අරාජකත්වය | අරාජකතාව | ආකූලත්වය | රාජවිප්ලවය
anarthria=අනාර්ත්‍රියාව | ස්වනභංගය
anasarca=උච්ජූනය
anaseismic=සිරස් භූස්පන්දන
anastigmatic=අනපේරණ
anastomosis=ජාලයෝගය | ප්‍රාභිමුඛණය | ප්‍රාභිමුඛිතය | යෝගය | සම්මුඛනය | සම්මුඛය
anatase=ඇනටේස්
anathema=අතිශය පිළිකුල | අභිශාපය | ජුගුප්සාව උපදවන දේ
anatomic=ශරීරය පිළිබඳ
anatomical=ව්‍යවච්ඡෙදක | ව්‍යවච්ඡේදක | ශරීරය පිළිබඳ
anatomist=ව්‍යවච්ඡේදකයා | ශරීරස්ථානය දත් තැනැත්තා
anatomy=ව්‍යවච්ඡෙදය | ව්‍යවච්ඡේද විද්‍යාව | ව්‍යවච්ඡේදය | ව්‍යවඡේදය | ව්‍යහ විද්‍යාව | ව්‍යහ විද්‍යාව | ව්‍යහය | ව්‍යහවිද්‍යාව
anatropous=යටිකුරු
anbolism=සංවෘත්තිය
ancestor=ආදිජයා | ආදිපුරුෂයා | පුර්වජයා | පූර්වජයා | මුතුන් මිත්තා | මුතුන්මිත්තා | මුතුමිත්තා
ancestors=මුතුන් මිත්තෝ
ancestral=ආදිකාලීන | ආදිජ | පරම්පරාගත | පරවෙණි | පාරම්පරික | පුර්වජ | පූර්වජ | පෞරාණික | මුතුන්මිත් | වංශානුගත | වරන්තන
ancestress=මුතුන් මිත්තියෝ
ancestry=කුල පරම්පරාව | පරපුර | පරම්පරාව | පෙළපත | පෙළැන්තිය | වංශය | වංසය
anchor=ආධාරය | ආරක්ෂාව සලසන දේ | නවතිනවා | නැංගුරම | නැංගුරම හෙළනවා | නැංගුරම් ලනවා | බරුව | ලකනක | ලකනැකිය | සිනි | සිනිකඳ | සීනි එළනවා
anchorage=ආරක්ෂාව | නැංගුරම් ගාස්තුව | නැංගුරම් ලෑම | නැංගුරම්පළ | ලකනැකිය | ලැංකුරම් ගාස්තුව
anchorite=අරණ්‍යවාසියා | ආරණ්‍යකයා | තාපසයා | සන්නාසියා
anchovy=හාල්මැස්සා
anchusa=ශාක විශේෂයක්
ancient=අතිපූර්ව | අතීත | ආදි | ආදිකාලීන | ඉතා පැරණි | කල් ගිය | පරණ | ප්‍රාක් | ප්‍රාක්තන | ප්‍රාග් | පැරණි | පැරන්නා | පැරන්නෝ | පැරැණි | පුරාණ | පුරාතන | පුරාතනයෝ | පූර්ව | පොරණ | පෞරාණික | වරන්තන
ancillary=අනු | අනුයාත | උපබද්ධ | උපයෝගී | උපසේවී | යටත් | සමග යොදුණු | සහයෝගී
ancilliary=අනුයාත
ancona=මහා අල්තාර මණ්ඩලය
and=එවිට | ත් | ද | පිණිස | සහ | හා
anda=අඳය
andalusite=ඇන්ඩලුසයිට්
andamanese=අන්දමනිකයෝ
andante=විලම්බිත රාගය
andesine=ඇන්ඩසීන්
andesite=ඇන්ඩසයිට්
andiron=ගිනි උදුනක දර දහනයට පහසු වන සේ තනා ඇති ලෝ
andorite=ඇන්ඩොරයිට්
andose=ඇන්ඩෝස්
andradite=ඇන්ඩ්‍රඩයිට්
androcracy=පූමිශ්වරත්වය
androcyte=පුංසෛලය
androdioecious=පුංද්විගෘහික
androecial=පුමංගී
androecium=පුමංගය
androgametangium=ඇන්තරීඩිය | ශුක්‍රාණුධානිය
androgamete=ශුක්‍රාණුව
androgonidium=පුංබීජාණුව
androgynophore=පුංජායාංගධරය
androgynous=පුංඡායාංගධාරී | පුංජායාංගී
androgyny=ඒකගෘහිකතාව | පුංජායාංගතාව
andromonoecious=පුංඒකගෘහික
androphile=මනුකාමියා
androphore=ඇන්ඩ්‍රොපෝරය | පුමංගධරය
androsporangium=ඇන්ඩ්‍රොස්පොරැන්‍ය | පුංබිජාණුධානිය
androspore=ඇන්ඩ්‍රොස්පෝරය | පුංබිජාණුව | පුංබීජාණුව
androzoogonidium=ඇන්ඩ්‍රොස්පෝරය | පුංබීජාණුව
anecdotage=දොඩවන මහලු කාලය
anecdote=අතුරුකථාව | උපඛ්‍යානය | උපාඛ්‍යානය | කෙටි කතාව | ප්‍රවෘත්තිය | රස කතන්දරය | වෘත්තාන්තය
anechoic=ප්‍රතිරාවය නැති
anelastic=නිෂ්ප්‍රත්‍යාස්ථ
anelasticity=නිෂ්ප්‍රත්‍යාසථතාව
anelectrotenus=අවිද්‍යුත්තානය
anemia=ලේ අඩුකම
anemochore=වාතව්‍යාප්තිය
anemochorus=වාතව්‍යාප්ත
anemochory=වාතව්‍යාප්තතාව
anemogram=අනිලප්‍රස්තාරය
anemograph=අනිල දර්ශකය
anemometer=අනිලමානය | අනිලමාපකය | ඇනිමෝමීටරය
anemometere=අනිලමානය
anemone=ශාක විශේෂයක්
anemophilous=වාතකාමී
anemophobe=වාතභීතික ශාකය | වාතවිරත ශාකය
anemophobous=වාතභීතික | වාතවිරත
anemoplankton=වායව ප්ලවාංග
anemotropism=අනිලානුවර්තනය
anencephaly=නිෂ්පාලික
anent=උදෙසා | ගැන | පිළිබඳ
anergung=අන්‍රෙගුම
aneroid=නිර්ද්‍රව | නිර්ද්‍රව පීඩනමානය
aneroidograph=නිර්ද්‍රව පීඩනදර්ශකය
anesosite=ඇනිමොසයිට්
anesthesia=නිර්වින්දනය
anesthetic=නිර්වින්දක | නිර්වින්දකය | නිශ්චේතකය
aneurin=ඇනියුරින්
aneurysm=උපුලුව
anew=අභිනවයෙන් | අමුතුවෙන් | අලුතින් | නැවත | වෙනක්‍රමයකින්
angary=අංගරිය
angel=ඒන්ජලය | දෙව්දුව | දේවදූතයා | පිහිටක් සලසන තැනැත්තා | සුරදූතයා
angelic=ඉතා කරුණාවන්ත | දිව්‍යමය
angelica=සුවඳවත් ශාඛ විශේෂයක්
angelical=ඉතා කරුණාවන්ත | දිව්‍යමය
angelus=දේවමාතාවට කරන විශේෂ යාච්ඤාව
anger=උදහස | එදිරිය | ක්‍රෝධය | කේන්තිය | කෝ | කෝප කරනවා | කෝපය | තරහ | තරහ අවුස්සනවා | ද්වේෂය | දැහැවිල්ල | දැහැවෙනවා | පටිච්චසමුප්පාදය | ප්‍රකෝපය | ප්‍රතිඝය | රැහැණි | රෝෂය | සරොස
angina=අධික වෙහෙස නිසා ඇතිවන පපුවේ රිදුම
angiocarpic=ආවෘතඵලීන
angiocarpous=ආවෘතඵලීන
angiology=වාහිනී විද්‍යාව
angioneurosis=ඇංගියෝනියුරෝසියාව
angiosperm=ආවෘතබීජකය | විවෘතබීජක ශාකය
angiospermae=අන්ගියොස්පෙර්මේ
angiospermal=ආවෘතබීජක
angiospermous=අන්ගියොස්පෙර්මීය
angiosporae=අන්ගියොස්පෝරේ
angiosporous=ආවෘතබීජාණුක
angle=ඇමක් දමනවා | කොණ | කොන | කෝණය | කෝනය | බිලි කොක්ක | බිලි බානවා | බිලී බානවා | බිලීකොක්ක | මාළු බානවා | මුල්ල | මුලු
angle-iron=හැඩයකඩ
angler=මාළු අල්ලන්නා
anglesite=ඇංග්ලසයිට්
anglican=එංගලන්ත සභාවට අයිති
anglicism=ඉංග්‍රීසි පන්නය
anglicize=ඉංග්‍රීසි පන්නයට හරවනවා | ඉංග්‍රීසි භාෂාවට හරවනවා
anglo=ආංගලීය | ඉංග්‍රීසි
anglomania=ඉංග්‍රීසි පිස්සුව
anglophobia=ඉංග්‍රීසියට විරුද්ධ බව | ඉංග්‍රීසීන් නුරුස්නා අය | ඉංග්‍රීසීන් නුරුස්නා බව
angora=ඇංගෝරා | ඇන්ගෝරා සතාගේ ලෝමවලින් සාදන පිළී
angrily=තරහෙන්
angry=උරණ | කිපුණු | කුපිත | තරහ | විරසක | සරොස්
angst=කාංසාව | සාංකාව
angstrom=ඇංග්ස්ට්‍රම් ඒකකය
anguish=කටුක වේදනාව | කයේ බලවත් වේදනාව | දුක් වෙනවා | සංවේගය | සන්තාපය | සන්තාපයට පත් වෙනවා
angular=ආශ්‍රය කිරීමට දුෂ්කර | උල් වූ | කෙට්ටු | කොන් ඇති | කෝණාකාර | කෝණික
anharmonicity=අනනුවර්තිතාව
anhedonia=නිස්ස්වාදනය | විරතිය
anhidrotic=අනාර්ද්‍රක | ප්‍රතිස්වේද
anhydride=ඇන්හයිඩ්‍රයිඩය | නිර්ජලකය
anhydrite=ඇන්හයිඩ්‍රයිට් | නිර්ජලකය
anhydrous=නිර්ජලීය | වියලි | වියළි | ශුෂ්ක
anicut=අමුණ
anilides=ඇනිලයිඩ
anilinate=ඇනිලයිනේට්
aniline=ඇනිලින්
anima=අනිමාව | ආත්මය | ප්‍රාණය
animadversion=ගර්හාව | දෝෂ විවේචනය
animadvert=දොස් කියනවා | නුගුණ කියනවා
animal=තිරච්ඡාන | තිරශ්චීන | තිරිසන් | තිරිසනා | පශු | ප්‍රාණියා | ප්‍රාණී | මෘග | ශාරීරික | සත්ව | සත්ව ගණයට අයත් | සත්වයා | සතා | සීපා සතා | සීපාවා
animalcule=අණුකයා | ක්ෂුද්‍ර ප්‍රාණියා
animalia=අනිමාලියා
animalism=කාමරාගය
animalitarianism=සත්වෝත්තරවාදය
animality=තිරිසන්කම
animate=උනන්දු කරනවා | පණ දෙන | පණ දෙනවා | ප්‍රාණවත් | ප්‍රාණවත් කරනවා | සප්‍රාණික
animated=උනන්දු | ප්‍රාණවත් | සප්‍රාණික | සව
animation=උනන්දුව | පණගැන්වීම | පණදීම | ප්‍රාණවත් කිරීම | ප්‍රාණවත් බව
animatism=සව දෘෂ්ටිය | සවතා ද්‍රෘෂ්ටිය
animikite=ඇනිමිකයිට්
animism=ජීවවාදය | ප්‍රාණ වාදය | ප්‍රාණවාදය | වවාදය | සර්වසව වාදය | සවවාදය
animist=සවවාදියා
animistic=ප්‍රණවාදී | සවවාදික
animosity=අමනාපය | එදිරිය | එදිරිවාදය | එදිරිවාදිකම | ද්වේෂය | වෛරය
animus=එදිරිය | ද්වේෂය | වෛරය
animust=සර්වසව වාදියා
anion=ඇනායනය | කෝෂයක සෘණ ආරෝපණයක් ඇති අයනය
anionotropy=ඇනායනාවර්තනය
anise=අසමෝදගම්
aniseed=අසමෝදගම් | ඇනිසීඩ්
anisocotyledonous=අසමකොටිල | අසමබීජපත්‍රී
anisocotyly=අසමකොටි ලතාව | අසමබීජපත්‍රීතාව
anisogamete=අසමජන්මාණුව
anisogamous=අසමජන්මාණුක
anisogamy=අසමජන්මාණුකතාව | අසමයෝගය
anisomeric=අසමාවයවික
anisomerous=අසමාංක
anisometropia=විෂමවර්තන දෘෂ්ටිකතාව
anisopetalous=අසමදල
anisophyllous=අසමපත්‍රී
anisophylly=අසමපත්‍රතාව
anisosepalous=අසමමණිපත්‍රී
anisospore=අසමබීජාණුව
anisostamenous=අසමරේණුක
anisostemonous=අසමරේණුක
anisostichous=අසමපංක්තික
anisostyly=අසමකීලතාව
anisotonic=අසමාභිසාරක
anisotropic=අසමවර්ත | අසමසාර්වදිශ | අසමාර්වදිශ
anisotropy=අසමවර්තතාව | සමසාර්වදිශතාව
anisoyl=ඇනිසොයිල්
anisyl=ඇනිසිල්
ankle=ඇස්වටය | ගුල්එය | ගුල්ඵය | බොලට | වලලුකර | වළලුකර
ankle-bone=ඇස්වටය | පාකර
anklet=ගිගිරි | ගෙජ්ජ | නූපුර | නූපුරය | පාදගම | පාසලඹ | සරණ වළා | සරණ වැල | සලඹ | සළඹ | සිලම්බු | හලං
ankylosis=ඇටමිදුලු දිය වීම නිසා සන්ධි දැඩිවීම | ඇන්කයිලෝසියාව | සන්ධි ස්තබ්ධය
anlage=මූලාකෘතිය | මෞලය
anna=ඇනා | ඉතිහාසය | පිළිවෙළ කථාව | පුරාවෘත්ත
annalist=ඉතිහාස කර්තෘ
annals=අනුවාර්ෂික | අනුවාර්ෂික වාර්තා | ඉතිහාසය | පිළිවෙළ කථාව | පුරාවෘත්ත | විත්ති
annatto=අන්නාත්තො
anneal=පණ පොවනවා | පන්නය බාල කරනවා | පන්නරය බාල කරනවා | මෘදු කරනවා | මෙලෙකනවා | මෙළෙකනවා | රත් කොට පාට පොවනවා
annealed=මෙළෙකු
annealing=පන්නය බාල කිරීම | මෘදු කරනවා | මෘදු කිරීම | මෙලෙක් කරනවා | මෙළෙකීම
annelid=වාලසික
annelida=ඇනිලිඩා
annelids=ඇනිලිඩා
annerodite=ඇනරොඩයිට්
annex=අමුණනවා | අයිති කර දෙනවා | අයිති කරගන්නවා | ආඳීනවා | ඈඳා ගන්නවා | එකතු කරනවා | යා කරනවා | යාකරනවා
annexation=අල්ලාගැනීම | ඈඳීම | යා කර ගැනීම | යා කිරීම | යාකර ගැනීම
annexe=අනුබැඳිය | අමතර ලිපිය | ඇමුණුම | ඈඳූම | උපගෘහය | උපාංගය | යාකරය | යානිවස
annexed=ඒකාබද්ධ | යා කළ
annexture=ඇමුණුම | ඈඳුම
annexure=යාකරය
annibilation=සංහාරය
annihilate=ගොම ගෑවිලා යනවා | නසනවා | නැති කරනවා | නිරුද්ධ කරනවා | විනාශ කරනවා
annihilation=උච්ඡේදනය | උච්ඡේදය | නැසීම | නිරුද්ධිය | මූලොත්පාටනය | විධ්වංසනය | විනාශය | සමූලඝාතනය
annihilationism=උච්චේද දෘස්ටිය | උච්ඡේදදෘෂ්ටිය | උච්ඡේදවාදය | සමූහාභභාවවාදය
annihilationist=උච්ඡේද වාදියා
annihilator=උච්ඡේදකය
anniversary=අවුරුද්ද | අවුරුදු පතා පවත්වන | අවුරුදු පතා යෙදෙන | ජයන්තිය | වත්සර | වර්ෂය | සංවත්සරය | සාංවත්සරික | සාංවත්සරිකය | සාංවත්සරිකෝත්ස්වය
anniversay=වාර්ෂික | සාංවත්සරික
annoint=අභිෂේක කරනවා | ගල්වනවා | තෙල්ගල්වනවා
annointment=අභිෂේකය | ආලේපය | ගැල්වීම
annona=අනෝදා | අනෝනා
annotate=ටීකා ලියනවා | ලකුණු කරනවා | ව්‍යාඛ්‍යා කරනවා | ව්‍යාඛ්‍යා ලියනවා | විවරණ කරනවා | විස්තර කරනවා
annotation=අනුසටහන | ටිප්පණිය | ටීකාව | පරිකථනය | ව්‍යාඛ්‍යාව | විවරණය | විස්තර කිරීම | විස්තරය | සටහන
annotator=ව්‍යාඛ්‍යා කර්තෘ
announce=නිවේදනය කරනවා | ප්‍රකාශ කරනවා | ප්‍රසිද්ධියෙන් දන්වනවා | ප්‍රසිද්ධියේ දන්වනවා
announcement=දැන්වීම | නිවේදනය | ප්‍රකාශ කිරීම | ප්‍රකාශනය | ප්‍රකාශය
announcer=ඝෝෂකයා | දැන්වීම්කරුවා | නිවේදක | නිවේදකයා | ප්‍රකාශකයා | ප්‍රචාරක | ප්‍රචාරකයා
announcing=ප්‍රකාශක
annoy=අවභේදනය කරනවා | කරදර කරනවා | ගැහැට කරනවා | ගැහැට පමුණුවනවා | තරහ උපදනවා | තරහ උපදවනවා | ප්‍රකෝපනය කරනවා | පීඩා කරනවා | වද කරනවා | සිත පෙළනවා | හිරිහැර කරනවා
annoyance=අප්‍රසන්නකම | අවභේදනය | උදහස | කන්කරච්චලය | කන්දොස්කිරියාව | කරදරය | ගැහැට | ප්‍රකෝපනය | පෑරීම | පීඩාව | මරගාතය | වද කරුමය | හිංසාව | හිරිහැරය
annoyer=අවභේදකයා | කෝපකය | ගැහැට පමුණුවන්නා
annoying=ගැහැට | පාරන | පීඩා | පීඩාකාරී | හිංසක | හිරිහැර | හිරිහැරදායක
annual=අවුරුද්දක් තුළ පවතින | අවුරුද්දක් පාසා යෙදෙන | අවුරුද්දක් වත් වන ශාකය | වාර්ෂික | වාර්ෂික සංග්‍රහය | වාර්ෂිකය | සංවත්සරික
annually=අවුරුදු පතා | වාර්ෂිකව
annuals=වාර්ෂිකයෝ
annuitant=වාර්ෂිකය ලබන්නා | වාර්ෂිකලාභියා
annuity=වාර්ෂික දීමනාව | වාර්ෂිකය
annul=අභිශුන්‍ය | අවලංගු කරනවා | නිෂ්ප්‍රභ කරනවා | ශුන්‍ය කරනවා | ශූන්‍ය කරනවා
annular=මණ්ඩලාකාර | වලයාකාර
annulate=මණ්ඩලාකාර | වලයාකාර | වාලයිකයා
annulled=අවලංගු කළ
annulling=අවලංගු කළ | අවලංගු කිරීම
annulment=අභිශුන්‍යනය | අවලංගු කිරීම | අවලංගු වීම | නිෂ්ප්‍රභකිරීම | නිෂ්ප්‍රභා කිරීම | ශුන්‍යීකරණය
annulus=වලය | වලයය
annunciate=අනාගත වාක්‍ය කියනවා | අනාගතවාක්‍ය කියනවා | ප්‍රකාශ කරනවා
annunciation=විඥාපනය
annuntiate=අනාගතවාක්‍ය කියනවා | ප්‍රකාශ කරනවා
anodal=උද්ගාමි
anode=ඇනෝඩය | ධන අග්‍රය
anodic=ඇනෝඩික | උද්ගාමි
anodize=විද්‍යුත් විච්චේදනයෙන් ආරක්ෂණ ලෝහ පටලයක් ගැල්වීම
anodizing=ඇනෝකරණය | ඇනෝඩ පිරියම් කිරීම | ඇනෝඩයිස් කිරීම
anodyne=පීඩාහාරකය | වේදනා නසන ඖෂධය | වේදනා නාශකය | වේදනානාශක
anoegenetic=අඥතාජනක
anoetic=අඥ | අවිජානන
anoint=අභිෂේක කරනවා
anointed=අභිෂේක ලත්
anointing=අභිෂේක කිරීම
anointment=අභිෂේකය
anolyte=ඇනොලයිටය
anomalous=අක්‍රමික | අනියම් | අයථා | ක්‍රමවිරෝධී | විෂම
anomaly=අක්‍රමික වූ දෙය | අක්‍රමිකතාව | අනියමය | අනියම් | අයථා දෙය | ක්‍රමවිරෝධය | කෞණිකාන්තරය | විෂමතාව
anomia=නාම විස්මෘතිය
anomic=අතිචාරී | අරීතික | සමාජ චාරිත්‍ර නොවැටහෙන ගති ඇති
anomie=අනෝමිය | ඉච්ඡාභංගත්වය
anomite=ඇනොමයිට්
anomoly=විෂමතාව
anomy=ඉච්ඡාභංගත්වය
anon=ඉක්මන් | ඉක්මනින් | නමක් නොයෙදූ | නිර්නාමික | නොපමාව | වහා
anona=අනෝදා | අනෝනා
anonym=නිර්නාමය
anonymity=නිර්නාමික දෙය | නිර්නාමිකත්වය
anonymous=අඥාත | අනාමික | නමක් නොයෙදූ | නිර්නාමික
anonymously=නමක් නොයොදා | නිර්නාමිකව
anopheles=උණ මදුරුවා | මැලේරියා මදුරුවා | විනාශකාරී මදුරු ජාතියක්
anorak=ජලය කාන්දු නොවන ඇඳුම
anorexia=අක්ෂුධාව | අරුවය | ආහාර අරුවය | බඩගිනි නැතිකම
anorganic=අකාබනික
anoroxia=අක්ෂුධාව
anorthite=ඇනෝතයිට්
anorthoclase=ඇනෝතොක්ලේස්
anorthopia=කුටිල දෘෂ්ටිය | කුටිලදෘෂ්ටිය
anorthosite=ඇනෝතොසයිට්
anosmia=අවඝ්‍රාණය
another=අන් | අන්‍ය | අනික් | අනෙක් | අනෙකා | තව එක් | වෙන | වෙනත්
anoxia=ඇනොක්සියාව
anoxyscope=ඇනොක්සිස්කෝපය
anschauung=අන්ෂෝං | ප්‍රතිභානය | ප්‍රභාසය
answer=උත්තර දෙනවා | උත්තරපත | උත්තරය | ප්‍රත්‍යත්තර දෙනවා | ප්‍රත්‍යත්තරය | ප්‍රතිවචනය | පිළිතුර | පිළිතුරු දෙනවා | පිළිවදන් දෙනවා | වග කියනවා | වගඋත්තර | විසඳීම | සෑහෙනවා
answerability=උත්තර දීමට බැඳී සිටීම
answerable=උත්තර දිය යුතු | උත්තර දිය හැකි | යෝග්‍ය | වගකිය යුතු | වගකියයුතු | වගකිව යුතු
answerless=උත්තර නොදියහැකි | නිරුත්තර
ant=ඇඹලයා | කුහුඹියා | කුහුඹුවා | කූඹියා | සින්නා | සිනි | හින්නා | හිනි
ant-eater=කැබැල්ලෑවා | කුහුඹුවන් ආහාරයට ගන්නා ක්ෂීරපායි සත්වයා
ant-hill=තුඹස | වේ තුඹස | සුඹස | හුඹස | හුඹහ
antacid=ප්‍රත්‍යම්ලකය | ප්‍රත්‍යාම්ලය
antagonise=අමනාප කර ගන්නවා | එදිරි කරගන්නවා | විරුද්ධ කර ගන්නවා
antagonism=එදිරිය | එදිරිවාදිකම | ප්‍රතිඝතාව | ප්‍රතිවිරුද්ධතාව | ප්‍රතීඝතාව | විරුද්ධතාව | විරෝධය | වෛරය | සතුරුකම
antagonist=එදිරිකාරයා | එදිරිවාදියා | පසමිතුරා | ප්‍රතිමල්ලවයා | ප්‍රතීඝ | ප්‍රතීඝයා | විරුද්ධ කාරයා | විරුද්ධකාරයා | විරෝධක | සතුරා
antagonistic=එදිරි | එදිරිවාදී | ප්‍රතිවාදී | ප්‍රතිවිරුද්ධ | විරුද්ධ | විරෝධී | සතුරු
antagonize=එදිරි කරනවා | එදිරිව සිටිනවා | විරුද්ධ කරගන්නවා
antalkaline=ප්‍රතික්ෂාර
antapex=ප්‍රතිශිඛරය
antapical=අපර
antarctic=දක්ෂිණ ධ්‍රැවයට සම්බන්ධ | පෙරාතුව
antartic=දක්ෂිණධ්‍රවැය | දක්ෂිණධ්‍රැව
ante=කලින් | ප්‍රාග් | පූර්ව | පෙර | පෙරාතුව
ante-date=පෙරදාතම | පෙරදාතම් කරනවා | පෙරදාතම් කිරීම
ante-room=ප්‍රවේශ කාමරය | පිටකාමරය
antecedence=පෙරසිදුවීම
antecedent=ආදි | පුරෝගාමී | පූරවගතය | පූර්ව | පූර්ව චරිතය | පූර්වකාලිකයා | පූර්වග | පූර්වගත | පූර්වගාමී | පූර්වපදය | පූර්වයෙහි වූ | පූර්වයෙහි වූ දේ | පූර්වයෙහි වූ පදය | පූර්වයෙහි වූ වාක්‍යය | පූර්වාංගය | පෙර | පෙර පදය | පෙර විත්ති | මුලින් සඳහන් දේ
antecedents=පූරවගතතා
antechamber=ප්‍රවේශකාමරය | පිට කාමරය | පිටකාමරය | පෙර කුටීරය | පෙරකිළිය
antedate=පෙරදාතම් කරනවා
antedated=පෙර දාතම් කළ | පෙරදාතමක් යෙදූ | පෙරදාතම් කළ
antediluvian=අතිපුරාණ | ආදිකල්පික | ප්‍රාඝෝග
anteecedence=පූර්වයෙහි වූ දෙය
anteflexion=පුරෝමිංජනය
antehelmintic=ක්‍රිමි හාරකය | ප්‍රතිහෙල්මින්තිකය
antelope=කුරංග මුව විශේෂය | කුරුංග | රුරු | රූරු මුව විශේෂය | වාමිග | සාරංග මුව විශේෂය | සාරංග වැනි මුව ජාතියක්
antelude=පෙර රැඟුම
antenatal=ගර්භණී | ජන්මපූර්වක | ප්‍රාක්ප්‍රසූති | බිහිවීමට පෙර
antenna=අන්තිනාව | ඇන්ටනාව | ඇන්තිනාව | නෙරුව | ස්පර්ශක | ස්පර්ශකය
antennae=ස්පර්ශක | ස්පර්ශේන්ද්‍රිය
antenuptial=විවාහයට පළමු
antependium=අල්තාර තිරය
antepenult=වචනයක අන්තිම අකුරට මෙහා පිහිටි අකුරු දෙක
antepenultimate=අවසාන පූර්වයට පෙර | අවසානයට දෙකක් මෙහායින් | පූර්වෝපාන්තය
antepost=අංක යෙදීමටත් කලින් තබන ඔට්ටුව
antergic=ප්‍රතිවිරුද්ධ
anterior=ඉස්සරහින් පිහිටි | කලින් | පළමු | පුර්ව | පූර්ව | පූර්වයෙහි වූ | පෙරටුව
anteriority=ප්‍රාක්තන
antero-posterior=පුර්වාපර
anterograde=පූර්වක්‍රමික
anteroom=පිට කාමරය
anteversion=පූරෝවර්තනය
anthelmintic=ප්‍රතිහෙල්මින්තික
anthem=ජයගීතය | තුතිගීය | ස්තෝත්‍රය
anther=ඇන්තරය | පරාගකෝෂය | පරාගධානිය
antherid=ඇන්තරීඩියම | ශුක්‍රාණුධානිය
antheridiophore=ඇන්තරීඩියොපෝරය | ශුක්‍රාණුධානිධරය
antheridium=ඇන්තරීඩිය | ශුක්‍රාණුධානිය
anthern=තුති ගී ගයනවා
antherozoid=ශුක්‍රාණුව
anthesis=පුෂ්ප අවදිය
anthill=තුඹස | වාල්මික | වේ හුඹහ
anthocyanin=ඇන්තොසයනින්
anthodium=පුෂ්පාහය
anthologist=සංහිතාකරු
anthology=කාව්‍ය මාලාව | කාව්‍යසංග්‍රහය | මාලාව | සංහිතාව
anthophilous=පුෂ්පකාමී
anthophore=පුෂ්පධරය
anthracite=ඇන්ත්‍රසයිට් | ප්‍රජතු | බිම් අඟුරු වර්ගයක්
anthracnose=ඇනත්‍රැක්නෝස් රෝගය
anthracometer=ඇන්ත්‍රකොමීටරය
anthraconite=ඇන්ත්‍රකොනයිට්
anthracosis=ඇන්ත්‍රකෝෂියාව
anthracyl=ඇන්ත්‍රසිල්
anthranoyl=ඇන්ත්‍රනොයිල්
anthrax=ඇන්ත්‍රැක්සය | ඇන්ත්‍රුක්ස් | ගව ආදී සතුන්ගෙන් බෝවන රෝගයකි | ගව රෝගයක් | ප්ලීහා රෝගය
anthraxolite=ඇන්ත්‍රක්සොලයිට්
anthraxylon=ඇන්ත්‍රක්සිලොන්
anthropalatry=මානවපූජාව
anthrope=මානව
anthroplogist=මානව විද්‍යාඥයා
anthropo-geography=මානව භූගෝල විද්‍යාව
anthropocentric=මානවකේන්ද්‍රිය | මානවකේන්ද්‍රීය
anthropocentrism=මානවකේන්ද්‍රවාදය
anthropochore=මානුෂව්‍යාප්තිය
anthropochorous=මානුෂව්‍යාප්ත
anthropogeography=මානවභූගෝල විද්‍යාව
anthropogical=මානව විද්‍යාව සම්බන්ධ
anthropoid=නරාකෘති | මනුෂ්‍යයාට සම වූ | මානවකල්ප | මානවකල්පයා | මානවාකාර | වානර
anthropolatry=මානව පූජාව
anthropological=මානවවිද්‍යාත්මක
anthropologist=මානවවිද්‍යාඥයා | මානවවේදියා
anthropology=මානව විද්‍යාව | මානවවිද්‍යාව | මානවවේදය
anthropometry=මානව මිතිය | මානවමිතිය
anthropomorphic=මනුෂ්‍යත්වාරෝපිත | මානවතත්වාරෝපිත
anthropomorphism=මනුෂ්‍යත්වාරෝපය | මානවතත්වාරෝපණය | මානවත්වාරෝපණය | මානවභාවාරෝපණය
anthropomorphous=මනුෂ්‍යරූපී
anthropomorpism=මානවත්වාරෝපණය
anthroponomy=මානව ශාස්ත්‍රය
anthroponymy=මානව නාමවිද්‍යාව
anthropopathism=මානවාරෝපණය | මානවාරෝපණවාදය
anthropopathy=මානවාවේගාරෝපණය
anthropophagi=මනුෂ්‍යමාංශභක්ෂකයෝ
anthropophagic=මනුෂ්‍යමාංශභක්ෂක
anthropophilous=මානවකාමි
anthropopsychiatry=මානවමනෝවකිත්සාව
anthroposophy=මානවත්වඥානය
anthryl=ඇන්ත්‍රිල්
anti=එදිරි | ප්‍රති | වි | විරුද්ධ | විරුද්ධත්වය අඟවන උපසර්ගයක් | සතුරු
anti-aircraft=ගගන යාත්‍රා නාශක | ගගන යාත්‍රා නාශක
anti-anaemia=ප්‍රතිනීරක්ත
anti-art=කලා විරෝධී | ප්‍රතිකලා
anti-centre=ප්‍රතිකේන්ද්‍රය
anti-cerne=ධවල අන්තරය
anti-climax=අවප්‍රාප්තිය
anti-clockwise=වාමාවර්ත | වාමාවෘත්ත
anti-coagulant=ප්‍රතිඅන්තංචකය
anti-coincidence=ප්‍රතිසම්පාතය
anti-commutation=ප්‍රතින්‍යාදේශනය
anti-commute=ප්‍රතින්‍යාදේශ කරනවා
anti-corrosive=මලනාශක
anti-cyclone=පිළි වාසුලිය
anti-dip=පරාවර්ත | ප්‍රත්‍යභිනතිය | ප්‍රත්‍යවපාත | ප්‍රත්‍යවපාතය
anti-emetic=ප්‍රතිඡර්දකය
anti-enzyme=ප්‍රතිඑන්සයිම
anti-freeze=මිදුම්වරණය
anti-hero=කථාවක සාම්ප්‍රදායික වීරකම් නොමැති ප්‍රධාන චරිතය | නාට්‍යයක සාම්ප්‍රදායික වීරකම් නොමැති ප්‍රධාන චරිතය | ප්‍රතිවීරයා
anti-incrustation=කබොළු වැරුම් පිළියම
anti-knock=ගැස්සුම් වරණය
anti-logarithm=ප්‍රති ලඝුගණකය
anti-matter=ප්‍රතිපදාර්ථය
anti-metaphysics=ප්‍රතිපාරභෞතික විද්‍යාව
anti-natalist=ඡනනවිරෝධියා | ජනනවිරෝධී
anti-neutrino=ප්‍රතිනියුට්‍රිනෝව
anti-neutron=ප්‍රතිනියුට්‍රෝනය
anti-nucleon=ප්‍රතින්‍යෂ්ට්‍යාංගය | ප්‍රතිනියුක්ලියෝනය
anti-parallel=ප්‍රතිසමාන්තර
anti-particle=ප්‍රතිඅංශුව
anti-realistic=යථාර්ථ විරෝධී
anti-resonance=ප්‍රත්‍යනුකම්පනය | ප්‍රත්‍යනුනාදය
anti-septics=ප්‍රති පූතික
anti-social=සමාජ විරෝධී
anti-static=ප්‍රතිස්ථිතික
anti-theatre=රංග විරෝධය | රංග විරෝධී
anti-trades=විරුද්ධ වෙළෙඳ සුළං
anti-trust-laws=ප්‍රතිභාර නීති
anti-type=ප්‍රතිවර්ග | ප්‍රතිවාර්ගික
antiagglutinin=ප්‍රතිඇග්ලුටිනින්
antiaggressin=ප්‍රතිඇග්‍රෙසින්
antialbumid=ප්‍රතිඇල්බියුමීඩ්
antialbuminate=ප්‍රතිඇල්බියුමිනේට්
antiarine=ඇන්ටියරීන්
antiautomorphism=ප්‍රතිස්වයංරූපතාව
antiauxin=ප්‍රතිඔක්සින්
antibacterial=ප්‍රතිබැක්ටීරීය
antiballistic=ප්‍රේරකනාශක
antibilious=ප්‍රතිපිත්ත
antibiosis=ප්‍රතිවිකතාව
antibiotic=ප්‍රතිජීවක | ප්‍රතිජෛවකය | ප්‍රතිවක | ප්‍රතිවකය | රෝගප්‍රතිරෝධක
antibody=ප්‍රතිදේහ | ප්‍රතිදේහය
antic=විකට | විගඩම | විහිළු | විහිළුව
antical=ප්‍රෂ්ඨීය
anticatalase=ඇන්ටිකැටලේස්
anticatalyser=ප්‍රතිඋත්ප්‍රේරකය
anticatalyst=ප්‍රතිඋත්ප්‍රේරකය
anticatarrahals=ප්‍රතිරීණිය
anticathode=ප්‍රතිකැතෝඩය
anticentre=ප්‍රතිකේන්ද්‍රය
anticerical=පූජ්‍ය පක්ෂයේ බලපෑම්වලට නොකැමති
antichlor=ක්ලෝරිනාශකය
anticholerea=ප්‍රතිවිසූවිකා
antichresis=බුත්ති උගස
antichrist=ක්‍රිස්තු විරෝධියා | ක්‍රිස්තුස් වහන්සේගේ සතුරා | යක්ෂයා
anticipant=අපේක්ෂා සහගත
anticipate=අපේක්ෂා කරනවා | ඉස්සර වෙනවා | කලින් බලාපොරොත්තු වෙනවා | කලින් විඳිනවා | කලින් සිතනවා | පුර්වාපේක්ෂා කරනවා
anticipation=අපේක්ෂණය | අපේක්ෂාව | කලින් බලාපොරොත්තු වීම | පූර්වාපේක්ෂණය
anticipatory=කලින් බලාපොරොත්තු වන | කලින් සිතන | පූර්වාපේක්ෂණ | පූර්වාපේක්ෂී
anticlimax=භාවාවනතිය
anticlinal=උඩුකුරු | ප්‍රතිතල
anticline=උඩු නැම්ම | උඩුනැම්ම
anticlinorium=උඩු නැමි මඩුල්ල
anticlockwise=වාමාවර්ත | වාමාවර්තව
anticoagulant=ප්‍රති ආතංචකය
anticoagulin=ඇන්ටිකොවැගුලින්
anticol=ඇන්ටිකොල්
anticomplement=ප්‍රත්‍යානුපූරක
anticorrosive=මලනිවාරක
anticyclone=ප්‍රතිචක්‍රවාතය | පිළිවාසුලිය | පිළිවාසුළිය
anticytolysis=ප්‍රතිසෛලරණ
antidepressant=විෂාදනාශකය
antiderivative=ප්‍රතිව්‍යත්පන්නය
antidesma=ඇඹිල්ල
antidimmer=ප්‍රතිහිමකය
antidissident=ප්‍රතිවිමතික
antidotal=විෂමරන
antidote=අගනා | ප්‍රතිගරලය | ප්‍රතිවිෂ | විෂඝ්න | විෂනාශක ඖෂධය | විෂභරණය
antidysenteric=ප්‍රත්‍යතීසාරය
antiemetic=ප්‍රතිවමනකරය
antienzyme=ප්‍රතිඑන්සයිම
antifade=දුර්වර්ණනාශක
antifebrin=ඇන්ටිපෙබ්‍රින් | ප්‍රතිජාරය
antifreeze=ප්‍රතිහිමායකය | මිදුම්වරනය
antigen=ඇන්ටිජන් | ප්‍රතිදේහ ජනකය | ප්‍රතිදේහජනකය | ප්‍රතිදේහජන්‍යය
antiglobulin=ප්‍රතිග්ලොබියුලින්
antihistamine=ඖෂධ විශේෂයක් | ප්‍රතිහිස්ටමින්
antiknock=පිළිගැටුම
antilog=ප්‍රතිලඝු
antilogarithm=ප්‍රතිලඝුගණකය
antilogism=ප්‍රතිවාක්‍යය | ප්‍රතිසංවාක්‍යතාව
antimacassar=පුටු කවරය
antimeridian=පූර්ව භාග
antimers=ප්‍රකාශ සමාවයවික
antimicrobin=ඇන්ටිමික්‍රොබින්
antimode=ප්‍රතිමාතය
antimoniate=ඇන්ටිමොනියේට්
antimonies=නීති ගැටුම්
antimonite=ඇන්ටිමොනයිට්
antimony=අඤ්ජන | ඇන්ටිමනි | න්‍යායවිරෝධය
antimonyl=ඇන්ටිමොනිල්
antinode=ප්‍රස්පන්දය
antinomy=න්‍යාය විරෝධය | නීති විරෝධය | නීතිගැටුම | විධි විරෝධය
antinovel=සාමාන්‍ය චාරිත්‍ර වාරිත්‍ර නොසලකන නවකථාව
antioki=ප්‍රතිනිවාසීහු
antipathetic=අප්‍රිය | නුරුස්නා | විරෝධි | වෛරී
antipathy=අප්‍රිය බව | එකඟ නොවන බව | එදිරිවාදිකම | නුරුස්නාගතිය | නුරුස්නාව | විද්වේෂය | විරෝධය | වෛරය
antipepsin=ප්‍රතිපෙප්සින්
antipetalous=ප්‍රතිදල
antiphlogistic=උණුසුම්කමින් වේදනා අඩු කරන
antiphon=කාණ්ඩ දෙකක් ගයන ගීතිකාව
antiphony=ඒකාන්තර ගායනය | ප්‍රතිචාර සංගීතය
antipodal=ප්‍රතිධ්‍රැව
antipodes=ප්‍රතිවිරුද්ධ දේශ | ප්‍රතිවිරුද්ධ දේශය | ප්‍රතිවිරුද්ධදේශ
antipolar=ප්‍රතිධ්‍රැව
antiprism=ප්‍රතිප්‍රිස්මය
antipyretic=ප්‍රතිජ්වරක | ප්‍රතිජ්වරකය
antipyrine=ඇන්ටිපයිරින්
antiquarian=පැරණි දේ පිළිබඳ | පැරණි දේ රැස්කරන්නා | පුරාවස්තූන් පිළිබඳ වූ | පුරාවේදියා
antiquarianism=පුරාවේදය
antiquary=පැරණි දේ | පුරා වස්තූන්හි හසළ පුද්ගලයා | පුරාවිෂය ගවේෂක
antiquate=අවලංගු කරනවා | පුරාකරණය | යල්පැනපු සේ සැලකීම
antiquated=අප්‍රචලිත | අවලංගු වූ | යල්පැනපු
antique=පුරා භාණ්ඩය | පුරාණ කාලයට අයිති | පුරාතන | පුරාභාණ්ඩ | පුරාවස්තුව | පෞරාණික | පෞරාණික දේ
antiqueness=පෞරාණිකත්වය | යල්පැනපුබව
antiques=පුරාවස්තු
antiquities=පුරා වස්තු | පුරාණ සිරිත් ආදිය | පුරාභූති | පුරාවස්තු
antiquity=ඉතා පුරාණ කාලය | පුරාණය | පුරාතන යුගය | පුරාතනය
antireciprocal=ප්‍රතිපරස්පරය
antireflexive=ප්‍රතිපරාවර්තී
antirrheoscope=ප්‍රතිස්‍රාවේක්ෂය
antirrhinum=සතෙකුගේ හොම්බ මෙන් හැඩයක් ඇති මල
antiscorbutic=සමේ රෝග සෑදිම වළක්වන
antisemitic=යුදෙවුවන්ට විරුද්ධ වූ
antisemitism=ප්‍රතිසෙමිටික වාදය | යුදෙව් විරෝධවාදය | සෙමිටික විරෝධවාදය
antisepalous=ප්‍රතිමණිපත්‍රී
antisepsis=විෂබීජ මර්දනය
antiseptic=එවැනි ඖෂධය | කුණු වීම වළක්වන | පල් වීම වළක්වන | ප්‍රති පූතිකය | ප්‍රතිපූති | ප්‍රතිපූතික | පුතිනාශක | පූතිනාශක | පූතිනාශකය | විෂබීජ මර්දක | විෂබීජ මර්දකය | විෂබීජමර්දක
antiserum=ප්‍රතිදේහ අඩංගු රුධිර ද්‍රව්‍ය
antisocial=සමාජ විරෝධී | සමාජයෙහි හැසිරීමට නොකැමැති
antispasmodic=ප්‍රති භ්‍රාස්‍යය
antistatic=ස්ථිති විද්‍යුතයේ බලය උදාසීන කරවන
antisymmetric=ප්‍රතිසමමිතික | ප්‍රතිසමමිතීය
antisymmetry=ප්‍රතිසමමිතිය
antitarnish=ප්‍රතිමලින
antitheses=අර්ථ විපර්ය්‍යාස | විරුද්ධාර්ථ | විරෝධ
antithesis=අර්ථ විපර්ය්‍යාසය | ප්‍රතිපක්ෂණය | ප්‍රතිපක්ෂබව | ප්‍රතිප්‍රත්‍යය | ප්‍රතිවාදය | විරුද්ධාර්ථය | විරෝධය
antithetic=අසමජාත | ප්‍රතිවාද | විරුද්ධ | විරෝධි
antitoxic=ප්‍රතිවිෂ
antitoxin=ප්‍රති ධූලකය | ප්‍රතිවිෂ | ප්‍රතිවිෂය
antitrade=විරුද්ධ වෙළඳ සුළඟ
antitrades=විරුද්ධ වෙළඳ සුළඟ
antitrigonometric=ප්‍රතිත්‍රිකෝණමිතික
antitype=ආදර්ශය | ප්‍රතිවර්ගය | මුල | මූර්තිය | මූලය
antiviral=ප්‍රතිවයිරසය
antler=අංතට්ටුව | මුව අඟ
antoeci=ප්‍රතිනිවාසීහු
antonym=ප්‍රතිශබ්දය | විරුද්ධාර්ථ පදය | විරුද්ධාර්ථවාචී පදය
antoxident=අශෝෂකය
antrieb=අන්ත්‍රිභය
antrorse=පෙරනැමි
antrum=උඩහක්කේ ඇති වන කුහරය | ගහ්වරය
anty=පියාගේ සහෝදරිය | මවගේ සහෝදරිය
anucleate=නිර්න්‍යෂ්ටික
anuria=අමූත්‍රතාව
anus=අධෝමාර්ගය | අපානය | ගුදමාර්ගය | ගුදය | පායුව | මලමඟ | මලමාර්ගය | වලිමඟ
anvil=කිණිහිර | කිණිහිරය | කිණිහිරිය | කිනිහිරය | කිනීරය | මිටිවහණ | මිටිවාණ
anxiety=අවුල් සහිත බව | උද්වේගය | කසිලිබිසිලි | කාංසාව | කිසි | කොහෙත්ම | යම්කිසි | ශාංකාව | සනෑ තරම් | සනෑම | සාංකාව
anxious=උත්සුක | කාංසා | කාන්සා සහිත | තැවිලි සහිත | බෙහෝ උනන්දු ඇති | වන්තාපර
anxiousness=අවුල් සහිත බව | උත්සුක බව
any=කවර | කිසි | කොහෙත්ම | යම් | සනෑ තරම් | සනෑම
anybody=කවරෙක් | සනෑ කෙනෙක්
anyhow=කෙසේ හරි | කොයි හැටි වුවත්
anyone=කිසිවෙක්
anyplace=කිසිතැන | යම්තැන
anything=කිසි දෙයක් | කිසිවක් | මොකුත් | සනෑ දෙයක්
anyway=කොයි හැටි වුවත්
anywhere=කොතැන වුවත් | කොහේවත් | සනෑ තැනක
aonthophilous=පුෂ්පකාමි
aorist=අතීත කාල ක්‍රියාව | අතීත කාල ක්‍රියාවක් | භූත කාල ක්‍රියාව | ලුං ක්‍රියාව
aorta=එයොටාව | ප්‍රාභ්‍යදය | මහාධමනිය | මුඛ්‍ය ධමනිය | මුඛ්‍යධමනිය
aortic=මහාධමනී
aortitis=ප්‍රභ්‍යදදාහය | මහාධමනී ප්‍රදාහය
aortography=ප්‍රාභ්‍යද රේඛණය | මහාධමනී රේඛනය
apace=ඉක්මණින් | ඉක්මනින් | යුහුසුලුව | වහා | විගසට | ශීඝ්‍රව | සැනින්
apache=අපාශ් මැරයා | මැරවරයා
apagoge=අපගමනය
apanage=අතිරේකය | යටත් ප්‍රදේශය
apart=අපගත භාෂණය | ඈතට | ඈතින් | තොරව | දුරට | දුරින් | වෙනම | වෙන්ව | හැර
apartheid=කුප්පායම් පිළිවෙත | වර්ණ භේදය | වර්ණභේදය
apartment=අනුනිවස | නිවස්කඩ | බද්ධනිවාසය | මැදිරිය
apartments=කාමර පෙළ | නවාතැන
apathetic=උදාසීන | නොසැලකිලිමත් | මන්දොත්සාහී | මන්දෝත්සාහී
apathy=උදාසීනකම | උදාසීනත්වය | උදාසීනතාව | උදාසීනභාවය | නොසැලකිල්ල | මන්දොත්සාහය
apatite=ඇපටයිට්
ape=අනුකරණය කරනවා | කපි | රිළවා | වඳුරා | වානරයා | විහිළු කරනවා
apeiron=අපර්යන්ත
apellonion=ඇපලෝනියානු
apercu=අනන්තර ප්‍රතිවේධය | ප්‍රතිභාව | සංක්ෂේපය
aperient=අපරේචකය | විරේකය | විරේචක | විරේචක ඖෂධය | විරේචන ඖෂධය
aperiodic=අනාවර්ත | අනාවර්තක | අවාර
aperiron=අපාර
aperitif=කෑම දිරවීමට බොන මත්පැන්
apertometer=විවරමානය
aperture=තව්ව | විවරය | සිදුර | හිල
apetaloid=විදල
apetalous=පෙති රහිත | විදල
apetaly=විදලතාව
apex=අග | අග්‍රය | ඉතා උසස් තත්ත්වය | ඉතා උසස් ස්ථානය | කූටය | මුදුන | මුඳුන | ශිකරය | ශිඛරය
apexes=ඉතා උසස් තත්ත්ව | ඉතා උසස් ස්ථාන | මුඳුන්
aphaeresis=මුලකුරුලෝපය
aphakia=නිෂ්කාචය
aphanisis=අපනීසියාව
apharasia=අවාක්‍යතාව
aphasia=අභාෂ්‍යතාව | ගොළු වීම | ගොළුවීම
aphelion=විහේලිකය | විහේළිකය | සූර්ය දුරකය | සූර්ය දූරකය | සූර්යදූරකය
apheresis=මුලකුරුලෝපය
aphersis=මූලාක්ෂර ලෝපය
aphid=කුඩිත්තා | කූඩිත්තා
aphis=පැළෑටි උකුණා
aphlebia=කුපත
aphlebioid=කුපත්‍රාභය
aphomia=අනුච්චාර්යතාව
aphonia=අස්වනතාව
aphorism=ආප්ත පදය | ආප්තවචනය | නීති වාක්‍යය | සූත්‍රය
aphoristic=නීති වාක්‍යය පිළිබඳ
aphotic=අප්‍රකාශ
aphototropic=සෘණ ගුරුත්වාවර්තී
aphrodiasiac=කාමෝද්දීපකය | රතිප්‍රබෝධකය
aphrodisiac=කාම වර්ධකය | කාමෝද්දීපක | රති ප්‍රබෝධකය | වාකරණ ඖෂධය | වාකරණය
aphthongia=ජීහ්වාබද්ධය
aphyllose=විපත්‍ර
aphyllous=විපත්‍ර
aphylly=විපත්‍රතාව
apian=මීමැසි
apiarist=මීමැස්සන් ඇති කරන්නා | මීමැසි පාලකයා
apiary=මී මැසි කූඩුව | මීමැසි පෙට්ටිය | මීය | මීවදය
apical=අග්‍රස්ථ | අපර | ඉතා උසස් ස්ථානයක | මුඳුනක | ශිඛර | ශිඛරීය
apices=ඉතා උසස් තත්ත්ව | ඉතා උසස් ස්ථාන | මුඳුන්
apicula=අග්‍රකය
apiculate=සාග්‍රක
apiculture=මී මැසි පාලනය | මීමැස්සන් ඇති කිරීම | මීමැසි පාලනය
apiculturist=මීමැසි පාලකයා
apiece=එකිනෙක | එකිනෙකාට | බැගින් | වෙන වෙනම | වෙන්වෙන්ව
aping=අනුකරණය | අනුව ක්‍රියා කරන | මුග්ධ | විහිළු කිරිම
apish=මුග්ධ | වඳුරකු වැනි
aplanatic=ගෝලීය අනපේරණ
aplanogamete=අචල ජන්මාණුව
aplanosporangium=අචල බීජාණුධානිය | ඇප්ලැනොස් පොරැන්‍ය
aplanospore=අචල බීජාණුව | ඇප්ලැනොස්පෝරය
aplasia=නිෂ්කල්ප්‍යය
aplasy=නිෂ්කල්ප්‍යය
aplite=ඇප්ලයිට්
aplomb=ආත්මවිශ්වාසය | නිර්භීත බව | ලම්බකභාවය | සිසිල
apnea=ඇප්නියාව
apnoea=ඇප්නියාව | නෛරානය
apocalypse=එළිදරව් කිරීම | එළිදරව්ව | ප්‍රකාශය
apocalyptic=අනාගතවාචක | එළිදරව් කළ
apocarpous=අපාණ්ඩපික
apocarpy=අපාණ්ඩපිකතාව
apocatastasis=පුනස්ථාපනය | සාර්වභෞමික විමුක්තිය සාර්ව විමුක්තිය
apocenzyme=ඇපොඑන්සයිම
apochromatic=වර්ණ අනපේරණ
apocope=අගඅකුරුලෝපය | අන්ත්‍යක්ෂර ලෝපය
apocrisiarii=පාප් නියෝජිතවරු
apocrypha=නූතන බයිබලයට පසුව එකතු කරන ලද පොත්
apocryphal=අප්‍රාධිකෘත | අභූත | අයථාබන්ධ | අයස්ථාභූත | අසත්‍ය
apodeictic==උපදිෂ්ට
apogamic=විසංයෝගී
apogamous=විසංයෝගී
apogamy=විසංයෝගතාව
apogee=චන්ද්‍ර හෝ ග්‍රහ කක්ෂයෙහි පොළවට දුරම තැන | භූදුරකය | භූදූරකය | ව්‍යාපාරයක ඉතා උසස් අවස්ථාව | විභූමිකය
apogeotropic=අපගුරුත්වාවර්තී
apogeotropism=අපගුරුත්වාවර්තනය
apolar=අවධ්‍රැවීය
apolarity=අවධ්‍රැවීයතාව
apolitical=දේශපාලනයට සම්බන්ධ නැති | දේශපාලනයෙන් තොර
apollinarianism=අපොලෝනියානු වාදය
apollo=බොහෝ ලක්ෂණ තැනැත්තා
apollonian=අපොලෝනියානු | ඇපොලෝනියානු
apologetic=කමාව ඉල්ලන | ක්ෂමාපන | නිදහසට කරුණු කියන | සමාව ඉල්ලනසුලු
apologetics=භක්ති සංරක්ෂක | භක්ති සංරක්ෂණය
apologise=ක්ෂමාපනය කරනවා | වරදට සමාව ඉල්ලනවා | සමාව ඉල්ලනවා
apologist=ක්ෂමාලාපක | සංරක්ෂණාලපක | සමාව ඉල්ලන්නා
apologize=සමාව ඉල්ලනචා | සමාව ඉල්ලනවා
apologue=උපමා කථාව | දෘෂ්ටාන්ත කථාව
apology=ක්ෂමාපනය | ක්ෂමාලාපය | දුරනුකරණය | නිදහසට කියන කරුණු | මායාව | වරදට සමාව ඉල්ලීම | සමාව | සමාව ඉල්ලීම
apomecometer=අපදුරමානය
apomixis=විසංයෝගතාව
aponeurosis=පෘථුලාව
apopathetic=අපව්‍යථීක
apopetalous=බහුදල්‍ර
apophantic=වාචකවිනිශ්ච
apophthegm=ආප්තෝපදේශය
apophyllous=බහුපුෂ්පපත්‍රි
apophysis=අපවර්ධය
apoplectic=මීමැස්මොරය රෝගය සහිත
apoplexy=අංගවිකෘතිය | අපඝාතය | අපහතය | මීමැස්මොරය | රක්තාඝාත
aporetics=සංශක
aporia=ගැටලුව | නිෂ්ප්‍රාය
aposepalous=බහුමණිපත්‍රි
aposporous=නිර්බීජාණුක
apospory=නිර්බීජාණුකතාව
apostasy=අදහන ආගම හැර දැමීම | ආගම හැර දැමීම | පළමු පිහිටි ධර්මය | භක්තිය
apostate=පක්ෂය හැරයන්නා
apostle=දූතයා | ධර්ම දූතයා
apostolic=ධර්ම දූතික
apostolical=ධර්ම දූතික
apostrophe=අපවර්තනය | ආමන්ත්‍රණය | ඇමතීම | ලොප් ලකුණ | සම්බෝධනය
apostrophic=අපවර්තක
apostrophize=අනභිමුඛයෙහි වූවකුට ආමන්ත්‍රණය කොට කැඳවනවා
apothecary=ඇපොතිකරි | බෙහෙත් වෙළෙන්දා | බෙහෙත් සකස්කරන්නා | බෙහෙත් සාදන්නා
apothece=ඇපොතීසිය | කූපිකාව
apothecium=ඇපොතීසිය | කූපිකාව
apothegm=ආප්තෝපදේශය
apothem=උපාරය
apotheosis=දේවත්ව පූර්ණය | දේවත්වයට පැමිණවීම | දේවත්වාපදානය | දේවත්වාරෝපණය
apotracheal=පරිවාහිනී
apotted=ගෝමර
apotype=අපදර්ශය
appal=තැති ගන්නවා | තැති ගන්වනවා | බය කරනවා | භය කරනවා
appalams=පපඩම්
appall=භයාභිභූතකරණය
appalling=ඉතා අශෝභන | තැති ගන්වන | දරුනු | බියජනක
appanage=අතිරේකය | යටත් ප්‍රදේශය
apparatus=අඩුවැඩිය | ආපාදිතය | උපකරණ | උපකරණය | ප්‍රතිපාදිතය
apparel=අන්දනවා | අන්දවනවා | අඳිනවා | ඇඳුම | ඇඳුම් පැළඳුම් | වේෂය
apparent=ගම්‍ය | ගම්‍යමාන | දකින්නට තිබෙන | දෘශ්‍ය | දෘශ්‍යමාන | පැහැදිලිව පෙනෙන | පෙනෙන | පෙනෙන්නට තිබෙන | භාසමාන | විද්‍යමාන | හාසමාන
apparently=පැහැදිලිව | පෙනෙන හැටියට නම්
apparition=අවතාරය | සොල්මන | හොල්මන
appcarance=පෙනී සිටීම
appeal=අනුකම්පාව ඉල්ලනවා | අභියාචනය | අභියාචනා කරනවා | අයදිනවා | අයැදුම | ආකර්ෂණය | ආයාචනය | ආයාචනා කරනවා | ඇකැස්ම | ඇපැල් ගන්නවා | ඇපෑල | ඉල්ලීම | කනපින්දම | කන්නලව්ව | පිහිට ඉල්ලනවා | මැසිවිල්ල | යැදුම | සිත ඇදගැනීම
appealable=අභියාචනා කළ හැකි | ඇපැල් ගත හැකි
appealing=කමනීය | පිහිට ඉල්ලන | පිහිට පතන | සිත් ඇදගන්න | සිත් ඇදගන්නා
appeals=ඇපැල්
appear=ඇතිවෙනවා | පළවෙනවා | ප්‍රකාශ වෙනවා | ප්‍රකාශයට පැමිණෙනවා | පැනෙනවා | පෙනී යනවා | පෙනී සිටිනවා | පෙනීසිටීම | පෙනෙනවා | හටගන්නවා
appearance=ආකාරය | උදය | දර්ශනය | දෘශ්‍යමානය | ප්‍රකාශයට පැමිණීම | ප්‍රතිභාසය | ප්‍රතිහාසය | ප්‍රාදුර්භාවය | පෙනී සිටීම | පෙනීම | පෙනීසිටීම | පෙනුම | පෙනෙන දේ | මුහුණුවර | ලකය | ලක්ෂණය | වෙස | සංකාසනය | සම්ප්‍රාප්තිය
appeared=ප්‍රාදුර්භූත | සඤ්ජාත
appease=නලවනවා | සංසිඳවනවා | සතුටු කරනවා | සනසනවා
appeasement=සංසිඳවීම | සැනසීම
appeitite=අභිලාෂය | ඉන්ද්‍රියන් පිනවීමට ආශාව | බඩගින්න | රුවය
appellant=අභියාචකයා | ආයාචකයා | ඇපැල්කරු | ඇපෑලක් ඉල්ලුම් කරන්නා
appellate=අභියාචන | ඇපැල් | ඇපෑල විනිශ්චය කරන
appellation=අභිධානය | අභියාචනය | නම | නාමය | සංඥාව
appellative=අවිශේෂ සංඥානාමය
appellee=වරදකාර වග උත්තරකරු
appellent=ඇපැල්කරු
append=අමුණනවා | ආඳිනවා | උවැඳනවා | එකතු කරනවා | යා කරනවා
appendage=අනුබද්ධය | උපාංගය | එකතු කරන ලද්ද
appendectomy=අනුබද්ධ ශල්‍යකර්මය | අනුබද්ධශල්‍යකර්මය
appendices=උපග්‍රන්ථ | පරිශිෂ්ට
appendicetomy=අනුබද්ධ විච්ඡේදය
appendicitis=අනබද්ධ ප්‍රදානය | අනුබද්ධදාහය | අනුබද්ධප්‍රදාහය | ඇපෙන්ඩිසයිට්ස්
appendicled=සෝපාංගක
appendicostomy=අනුබද්ධ ද්වාරණය | ඇපෙන්ඩිකොස්ටොමි
appendictomy=උණ්ඩුකපුච්ඡ අපනෝදය
appendiculate=සෝපාංග
appendiculum=උපාංගකය
appendix=අනුබද්ධය | අනුබන්ධනය | අනුලැඹිය | උණ්ඩුකපුච්ඡය | උපග්‍රන්ථය | උවෑඳුම | ඌනපූරණය | පරිශිෂ්ටය | බඩවැලේ කොටසක්
apperception=සංවිජානනය | ස්වෝපලබ්ධිය
appertain=අඩුත්තු වෙනවා | අදාළ වෙනවා | අයිතිව තිබෙනවා | සම්බන්ධව තිබෙනවා
appertainance=අඩුත්තුවීම | අදාළ දෙය | අදාළ වීම
appertinent=අදාළ වන | අයිති | ඇතුළත් | සුදුසු
appertising=අග්නිකාරක | බඩගිනි වඩන
appertizing=අග්නිකාරක | බඩගිනි වඩන
appetence=සුඛායකය
appetention=අභ්‍යාධානය
appetising=රෝවන
appetite=අග්නිය | අභිරුවය | ගින්න | රුවය | රෝවනය
appetition=අභීප්සාව
appetitive=ආභීප්සු
appetize=රුව ඇති කරනවා
appetizer=අග්නිකාරකය | කට ගැස්ම
appetizing=අග්නිකාරක
applanate=පැතැලි
applaud=අත්පොළසන් දෙනවා | අපොළනවා | අභිනන්දනය | ඔල්වරසන් දෙනවා | ප්‍රශංසා කරනවා | වර්ණනා කරනවා | සතුට දක්වනවා | සාදුකාර දෙනවා
applause=අත්පොලසන් දීම | අත්පොළසන් | අත්පොළසන් දීම | අභිනන්දනය | ඔල්වරසන් | ඔල්වරහඬ | ප්‍රශංසාව | ප්‍රීතිය | සතුට | සාධුකාරය
apple=ඇපල් | ඇපල්ගෙඩිය | එනම් පලතුරු වර්ගය
appleton-layer=ඇපල්ටන් ස්තරය
appliance=උපකරණය | උවාරණය
appliances=උවාරණ
applicable=අදාළ | උපයෝගී | උවත | ගැළපෙන | යෙදියහැකි | යෙදෙන | යෝග්‍ය | සුදුසු
applicant=අයදුම්කරු | අයදුම්කරුවා | අයදුම්කාරයා | ඉල්ලුම් කාරයා | ඉල්ලුම්කරු | ඉල්ලුම්කරුවා
application=අදාල කිරිම ම | අයදුම | ආලේපනය | ආලේපය | ඉල්ලිම | ඉල්ලීම | ඉල්ලුම් පත්‍රය | උපයෝගය | නියැලුම | පිරිබඩ | භාවිතය | භාවිතිය | යෙදීම | ලෙවුන් | ව්‍යාපෘත වීම | සම්ප්‍රයෝගය
applicator=ගාන උපකරණය | යෝජකය
applied=ප්‍රායෝගික | භාවිත | රූඩි | ව්‍යවහාරික
applique=අප්ලිකෙ කිරීම | ඇප්ලිකය | ඇප්ලික් කිරීම | මතුපිට මැස්ම | සැරසුම
apply=අදාළ වෙනවා | අයදිනවා | අල්ලනවා | ආරුඩ කරනවා | ආරූඩ කරනවා | ආලේප කරනවා | ඉල්ලුම් කරනවා | ගානවා | දවටනවා | යෙදෙනවා | යොදනවා | යොමු කරනවා | හිතට ගන්නවා
appoint=නියම කර ගන්නවා | නියම කරනවා | නිල කරනවා | පත් කරනවා | පත්කරනවා
appointed=නියමිත | පත් කළ | පත්කළ | යොදාගත්
appointee=පත්වීම් ලද්දා | පත්වීම් ලාභියා
appointer=පත් කරන්නා
appointment=නියමය | නියෝගය | නිලය | පත් කිරීම | පත් වීම | පත්කිරීම | පත්වීම | පදවිය
appointor=පත්කරන්නා | බලදායකයා
apport=අධිවහනය
apportion=කොටස් කර බෙදීම | කොටස් කරනවා | පංගු කරනවා | බෙදා දෙනවා | බෙදා වෙන් කරනවා | විබෙදනවා | විභාජනය කරනවා
apportionment=අනුපාතනය කිරීම | කොටස් කිරීම | පංගුකිරීම | පංගුව | විබෙදුම | විභාජනය | වෙන් කළ කොටස
appose=විමසනවා | හඟිස්සනවා
apposite=අනුකූල | උවත | ගැළපෙන | යථාර්ථ | යෝග්‍ය | සුදුසු
apposition=අහිස්ථාපනය | ඒකාන්වතාව | ඒකාබද්ධකම | යා කිරීම | විස්තරය | සමානාධිකරණය
appraisal=අර්ඝණය | ඇගයුම | තක්සේරුව | නිර්ධාරණය | මිල කිරීම
appraise=අගයනවා | තක්සේරු කරනවා | තරම තේරුම් ගන්නවා | මිල කරනවා
appraised=තක්සේරු කළ | මිල කළ
appraisement=තක්සේරු කිරීම | තක්සේරුව | මිල කිරීම
appraiser=තක්සේරු කරන්නා | තක්සේරුකරු | තක්සේරුකරුවා | මිලකරු | මිලකරුවා
appreciable=අගනා | අගය කළ හැකි | ප්‍රමාණකළ හැකි | රස විඳිය හැකි | සැලකිය යුතු
appreciate=අගය කොට සලකනවා | අගය තේරුම් ගන්නවා | අගයෙන් වැඩි වෙනවා | තරාතිරම තේරුම් ගන්නවා | නිවැරැදිව තේරුම් ගන්නවා | ප්‍රමාණ කරනවා | මිල නගිනවා | වටහාගන්නවා | වටිනාකම තේරුම් ගන්නවා | හරිහැටි තේරුම් ගන්නවා
appreciation=අගය කිරීම | අගය තේරුම් ගැනීම | අගය වැඩි වීම | අගය වැඩිවීම | අගයෙන් වැඩිවීම | අගේ කොට සැලකීම | අර්ඝ වෘද්ධිය | ආස්වාදනය | ආස්වාදය | ඇගයීම | රස විඳීම | රසය | රසාස්වාදනය | රසාස්වාදය | රසිකත්වය | වටිනාකම වැඩිවීම | වින්දනය | සම්භාවනය
appreciative=අගේ කොට දක්වන | අගේ කොට සලකන
appreciatory=අගේ කොට දක්වන | අගේ කොට සලකන
apprehend=අල්ලනවා | තේරුම් ගන්නවා | ප්‍රග්‍රහණ කරනවා | ප්‍රග්‍රහණය කරනවා | භය සිතනවා | වටහා ගන්නවා | සැක කරනවා | සැක සිතනවා | සිර භාරයට ගන්නවා | සිරබාරයට ගන්නවා
apprehended=අල්ලන ලද | උදික්සු | පරිගෘහීත
apprehension=අල්ලා ගැනීම | උදික්සුම | ප්‍රග්‍රහණය | භය | වටහා ගැනීම | වහා තේරුම් ගැනීම | සැකය | සිර භාරයට ගැනීම
apprehensive=අසු වන | තේරෙන | භය සහිත | භය සිතන | වහා තේරුම් ගන්නා | වැටහෙන | සැක සිතන | සැකමුසු
apprentice=අතවැසියා | අභ්‍යාසලාභියා | ආධුනික | ආධුනිකයා | ඉගෙනීමට බැඳෙනවා | ඉගෙනීමට භාර කරනවා | ගෝලයා | දුහුනා | නවක | පුහුණුවන්න | පුහුණුවන්නා | ශිෂ්‍ය ශිල්පියා | ශිෂ්‍යශිල්පියා | සිප්කැටියා | සිප්කැමියා
apprenticehood=ආධුනිකත්වය | පුහුණුවීම
apprenticeship=අභ්‍යාසලාභිත්වය | ආධුනික කාලය | ආධුනිකත්වය | සිප්කැමිතාව
appresentation=සමර්පණය
appresscrium=ලග්නාංගය
appressed=ආලග්න
appressor=ලග්නාංගය
apprise=දැනුම් දෙනවා | මිල නියම කරනවා | සැල කරනවා | සැලකරනවා
apprize=මිල නියම කරනවා
approach=අභික්‍රමණය | උපගමනය | එළඹෙනවා | එළැඹුම | කිට්ටු වීම | කිට්ටු වෙනවා | ප්‍රවේශය | පාර | පිවිසුම | මඟ | මාර්ගය | සමීප වෙනවා | හැරෙන පාට | ළං වෙනවා | ළංවීම | ළඟා වෙනවා
approachable=ප්‍රියවාදී | ළං විය හැකි | ළංවිය හැකි
approached=උපගත
approbate=පිළිගන්නවා | මනාපය ප්‍රකාශ කරනවා
approbation=අධිමතිය | අනුමතිය | අනුමෝදනය | ප්‍රශංසාව | මනාප වීම | මැනවැයි පිළිගැනීම
appropriate=අදාළ | අනුයොදනවා | අනුයෝජනය කරනවා | අයත්කර ගන්නවා | අයිති | අයිති කරගන්නවා | අයිතිකර ගන්නවා | අර්ථාන්විත | අර්ථානුරූප | උචිත | ඔබින | කාලානුරූප | කාලෝවත | කැප | තරම් | තැන්වැසි | නියමිත | නිසි | ප්‍රතිරූප | මැන | මැනවි | යුක්ත | යොදනවා | යොදා ගන්නවා | යෝග්‍ය | විසර්ජනය කරනවා | සමයානුරූප | සරි | සරූපී | සෑහෙන | සුදුසු
appropriateness=අනුරූපතාව | සුදුසුකම
appropriation=අනුයෙදුම | අනුයෝජනය | අයිති කරගැනීම | අයිතිකරගැනීම | මුදල් වෙන් කිරීම | යෙදීම | විසර්ජනය | විසර්තය
appropriation-in-aid=අපේක්ෂිත විසර්ජනය | අපේක්ෂිත විසර්ජනය
approprite=සරුප
approsexia=අනවධේයතාව
approval=අනුමතය | අනුමතිය | අනුමැතිය | පිළිගැනීම | සම්මති
approve=අනුමත කරනවා | ඉඩ හරිනවා | පිළිගන්නවා | මැනවැයි පිළිගන්නවා
approved=අනුඥාත | අනුමත | අනුමත කළ | අනුමැතිය ලත්
approver=අනුමතකරු
approvingly=ප්‍රශංසා මුඛයෙන්
approximate=ආසන්න | ආසන්න ලෙස කරනවා | ඉතා කිට්ටු | කිට්ටුව තිබෙනවා | දළ | දළ වශයෙන් කරනවා | සන්නිකර්ෂණ | සන්නිකර්ෂණ කරනව | සන්නිකර්ෂණ කරනවා | සන්නිකර්ෂණය කරනවා | සන්නිකර්ෂණීය | සමානව තිබෙනවා | සමීප | සමීප කරනවා | සමීප වෙනවා | සමීපකරණය කරනවා | ළං කරනවා | ළං වූ | ළං වෙනවා
approximately=ආසන්න වශයෙන්
approximating=සන්නිකර්ෂණය කිරීම
approximation=ආසන්න කිරීම | ආසන්නය | සන්නිකර්ෂණය | සමානව තිබීම | ළං වීම
approximatly=ඉතා කිට්ටුව | බොහෝසෙයින් | සම්පූර්ණයෙන්ම වාගේ
appurtenance=අඩුත්තුව | අදාළ දෙය | අනුබද්ධනය | අයත් දෙය | අයත් දේ | ආයත්තනය
appurtenances=අනුබන්ධන | අනුබැඳි දේපල
appurtenant=අඩංගු | අඩුත්තු | අනුබද්ධ | අනුබැඳි
apraxia=අප්‍රක්සියාව | අප්‍රයෝජ්‍යතාව
apricot=එනම් පල වර්ගය | එප්‍රිකට් | රට කොට්ටං
april=අප්‍රේල් | අප්‍රේල් මාසය
apron=උඩ ඇඳුම | ඒප්‍රනය | කාවාඩම | නෙරිය | නෙරුව | පිළිවැස්ම | පෙර වැස්ම | පෙරවැස්ම
apropos=අදාළව | අනුකූලව | කාලෝවතව
aprotic=අප්‍රෝටෝනීය
apsdal=දූරාන්තික
apse=ඇප්සිය | දූරාන්තිකය
apselaphosia=අනවධේයතාව | ස්පර්ශ වෛකල්‍යය
apsidal=දූරාන්තික | දේවස්ථානයක වෙන් කළ කොටසට අදාළව පවතින
apt=ආප්ත | උවත | තැන්වැසි | දක්ෂ | යෝග්‍ය | ස්ථානෝවත | සුදුසු | හුරුබව ඇති
aptitude=අභියෝග්‍යතාව | කුශලතාව | දක්ෂතාව | යෝග්‍යතාව | රුවය | ලැදිකම | ශූරභාවය | සාමර්ථ්‍යය | සුදුසුකම | හුරුකම
aptly=දක්ෂ ලෙස
aptness=යෝග්‍යතාව
apurtenance=අඩංගු වූ දෙය | අයිති වූ දෙය | සම්බන්ධීවූ දෙය
apurtenances=උපාංග | පරිෂ්කාර | බඩු බාහිරාදිය
apyrexia=නිර්ජ්වරතාව
aquaeduct=ජල නායකය | දියමං පාලම
aqualung=දියයටදී හුස්ම ගැනීමට භාවිත කරන උපකරණය
aquamarine=නිලට හුරු | නිල් වෛදූර්ය | පව්චපඩියම් | සුදු නිල
aquaplane=දිය මතුපිට ගමන් කරන යන්ත්‍රය
aquarelle=අක්වාරෙල් | දිය සායම් | දිය සායමින් කළ වත්‍රය
aquarium=ජලජ වීන් සඳහා වන තටාකය | ජලජ වීන් හා පැලෑටි සඳහා වූ තටාකය | ජලාලය | මාළුපොකුණ | මින්මැදුර
aquate=ඇක්වේටය
aquatic=ජලචර | ජලජ | ජලයෙහි වසන | ජලරුහ
aquatint=අක්වාටින්ට්
aquation=ජලායනය
aqueduct=ඇළ | කැපූ ඇල | ජලපීල්ල | දිය මං පාලම | දිය මඟ | වාරිමාර්ගය
aqueo-igneous=ජලාග්නේය
aqueous=අම්මය | ජලමය | ජලීය
aquifer=ජලධරය
aquila=ඇක්විලා
aquilian=ඇක්වීලියානු
aquiline=තියුණු
aquilline=රාජාලියා වැනි | වකුටු
arab=අරාබියා
araban=ඇරබැන්
arabesque=ඇරබස්ක් ලියකම | නාටිකාංගනාවකගේ ලාස්‍ය විලාසයක්
arabia=අරාබිය | අරාබියාව
arabian=අරාබි
arabic=අරාබි
arabin=ඇරබින්
arabinose=ඇරබිනෝස්
arabinoxylan=ඇරබිනෝසයිලන්
arable=ගොවිතැනට යෝග්‍ය | ගොවිතැනට සුදුසු | වගා කළ හැකි | වැවිය හැකි
arachnid=ගෝනුසු කාණ්ඩයට අයත් | මකුළු කාණ්ඩයට අයත් | මකුළු ගණයේ සතා
arachnitis=ලෞතාහ ප්‍රදාහය
arachnoid=ජාලාකාර | ලෞතාහය
arack=අරක්කු
aragonite=ඇරගනයිට්
arahant=අර්හත් | ක්ෂීණාස්‍රව | රහතන් වහන්සේ | රහත් | වීතරාගී
aramaic=ඇරමෙයික් භාෂාව
aranged=සැදූ
arangement=පිළියෙල කිරිම
arapesh=ඇරපේශ්
araphite=ඇරපයිට්
arawak=ආරාවාක
arbiter=තීරකයා | තීරකීකරණය කරනවා | බලපවත්වන්නා | බේරුම්කරු | විනිශ්චයකාරයා
arbitrage=තීරක තීන්දුව | පරස්පරය
arbitrageur=පරස්පරකරු
arbitral=තීරකාත්මක
arbitrary=අත්තනෝමතික | අභිමත | අභිමතානුකූල | හිතුවක්කාර
arbitrate=විනිශ්චයක් කරනවා | විනිශ්චයක් දෙනවා | සමථයට පමුණුවනවා
arbitration=තීරකීකරණය | නියම කිරිම | බේරුම | බේරුම් කිරීම | බේරුම්කිරීම | විනිශ්චය | ශමථ | සමථනය
arbitrator=තීරකයා | බේරුම්කරු | බේරුම්කාරයා
arbor=ඊෂිකාව | කඳ | ගස | පට්ටල් දණ්ඩ | ලතා මණ්ඩපය
arboraceous=ගස් වැනි | වන වදුලින් ගහන
arboreal=ගසකට අයිති | ගස්හි වැඩෙන | ගසෙහි වත් වන | ගසෙහි වත්වන | වෘක්ෂජ
arborescent=වැඩුණු ගසක් බඳු වූ | වෘක්ෂරූපී | වෘක්ෂාකාර
arboretum=තෘණ උද්‍යානය | මල් වත්ත | රුක් උයන | වෘක්ෂ උ්‍යානය
arboriastion=ද්‍රුමායනය
arboriciture=ගස් හා ලඳු වගාව
arboring=ඊෂිකායනය
arbour=ලතා මණ්ඩපය | ලතාගෘහය | වටගෙය
arbuscule=සිඵව
arbutus=ස්ට්‍රොබෙරි ගස වැනි ගස් විශේෂයක්
arc=කවයක කොටසක් | චාපය | දුනු හැඩය | බෝක්කුව | වෘත්තාංශකය
arcade=ආරුක්කු පාර | ආරුක්කු පේළිය | ආරුක්කු මාර්ගය | උඩින් වැසුණු බෝක්කුවක් සහිත පාර | සෙවන කළ මාර්ගය | සෙවන කළ සාප්පු පෙළ
arcadian=පිටිසර සැප ඇති | රමණීය
arcadic=ග්‍රාමව්‍යපදේශී
arcane=ගුප්ත | ගූඩ | රහස්‍ය
arcanite=ආකනයිට්
arcanum=ගුප්ත වන්තාව
arch=ආරුක්කුව | කපටි | චක්‍රය | චාටුකාර | තොරණ | දුන්නක් මෙන් නමනවා | ප්‍රධාන | ප්‍රයෝගයෙහි දක්ෂ | බෝක්කු තනනවා | බෝක්කුව | රැළි පාලම | වක | වක්‍රය
arch-enemy=පරම හතුරා | සාතන්
archaean=අති පුරාණ
archaen=අතිපුරාණ | ආදිම
archaeo=ප්‍රාක් | ප්‍රාග්
archaeological=පුරාණ වස්තු පිළිබඳ | පුරාවිද්‍යාත්මක | පුරාවේදක
archaeologicl=පුරාවිද්‍යා
archaeologist=පුරාවිද්‍යාඥයා
archaeology=පුරා විද්‍යාව | පුරාණ වස්තු ශාස්ත්‍රය | පුරාවිදයාව | පුරාවිද්‍යා | පුරාවිද්‍යාව | පුරාවේදය | මූලශාස්ත්‍රය
archaeozoic=ආකියෝසොයික
archaic=ආදි කාලයේ වූ | ආදියෙහි වූ | පුරා | පුරාණ | පුරාතන | පෞරාණික | යල් පැනපු
archaism=කලාවන් පිළිබඳ පැරණි ප්‍රයෝගය | කලාවන් පිළිබඳ පැරණි යෙදීම | පදයන් පිළිබඳ පැරණි ප්‍රයෝගය | පදයන් පිළිබඳ පැරණි යෙදීම | පෞරාණිකය | වාක්‍යයන් පිළිබඳ පැරණි ප්‍රයෝගය | වාක්‍යයන් පිළිබඳ පැරණි යෙදීම
archangel=ශ්‍රේෂ්ඨ පංක්තියේ දේවදූතයා
archbishop=අග්‍ර රාජගුරු ප්‍රසාදී තුමා ගේ පදවිය | අග්‍ර රාජගුරු ප්‍රසාදී තුමාට අයිති ප්‍රදේශය | නායක බිෂොප් තැන
archdeacon=අනුනායක තැන
archdiocese=අග්‍ර බිෂොප් තුමාට යටත් ප්‍රදේශය
archduchess=නායක ආදිපාද තුමිය
archduchy=නායක ආදිපාද තැනට යටත් ප්‍රදේශය
archduke=නායක ආදිපාද තැන
archdukedom=නායක ආදිපාද තැනට යටත් ප්‍රදේශය
arche=මූලකාරණය
archegone=අණ්ඩාණුධානිය | අණ්ඩාණූධානිය | ආකිගොනිය | ආකිගෝනිය
archegonial=අණ්ඩාණූධානික | ආකිගෝනීය
archegoniatae=ආකෙගෝනියාටේ
archegoniate=අණ්ඩාණූධානික | ආකිගෝනීය
archegonium=අණ්ඩාණුධානිය | අණ්ඩාණූධානිය | ආකිගොනිය | ආකිගෝනිය
archelogy=මූලකරණවේදය
archer=දුනුවායා | ධනුර්ධරයා | සරසන
archery=ධනු ශිල්පය | ධනුර්වේදය | ධනුවේදය | ධනුශ්ශිල්පය
archespore=ආකිස්පෝරිය | ආකිස්පෝරීය | බිජාණුමුලිකය | බීජාණුමුලිකය
archesporial=ආකිස්පෝරිය | බීජාණුමුලික
archesporium=ආකිස්පෝරිය | ආකිස්පෝරීය | බිජාණුමුලිකය | බීජාණුමුලිකය
archetypal=පුරාකෘතික
archetype=ආද්‍යාකෘතිය | ආදි වර්ගය | ආදිදර්ශය | පුරාකෘතිය | මුල් සැලැස්ම | මූල රූපය | මූලාකෘතිය
archeus=ආකේයුස් මූලධර්මය
archfiend=මාරයා | සාතන්
archiangiosperm=ආදිආවෘතබීජකය
archicarp=අස්කොගෝනිය | ආකිකාපය | ආකිකාපය | පුරාණ්ඩපය
archichlamydeae=ආකික්ලමිඩේ
archichlamydeous=ආකික්ලමිඩිය | ආදිපරිපුෂ්පී
archigoniophore=අණ්ඩාණුධානිධරය | ආකිගෝනිපෝරය
archimandrite=දේවස්ථානයක නායක පූජක තුමා
archimedean=ආකිමිස්
archimycetes=ආකිමිසේටේස්
archipelago=කොදෙව් පෙළ | කොදෙව් රාශිය | කොදෙව් රැස | දුපත් සමූහය | දූපත් ගහන මුහුද
architect=අත්පාදකයා | ගෘහ නිර්මාණ ශිල්පියා | ගෘහනිර්මාණ ශිල්පියා | ගෘහපති | නිර්මාණ ශිල්පියා | වාස්තු විද්‍යාඥයා | හැඩගස්සන්නා
architectonic=ගෘහ නිර්මාණය සම්බන්ධ | නිර්මාණශීලී | මහාත්ම්‍ය | ව්‍යහමුඛ්‍ය | ව්‍යහමුඛ්‍ය
architectural=වාස්තු විද්‍යාත්මක | වාස්තුරූපී | වාස්තුවිද්‍යාත්මක | වාස්තුවිද්‍යාත්මත
architecture=ගෘහ නිර්මාණ ශිල්පය | ගෘහනිර්මාණ ශිල්පය | නිර්මාණ ශිල්පය | මුඛ්‍ය තාක්ෂණය | වාස්තු විද්‍යාව | වාස්තුව | වාස්තුවිද්‍යාව | විස්තු විද්‍යාව
architrave=කවුළු ලීස්තරය | ලීස්තරය
archive=තෝම්බුව | රාජ්‍ය ලේඛනාගාරය | ලේකම් මිටිය
archives=පුරාගාරය | රාජ්‍ය ලේඛනාගාරය | ලේඛනාගාරය | සංරක්ෂණාගාරය
archiving=අධි ලේඛනකරණය | අධිලේඛනකරණය
archivist=රාජ්‍ය ලේඛනාගාරයේ භාරකාරයා | රාජ්‍ය ලේඛනාගාරයේ විහේෂඥයා | ලේඛනාරක්ෂක
archway=ආරුක්කු මග
arciform=චාපරූපී
arcing=චාපනය | චාපවීම
arconium=ආකෝනියම්
arctic=අති ශීතල | ආක්ටික් | උත්තරධ්‍රැව ප්‍රදේශය | උත්තර ධ්ර්ැවයට අයිති | උත්තරධ්‍රැව
arcual=චාපරූපී
arcuate=චාපායිත | දුනුහැඩ
ardency=ප්‍රචණ්ඩත්වය
ardennite=ආඩෙනයිට්
ardent=අග්‍ර | උත්සුක | ඉතා ලැදි | උද්‍යෝගිමත් | උනන්දු | දන | දැවෙන | ප්‍රචණ්ඩ | ප්‍රබල
ardently=ප්‍රචණ්ඩ ලෙස
ardoloy=ආඩොලොයි
ardometer=ආඩොමීටරය
ardour=අනුරාගය | උද්‍යෝගය | උනන්දුව | තාපය | දැඩි ප්‍රේමය | බලවත් උනන්දුව
arduous=අමාරු | අසීරු | දුෂ්කර
arduously=අමාරුවෙන් | අසීරුවෙන්
arduousness=අසීරු වීම
are=ආර | ආරය | වෙති
area=අවකාශය | ඉඩ ප්‍රමාණය | ක්ෂේත්‍රඵලය | ක්ෂේත්‍රය | කොට්ඨාසය | පළාත | ප්‍රදේශය | පැත්ත | පියස | පෙදෙස | ඵලය | බිම් ප්‍රමාණය | මණ්ඩිය | මිදුල | වපසරීය | වර්ග ප්‍රමාණය | වර්ග ඵලය | වර්ගප්‍රමාණය | වර්ගඵලය | වාර්ගිකය | විශාලත්වය | සරිය | සාවිය | හරිය | හිස් බිම
areal=ප්‍රදේශ | ප්‍රදේශ කම්බිය | ප්‍රාදේශීය
areametric=වර්ගඵලමිතික
areca=කරුංකා | පුවක්
arecanut=පුවක් | පුවඟු | පූග
arecanut-cutter=ගිරය
areic=නිර්වාහි
arena=අංගනය | මණ්ඩලය | මල්ලව භූමිය | මල්ලවරංගය | රංග පීඨය | රංගභූමිය | රඟ මජල | රඟමජල | වාද බිම | සංග්‍රාම භූමිය
arenaceous=වාලුකාමය | වාලුරුහ | වැලි සහිත
arenarious=වාලුමය
arendalite=ඇරෙන්ඩලයිට්
arenolite=අරිනොලයිට්
arenophilous=වාලුකාමි
areola=අංගණ | අන්තරාලය | තන පුඩුවට සමීපව ඇති පැහැ ගැන්වුණු ප්‍රදේශය
areolar=අන්තරාල | ක්ෂේත්‍රක
areolate=සාංගණ
areolation=සාංගණය
areometer=ද්‍රවමානය
areometry=ද්‍රවමිතිය
arepyconmeter=ඇරිපික්නොමීටරය
arete=අරේටය | කඳු වැටියක ඇති තියුණු බෑවුම
aretology=සද්ගුණවේදය
arfvedsonite=අර්පෙඩ්සොනයිට්
argasidae=ආර්ගැසිඩ්
argent=රිදී | රිදී පැහැය ඇති
argentic=රජතධර සංයෝගය
argentiferous=රිදී සහිත
argentine=ආජන්ටයින්
argentite=ආජන්ටයිට්
argentometer=රජතමානය
argentometry=රජතමිතිය
argentopyrites=ආජෙන්ටොපයිරයිටීස්
argentous=ආජෙන්ටස්
argillaceous=මෘත්තිකාමය
argillicole=මෘත්තිකාරුහ
arginase=ආනේස්
arginine=ආනින්
argon=අක්‍රීය වායුවක් | ආගනය | ආගන් | මූලද්‍රව්‍යයක්
argosy=අගනා බඩු පිරවූ මුහුදු යාත්‍රාව
argot=අපභාෂාව | අසභ්‍ය භාෂාව | චෞරභාෂාව
arguable=තර්ක කළ හැකි | වාදයට තුඩු දුන්
argue=කට ගහනවා | කරුණු ගෙනහැර දක්වනවා | තර්ක කරනවා | වාද කරනවා | වාද විවාද කරනවා
arguer=තර්ක කරන්නා
argument=තක | තර්කය | වාදය | විතර්කය | විස්තාරය | ස්වායත්ත විචල්‍යය
argumentation=වාදය | විතර්කණය | විවාදය
argumentative=තර්කශීලි | වාද පාත්‍ර | වාදශීලී
arguments=තර්ක | වාද
argumentum=තර්කය
argus=ග්‍රීක මිථ්‍යාකථාවල එන ඇස් සියයක් ඇති ආරක්ෂකයා
argute=තියුණු
argy-bargy=කලබැගෑනිය | වියවුල
argyrite=ආගිරයිට්
argyrodite=ආගිරොඩයිට්
aria=නාට්‍යවලදී ඉදිරිපත් කරන ගායන වෘන්දයක්
arianism=ඒ‍රියානුවාදය
arid=තෙතමනයක් නැති | නිසරු | රූක්ෂ | වියලි | වියළි | ශුෂ්ක | හුන්
aridity=වියලි බව | ශුෂ්කතාව
aridness=වියලි බව
aries=මේෂ | මේෂ රාශිය
aright=ක්‍රමවත්ව | නිවැරදි ලෙස | යහපත් ලෙස | යුතු | හරියාකාර
aril=බීජ කවචමය
arillate=කවවමය
arillus=බීජ කවචමය
arise=ඉදිරිපත් වෙනවා | උදා වෙනවා | උපදිනවා | එෘවෙනවා | නැගිටිනවා | නැගී සිටිනවා | පායනවා | පැන නගිනවා | මතු වෙනවා | හටගන්නවා
arisen=උත්පන්න
arista=කූර | නණ්ඩුව
aristocracy=ප්‍රභූතන්ත්‍රය | රදල පන්තිය | රදළ පෙළැන්තිය | වංශවතුන්ගේ ආණ්ඩුව | වංශවතුන්ගේ පෙළන්තිය
aristocrat=කුලීනයා | රදළයා | වංශක්කාරයා | වංශවත් තැනැත්තා
aristocratic=අභිජාත | අභිමාන ඇති | කුලීන | රදළ ආණ්ඩුව | වංශවත් | ශිෂ්ට
aristotelian=ඇරිස්ටෝටලියානු
arithmatic=අංක ගණිතය
arithmetic=අංක ගණිතය | අංක විද්‍යාව | අංකගණිතය | අංකමය
arithmetical=අංක ගණිත | අංක ගණිතමය | ගණිත හා සම්බන්ධ
arithmetician=ගණකයා | ගණිත ශාස්ත්‍රඥයා
arithmetieal=අංක ගණිත | ගණිත
aritmomania=ගණිතෝන්මාදය
ark=පෙට්ටියක් මෙන් වැසූ නැව
arkansite=ආකන්සයිට්
arkevalue=වෙළෙඳ අගය | වෙළෙඳ පොළෙහි අගය
arkite=ආකයිට්
arksutite=ආක්සුටයිට්
arm=අත | ආයුධ ගන්නවා | ආයුධය | ඇන්ද | බා | බාහු | බාහුව | බුජ | භුජය | යුද්ධ සේනාංගය | ශාඛාව | සන්නද්ධ වෙනවා | හුණු
arm-chair=අත්පුටුව
arm-let=අංගදාභරණය | වළල්ල
arm-pit=කක්ෂපුට | කිහිල්ල
armada=නාවික යාත්‍රාසමූහය | නැව් කණ්ඩායම | යුජයට සැරසුණු අහස්‍යාත්‍රා
armadillo=කබැල්ලෑවා වැනි සතෙක්
armageddon=ඉතා විශාල අරගලය
armament=යුධෝපකරණ
armaments=යුද්ධායුධ | යුද්ධෝපකරණ
armature=ආමේචරය | ආමේවරය | සැකිල්ල
armed=යුද්ධයට සැරසුණු | සන්නද්ධ | සන්නාහ සන්නද්ධ
armenian=ආර්මිනියානු
armful=ඔසවා ගත හැකි තරමක් | වඩා ගත හැකි තරමක්
armistice=තාවකාලික සමාදානය | සටන් නිමාව | සටන් විරාමය
armless=අත් නැති | අතු නැති | ආයුධ නැති
armlet=අංගදය | අත්පටිය | බන්දි වළල්ල
armorial=යුද්ධායුධ පිළිබඳ වූ
armorican=ආමොරිකන්
armory=යුධ අවි ගබඩාව
armour=ආරක්ෂාව | කඤ්චුකය | කවචය | කවද | සන්නාභය | සන්නාහය | සැද
armour-plated=ආරක්ෂක තැටිවලින් යුක්ත
armoured=සන්නද්ධ | සන්නාහ
armourer=යුද්ධ ආයුධ තනන්නා | යුද්ධායුධ තනන්නා
armoury=යුද්ධායුධ | යුද්ධායුධ ගබඩාව
armpit=ඉකිළිය | කක්ෂය | කිහිල්ල
arms=අත් | ආයුධ | බාහු | යුද්ධ භටයෙකුගේ වෘත්තිය | යුද්ධායුධ | යුද්ධායුධවලින් සකස් කරනවා | සන්නාහ | සන්නාහ සන්නද්ධ කරනවා | සන්නාහ සන්නද්ධ වෙනවා
army=ඇණිය | කඳවුර | බල ඇණිය | බල සෙනඟ | බළ සෙනඟ | යුද්ධ සේනාව | යුද්ධ හමුදාව | වාහිනී | සමුදාය | සමුදාව | සමූහය | සේනා | සේනාව | හමුදා | හමුදාව
army-worm=න් පණුවා
arnatto=ආනටෝ
arnica=ශාකවලින් ලබාගත් ඖෂධ විශේෂයක්
arnivore=මාංශභක්ෂකයා
arnotto=ආනටෝ
arogant=උදාරම්
aroid=හබරල
aroma=ආමෝදය | පුසුඹ | සුවඳ
aromatic=අහළ පහළ | ආමෝදිත | වටකර | වටේට | සගන්ධ | සුවඳැති | හාත්පස
arose=නැගිට්ටා | පෑව්වා
around=අවට | එහා මෙහා | එහි මෙහි | පරි | වටා | වටින් | වටේ | හාත්පස | ළඟ
arouse=අවදි කරනවා | අවදි වෙනවා | අවුස්සනවා | උනන්දු කරනවා | නැගිටිනවා | ප්‍රබෝධ කරනවා | පුබුදු කරනවා
aroyl=ඇරොයිල්
arpeggio=ආද්‍රුතිය | වේගවත් සංගීත රිද්මයක්
arpent=ආපෙන්ටය
arquebus=පැරණි තුවක්කු වර්ගයක්
arqueite=ආක්වරයිට්
arra=අත්තිකාරම | ඇරාව
arrack=අරක්කු
arragnment=විනිශ්චයට ඉදිරිපත් කිරීම
arraign=අධිකරණයට පමුණුවනවා | චෝදනා කරනවා | චෝදනා ප්‍රකාශ කරනවා | දෝෂාරෝපණය කරනවා | විනිශ්චයට ඉදිරිපත් කරනවා
arraignment=චෝදනා ඉදිරිපත් කිරීම | චෝදනාව
arrange=අවුරනවා | අසුරනවා | නියම කරගන්නවා | පට්ටල් කරනවා | පනවනවා | පිළියෙල කරනවා | පිළියෙළ කරනවා | පිළිවෙළ කරනවා | පෙළ ගසනවා | යොදනවා | සකසනවා | සකස් කරනවා | සලසනවා
arranged=සැදි | සැදී
arrangement=එකඟවීම | ප්‍රතිඥානය | පිළියෙල | පිළියෙළ | පිළියෙළ කිරීම | පිළිවෙළ | පිළිවෙළ කිරීම | විධිවිධානය | වින්‍යාසය | සංවිධානය | සංස්ථාපනය | සැකසීම | සැකසුම | සැලසීම | හෙළිපෙහෙළිය
arrangements=පිළියෙළ කිරීම් | විධිවිධාන
arranging=පිළියෙළ කිරීම
arrant=අත්‍යන්ත | අධම | ඉතා නරක | තුච්ඡ | දරුණු | පල් | පාදඩ | වස
arras=අරාසය | සැරසිල්ල
array=අන්දනවා | අඳිනවා | අභරණය | අයිත්තම් | අරාව | ආභරණය | ආයිත්තම | පළඳවනවා | පිළියෙල කරනවා | පිළියෙළ | පිළිවෙළ | පෙළ | පෙළ ගස්සනවා | පෙළපාලිය | වර්ග පන්තිය | වැල | සටනට පෙළගැසීම | සරසනවා | සැරසීම
arrear=අතපසුව | පසුපස | හිඟය
arrears=අතපසුව | උපශිෂ්ටය | ගෙවුම් හිඟය | හිඟ | හිඟ මුදල් | හිඟය | හිඟව
arrest=අත් අඩංගුවට ගැනීම | අත්අඩංගුවට ගැනීම | අල්ලනවා | ඇල්ලීම | නවත්වනවා | ප්‍රග්‍රහණය | යොමු කරවනවා | වැළැක්වීම | සංග්‍රහණය | සිර භාරයට ගන්නවා | සිර භාරයට ගැනීම | හිටවනවා | හිරබාරයට ගන්නවා | හිරබාරයට ගැනීම
arrestee=අල්ලනු ලබන්නා
arrester=අල්ලන්නා | ගුවන් යානයක් බිමට බැස්වීමේදී මන්දනය | නවතනය
arrestment=නිවාරකය | නිවාරණය
arrestor=අල්ලන්නා | නිවාරකය
arricciato=අරිච්වයාතෝ බදාමය
arris=අරිස | ගඩොල් දාරය
arrival=ආගම | ප්‍රාප්තිය | පැමිණි තැනැත්තා | පැමිණිය අය | පැමිණීම | සම්ප්‍රාප්තිය | සමාගත | සමාගතිය | සැපත
arrive=එනවා | පැමිණෙනවා | සේන්දු වෙනවා | ළඟා වෙනවා
arrived=අනුප්‍රාප්ත | ආගත | ප්‍රතිපන්න | වුත් | සම්ප්‍රාප්ත | සැපත්
arriviste=තමා ගැන පමණක් සලකන පුද්ගලයා
arrogance=අධිමානය | අභිමානය | අහංකාරය | එඩිය | ගර්වය | මාන්නය
arrogant=අහංකාර | ආඩම්බර | උද්ධච්ච | උද්ධත | එඩිතර | ප්‍රගල්භ | ප්‍රෙඩෙ | මාන්නක්කාර | මානාදික | වහසි
arrogate=ආරූඩ කර ගන්නවා | පවරා ගන්නවා
arrow=ඊ | ඊගස | ඊතලය | ඊය | කූර | නරද | බාණ | වාණ | ශර | ශරය | ශල්‍යය | සර | සරය | සැරය | හිය | හී | හීය
arrow-head=ඊතලය
arrow-root=හළංකීරිය
arrowgraph=ඊ ප්‍රස්තාරය
arrowroot=අරලුපිටි | හුලංකීරිය | හුළංකීරිය
arroyo=වාරදොළ
arse=ගුදය | තැනැත්තා
arsenal=අවිහල | යුද්ධායුධ කම්මල | යුද්ධායුධ ගබඩාව | ශස්ත්‍රාගාරය
arsenate=ආසනේට්
arsenic=ආර්සනික් | ආසනික් | ආසනියම් | නේපාලිකා | පාසානම් | මනහ්ශිලා | මයූරතුකු
arsenical=ආසනික
arsenides=ආසනයිඩ්
arsenite=ආසනයිට්
arsenium=ආසනියම්
arsenolite=ආසනොලයිට්
arsenopyrite=ආසනොපයිරයිට්
arsine=ආසීන්
arson=කුදහනය | ගිනි තැබීම | ගිනිතැබීම | ගෘභදාහය | ගෙවල් ගිනි තැබීම | ගෙවල් ගිනිතැබීම
arsonable=කුදහ්‍ය
art=උපාය | කලාව | දක්ෂකම | නිපුණතාව | ප්‍රයෝගය | වත්‍ර කලාව | වත්‍රකර්මය | වත්‍රකර්මාන්තය | වත්‍රකලාව | වත්‍රශිල්පය | ශිල්පය
artefact=මෙවලම
arterial=ධමනි | ධමනි හා සම්බන්ධ | ධමනිය | ධමනීය
arteriole=ධමනිකාව
arteriosclerosis=ධමනී ජාරඨ්‍යය | ධමනී දෘඩතාව | රෝගයක්
arterole=ධමනිකාව
artery=ධමනිය | ප්‍රධාන ගමන් මාර්ගය | රක්තවාහිනිය
artesian=ආටීසියානු
artful=උපායෙහි දක්ෂ | කපටි | කෛරාටික | චාටු | මායාකාර
arthoplasty=පර්ව කල්පනය
arthritis=ආමවාතය | පර්වදාහය | පර්වප්‍රදාහය | වාතරක්තය | සන්ධි ඉදිමීම | සන්ධිප්‍රදාහය
arthrodesis=පර්වබද්ධය
arthropod=සන්ධිපාදකයා | සන්ධිපාදිකයා
arthrospore=ආත්‍රොස්පෝරය | සන්ධි බීජාණුව
artichoke=අල සූරියකාන්ත | එළවලු වර්ගයක්
article=කොටස | කොන්දේසිය | ඛණ්ඩය | ගිවිසුම් ආදියෙහි වගන්තිය | ඡේදය | ද්‍රව්‍යය | දෙය | නියාමිතය | පනත | බඩුව | භාණ්ඩය | ලිපිය | වගන්තිය
articled=පොරොන්දුවක් අනුව අතවැසි භාවයට පැමිණි
articles=කොන්දේසි | ගිවිසුම් | චෝදනා දක්වනවා | පොරොන්දුවකට යටත් කරනවා | ව්‍යවස්ථා | ව්‍යවස්ථාවලිය
articular=සන්ධාන
articulate=අක්ෂර සහිත | අමුණනවා | ආඳිනවා | ඈඳූ | උච්චාරණය කරන | පැහැදිලි | පැහැදිලිව කියනවා | යමක් කියාපෑමට හැකි | ශබ්ද ප්‍රකාශ වන | සන්ධානයට එනවා | සන්ධි කරනවා
articulated=ඈඳූ | සන්ධි සහිත
articulation=ඈඳීම | උච්චාරණය | උදීරණය | පැහැදිලි ප්‍රකාශය | සන්ධාන කරණය | සන්ධානය | සන්ධිය | සූච්චාරණය
articulator=උදීරක | උදීරකයා
artifact=කෘතකය | මානවකෘතිය | මෙවලම | සිප්පම
artifacts=මානවකෘති
artifice=උපක්‍රමය | උපාය | ප්‍රයෝගය | මායාව
artificer=කර්මාන්තකරුවා | කර්මාන්තකාරයා | ශිල්පියා
artificial=අස්වාභාවික | කෘතක | කෘත්‍රිම | නිර්මාපිත | ව්‍යාජ | විකර
artificiality=කෘත්‍රිම බව
artificially=අස්වාභාවික ලෙස | කෘත්‍රිම ලෙස
artillery=කාලතුවක්කු | කාලතුවක්කු රැගත් සේනාංගය | කාලතුවක්කු ශිල්පය | කාලතුවක්කු හමුදාව
artisan=කම්කරුවා | කර්මාන්තකරුවා | කර්මාර | ශිල්පියා | සිප්කරු
artist=කලාකරු | කලාකරුවා | කලාකාරයා | කලාවේදියා | කලාශිල්පියා | නිපුණයා | රසිකයා | වත්‍ර ශිල්පියා | වත්‍රකාරයා | වත්‍රශිල්පියා | ශිල්පියා
artiste=කලා ශිල්පියා | රඟපාන්නා | වෘත්තිමය නැටුම් කරන්නා | වෘත්තීමය ගැයුම් කරන්නා | ශිල්පියා
artistic=කලා | කලාත්මක | මනහර | රමණීය | රම්‍ය | ශිල්පාත්මක | සෞන්දර්යයට ප්‍රිය කරන
artistry=කලා කෞශල්‍යය | කලාකෘතිය | කලාකෞශල්‍යය | නිපුණභාවය
artless=අදෂ | අවංක | අව්‍යාජ | ග්‍රාමික | චාම් | ප්‍රයෝගනැති | පිළිවෙළක් නැති | මුග්ධ | සරල
arts=කලා ශිල්ප | විද්‍යා | ශාස්ත්‍ර
arty=කලාශිල්පියෙකු වීම අපේක්ෂිත | පුහු කලාත්මක | මනහර යැයි කිද්‍රීයන | ව්‍යාජ කලාවාදී
arum=කිඩාරම් | පණු අල
arunta=අරුන්ත
aryan=ආර්ය | ආර්යයා | ආර්ය්‍ය | ආර්ය්‍ය වර්ගයට අයත් | උතුම්
aryl=ඇරිල්
arytenoid=දාර්වික
as=එව් | තුල් | තෙක් | නිසා | පරිදි | මෙන් | යථා | යම් බඳු | ලෙස | වගේ | වත් | වන් | වශයෙන් | වාගේ | වාලේ | වැනි | විට | සමාන
asafetida=පෙරුම්කායම්
asafoetida=ඇසපිටීඩා | පෙරුංකායම් | පෙරුම්කායම් | හිංගු
asanaghara=ආසනඝරය
asarite=ඇසරයිට්
asbastosis=ඇස්බැස්ටෝසියාව
asbestos=ඇස්බැස්ටෝස් | ඇස්බෙස්ටොස් | ඇස්බෙස්ටෝස්
asbolite=ඇස්බොලයිට්
ascarite=ඇස්කරයිට්
ascend=ආරුඩ වෙනවා | ආරූඩ වෙනවා | නගිනවා | නඟිනවා | නැගෙනවා
ascendance=උන්නතිය | නැගීම | බලයට පත්වීම | මුදුනට පැමිණීම
ascendancy=ඉහළට යාම | නැගීම | බලයට පැමිණීම
ascendant=ආරෝහණයා | උදාවීම | මව්පිය පරම්පරාව | වඩා උසස් බව
ascendency=ප්‍රභූත්වය | බලපෑම
ascendens=උද්‍රෝහක
ascendent=උච්ච | උච්ච බව | උතුම් | උද්‍රෝහක | උදා වන | උදා වන රාශිය | උදා වීම | නැගෙන | බලපවත්වන | ලග්නය | වඩා උසස් බව
ascending=ආරෝහණ | ආරෝහණය | උද්‍රෝහක | ඌර්ධ්වගාමී | ක්‍රමයෙන් වැඩි වන | නගින
ascension=ආරෝහණය | නැගීම
ascent=ආරෝහය | උද්ගමනය | උසස් වීම | නැග්ම | නැගීම | නැඟුම
ascertain=අවබෝධ කරගන්නවා | දැනගන්නවා | නිර්ණය කරනවා | නිශ්චය කර ගන්නවා | නිසැකව දැන ගන්නවා | විචාරා දැනගන්නවා | සොයා දැනගන්නවා | හගිස්වනවා | හගිස්සනවා
ascertainability=නිර්ණේයත්වය
ascertainable=දැන ගත හැකි | දැනගත හැකි | නිර්ණේය
ascertained=දැනගත් | නිර්නිත | නිශ්වත
ascertaining=ප්‍රනිශ්චය
ascertainment=නිර්ණයනය | විචාරා දැනගැනීම
ascetic=ජටිලයා | තවුස් | තවුසා | තාපස | තාපසයා | දැමිඳුරු | පැවිද්දා | පැවිදි | මුනි | යති | යෝගාවචරයා | යෝගියා | ශ්‍රමණ | ශ්‍රමණයා | සන්‍යාසියා | සමණ
asceticism=තපස | තව | තවුස්බව | ව්‍රතය | ශ්‍රමණභාවය
ascetisism=අල්පේච්ඡතා වාදය
ascharite=ඇෂරයිට්
ascii=ඇස්කි
ascites=ජලොදරය | ප්ලෝදරය
ascocarp=අස්කඵලය | අස්කොකාපය
ascogenous=අස්කජනක
ascogonium=අස්කොගෝනිය | ආකිකාපය | පුරාණ්ඩපය
ascolichenes=අස්කොලිකේනේස්
ascomycetes=අස්කොමිසේටේස්
ascospore=අස්කබීජාණුව | අස්කොස්පෝරය
ascribe=ආරෝපණය කරනවා | පවරනවා | ප්‍රලබ්ධ
ascription=ආරෝපණය | ප්‍රලබ්ධතාව | පැවරීම
ascus=අස්කස
asdic=ඇස්ඩිකිය | දිය යට ඇති දේවල් සොයාගන්නා පුරාණ ක්‍රමයක්
aseismic=අකම්ප
aseitas=ස්වයංභූත්වය
aseity=ස්වයංභූ
asemasia=අවාණිතාව | අවානිතාව
asemia=අවාණිතාව
asepsis=නිපුතිය | නිපූතිය | නොපැසවන බව | නොපැසවීම | සැරව නැති බව
aseptate=නිරාවාර
aseptic=අපුති | නිපූති | විෂබීජ රහිත | සැරව නැති
asexual=අලිංගික | ලිංගහීන | විරාගී
asexualisation=අලිංගීකරණය
asexuality=අලිංගිකතාව
ash=අළු | ඈෂ් | බස්ම | භස්ම | භස්මය | භස්මාවශේෂ | භ්‍රස්ම | හළු
ash-plantain=අළු කෙසෙල්
ash-pumpkin=අළුපුහුල්
ashamed=ලජ්ජා වූ | ලජ්ජාවට පත් | ලජ්ත
ashamedly=ලජ්ජා සහිතව
ashen=අළු වැනි | අළුපාට | ධූසර
ashes=අළු | භස්මාවශේෂ
ashkenazi=නැගෙනහිර යුරෝපීය යුදෙව්වා
ashlar=ආශ්ලේෂ බැම්ම | ගලින් නිම කරන ලද හතරැස් වූ නිර්මාණය
ashore=ගොඩ | ගොඩට | ගොඩබිමෙහි | වෙරළට | වෙරළෙහි
ashpan=අළුබඳුන
ashram=ආශ්‍රමය | තවුසන්ගේ අසපුව
ashtray=අළුතැටිය | සිගරැට් අළු බඳුන
ashy=අළු වැනි | අළු සහිත
asia=ආසියාව
asian=ආසියාතිකයා | ආසියානුවා | ආසියාවට අයත්
asiatic=ආසියාතික
aside=අපගත භාෂණය | අහක | අහකට | ඉවත | ඉවතට | එකත්පස්ව | කොණකට | පසෙක | පැත්තක | හැර
asinine=ගද්‍රභ | බූරු | බූරුවාට අයත් | මූර්ඛ | මෝඩ
asininity=මෝඩකම
ask=අයදිනවා | අසනවා | ඉල්ලනවා | ඉල්ලා සිටිනවා | කැඳවනවා | විචාරනවා | විතාරනවා | විමසනවා
askance=අවිශ්වාසයෙන් | ඇදව | ඇස් කොණින් | වපර ඇසින් | වපරව | වපරෙට
askant=අවිශ්වාසයෙන් | ඇදව | ඇස් කොණින් | වපරව
askari=අප්‍රිකානු යුද්ධ භටයා
askew=ඇද ලෙස | ඇදට | ඇලව | විපරීතව | හරහට
asking=ඇසීම
aslant=ඇද ලෙස | ඇලව | හරහට
asleep=නිද්‍රෝපගත | නිදි | නිදිගත්
asocial=සමාජශීලී නොවන
asomatic=අදෛහික | ආදේහික
asp=මිසර දේශයෙහි විසකුරු කුඩා සර්පයෙක්
asparagine=ඇස්පරන්
asparagus=රට හාතාවාරිය | හාතාවාරිය
aspasiolite=ඇස්පැසියොලයිට්
aspect=අංගය | අංශය | ආකාරය | ආභාව | දකිනවා | දර්ශනය | දර්ශය | දශාව | දිෂ්ටිය | දෘෂ්ටිය | පාර්ශ්වය | පැත්ත | පෙනුම | පෙනෙනවා | බලනවා | බැල්ම | බෑවියාව | රූපය | ලක්ෂණය | වෙස | වෙස්
aspectable=දකින | පෙනෙන
aspectual=පැහැදිලි | පෙනෙන
aspen=තරල | නිතර සැලෙන පත්‍ර ඇති ගස් ජාතියකි
asperate=රඵ
asperge=ඉසිනවා
aspergillin=ඇස්පලින්
asperity=කටුක බව | කර්කශභාවය | රළු බව | විෂමතාව
asperous=රඵ
asperse=අගූණ කියනවා | කේලාම් කියනවා | නින්දා කරනවා | සපාදූප කියනවා
aspersion=අපවාදය | ඉසීම | නින්දාව | පරෝපවාදය | සේචනය
asperulous=මඳ රඵ
asphalt=ඇස්පැල්ට් | ඇස්පැල්ට් තාර | ගල්තාර | ගල්තාර දමනවා
asphaltum=ඇස්පැල්ට්
aspherical=අගෝලීය
asphodel=ග්‍රීක මිථ්‍යාකථාවල එන මල් විශේෂයක්
asphyxia=ඇස්පික්ෂියාව | ඇස්පික්සියාව | නිෂ්පුරණය | නිෂ්ඵූරණය | මූර්ඡාව | මූර්ජාව | ශ්වාසරෝධය | හුස්ම නැවතිම | හුස්ම හිරවීම
asphyxial=ශ්වාසරෝධී
asphyxiate=හුස්ම ගැනීම වළකනවා
asphyxiation=හුස්ම ගැනීම වැළකීම
aspidistra=විශාල පත්‍ර ඇති ගස් වර්ගයක්
aspirant=අපේක්ෂකයා | තැත්කරන්නා
aspirate=මහා ප්‍රාණාක්ෂර ශබ්ද කරනවා | මහාප්‍රාණ | මහාප්‍රාණාක්ෂර උච්චාරණය කරනවා | මහාප්‍රාණාක්ෂරය | හකාරය
aspirated=මහා ප්‍රාණ
aspiration=අපේක්ෂාව | අභිලාශය | අභිලාෂය | උච්ශ්වසනය | චූෂණය | ප්‍රණිධිය | ප්‍රාර්ථනාව | සංකල්පය
aspirator=චුෂකය | චූෂකය | දියර අදින උපකරණයකි | වූෂකය
aspire=අපේක්ෂා කරනවා | පතනවා | ප්‍රාර්ථනා කරනවා | බලාපොරොත්තු වෙනවා
aspirin=ඇසිටයිල් සැලිසිලික් අම්ලය | රුජානාශක ඖෂධයක්
aspiring=පතන
asport=ගෙනයනවා | සාවද්‍යු ලෙස ගෙනයනවා
asportation=ගෙනයෑම
aspout=වීසි වෙමින්
asquat=ඇණ තියා ගෙන
asquint=ඇස් කොණින් | වපරව
ass=ගද්‍රභයා | බූරුවා | මෝඩයා
assafoetida=පෙරුම්කායම්
assail=අඩම්තේට්ටම් කරනවා | ආක්‍රමණය කරනවා | දොස් නගනවා | පහර දෙනවා | විරුජකම් පානවා
assailant=තදින් පහර දෙන්නා | පහර දෙන්නා | ප්‍රහාරකයා | වාදයට එළඹෙන්නා | සටනට එළඹෙන්නා
assart=වල් කෙටීම | වල් කොටනවා | වල්කෙටීම | වල්කොටනවා
assasination=ඝාතනය
assassin=ඝාතකයා | මිනීමරුවා | රහසින් මිනීමරන්නා | හදිසියෙන් මිනීමරන්නා
assassinate=ඝාතනය කරනවා | මිනීමරනවා | රහසින් මිනී මරනවා | හදිසියෙන් මිනී මරනවා
assassination=ආඝාතනය | ඝාතනය | මිනීමැරීම
assassinator=රහසින් මිනීමරන්නා | හදිසියෙන් මිනීමරන්නා
assassintion=රහසින් මිනී මැරීම | හදිසියෙන් මිනී මැරීම
assault=අඩන්තේට්ටම | අඩන්තේට්ටම් කරනවා | අඩන්තේට්ටම් කිරීම | අඩම්තේට්ටම් කිරීම | පහර | පහර දීම | පහර දෙනවා | පහරදීම | පොලු ගසනවා | බැට දෙනවා
assay=අර්ඝණය | අර්ඝනය | උත්සාහ කරනවා | උත්සාහ කිරීම | උත්සාහය | උරගා බලනවා | උරගා බැලීම | තැත් කරනවා | තැත්කිරීම | පරීක්ෂා කරනවා | පරීක්ෂා කිරීම | පහර දෙනවා | පහරදීම | මාත්තු බලනවා | මාත්තු බැලීම
assaying=උරගා බැලීම
assegai=දකුණු අප්‍රිකානුවන් භාවිත කරන හෙල්ලයක්
assemblage=එකලස් කිරීම | ගණය | රාශිය | රැස් කිරීම | රැස් වීම | රැස්වීම | සන්නිපාතය | සමූහය
assemblance=ගණය | රාශිය | රැස් කිරීම | රැස් වීම | සමූහය
assemble=එකතැන් කරනවා | එකතු වෙනවා | එකතුකරනවා | එකලස් කරනවා | එක්‍රුස් වෙනවා | එක්‍රොක් වෙනවා | රැස් කරනවා | රැස් වෙනවා | රැස්කනවා
assembled=සංගත
assembler=එසෙම්බලරය | එසෙම්බ්ලරය
assembling=එකතු කිරීම | එකලස් කිරීම | රැස්වීම
assembly=අත්තානි | එකතුව | එකලස | ගොන්න | පර්ෂද | පර්ෂදය | පරිෂදය | මන්ත්‍රණ සභාව | මුළුව | රැස්කිරීම | රැස්වීම | සංගතිය | සංගමය | සන්නිපාතය | සභාව | සම්මේලනය | සමාජය | සමුළුව | සමූහය
assent=අධිමතිය | අධිවාසනා | අනුඥාව | අනුදැනීම | අනුමත කරනවා | අනුමතිය | අවසරය | එකඟ වෙනවා | එකඟත්වය | කැමත්ත | කැමැත්ත දෙනවා | පිළිගන්නවා | පිළිගැනීම
assented=අනුමත | එකඟ වූ
assert=කියා සිටිනවා | තරයේ ප්‍රකාශ කරනවා | තිරසරව ප්‍රකාශ කරනවා | පවසනවා | ප්‍රකාශ කරනවා | ප්‍රභාෂණය කරනවා | බලය තහවුරු කර ගන්නවා | ස්ථීර ලෙස ප්‍රකාශ කරනවා
asserting=ප්‍රනිශ්චය කිරිම
assertion=කියමන | තරයේ ප්‍රකාශ කිරීම | තිරසරව ප්‍රකාශ කිරීම | නිශ්වත ප්‍රකාශනය | ප්‍රකාශය | ප්‍රභාෂණය | පැවසීම | සහතික ලෙස පැවසීම | සහතිකළෙස ප්‍රකාශ කිරීම | ස්ථිර ප්‍රකාශය | ස්ථිරළෙස ප්‍රකාශ කිරීම | ස්ථීර ප්‍රකාශය
assertive=ගර්විත | බලපෑමට තැත් කරන
assertoric=ප්‍රවර්තමාන
assertory=අස්ත්‍යර්ථ | එසේය කියන | ප්‍රභාෂණ
assess=අගය කරනවා | තක්සේරු කරනවා | තුලනය කරනවා | දඩය නියම කරනවා | මිල නියම කරනවා | වටිනාකම නියම කරනවා
assessable=තක්සේරු කළ හැකි | තක්සේරු වන | තුලනීක්ෂ්‍ය
assessed=තක්සේරු කළ | තුලනීක්ෂිත
assessee=තක්සේරු කරනු ලබන්නා | තක්සේරු කරනු ලබන්නා | තක්සේරුව ලබන්නා | තුලනීක්ෂිතයා
assessment=අගය කිරීම | ඇගයුම | තක්සෘ කිරීම | තක්සේරු | තක්සේරුව | තුලනීක්ෂණය | වර්පණම්
assessor=තක්සේරුකරු | තක්සේරුකාරයා | තුලනීක්ෂක | දඩය නියම කරන්නා | මිල නියම කරන්නා | වටිනාකම නියම කරන්නා | වණ්ණකු
asset=ධනය | වත්කම | වස්තුව | වාසිය
assets=මුළු වත්කම | වත්කම්
assets,liquid=ද්‍රවශීල වත්කම්
asseverate=දිවුරා කියනවා | සත්‍ය ලෙස ප්‍රකාශ කරනවා | සහතික වශයෙන් කියනවා
asseveration=සහතික වශයෙන් කීම
assiduity=අනලස් බව | කඩිසරකම | පරවශතාව | පරායණය
assiduous=අනලස් | අප්‍රමාද | අප්‍රමාදී | උද්‍යුෝගිමත් | නොකඩව යෙදෙන
assiduously=අනලස්ව
assiege=වටලනවා
assign=නියම කරනවා | පත් කරනවා | පවරනවා | පාවාදෙනවා | බාර කරනවා | භාර කරනවා | වෙන් කරනවා
assignable=පවරාදිය හැකි | පැවරිය හැකි
assignat=අසිඤ්ඤාව
assignation=පාවා දීම | හමු වීමට යෙදූ වේලාව | හමුවීමට යෙදූ පිළිවෙළ
assignee=අයිතිවාසිකම ලත් අය | පාවාදීම්ලාභියා | පැවරුම්ලාභියා | පැවරුම්ලාභී | පැවැරුම්ලාභී | බලය ලත් අය
assigning=ආරෝපණය
assignment=අන් සතු කිරීම | නියමය | නියමව තිබීම | නියමිත කොටස | පවරා දීම | පාවාදීම | පැවරීම | පැවරුම | පැවැරුම
assignor=පවරන්නා | පාවාදෙන්නා | පැවරුම්කරු
assimilable=උරා ගතහැකි | වැටහෙන | ස්වීකාර්ය | සුගම
assimilate=උරා ගන්නවා | ජීර්ණ කරගන්නවා | ජීර්ණ වෙනවා | ස්වීකරණය කරනවා
assimilation=උරා ගැනීම | උරාගැනීම | ජීර්ණවීම | සමාග්‍රහණය | සමීකරණය | ස්වීකරණය
assimilative=උරා ගැනීමෙහි සමර්ථ | ප්‍රභාසංශ්ලේෂ | ජීර්ණ කරගැනීමෙහි සමර්ථ | සංශ්ලේෂක
assimilatory=ස්වීකරණ
assising=සහකාර
assist=අත ගසනවා | ආධාර වෙනවා | උදව් කරනවා | උදව් වෙනවා | උදවු කරනවා | උපකාර කරනවා | පිටිවහල් වෙනවා | පිහිට වෙනවා | පිහිටනවා | සහාය දෙනවා | හොඳ කරනවා
assistance=අත්උදව්ව | අනුග්‍රහය | ආධාරය | උදව්ව | උදවුව | උපකාරය | ප්‍රතිෂ්ඨාධාරය | පිටිවහල | පිහිට | පිහිටාධාරය | පිළිසරණ | වහල | ශරණ | සහනාධාර | සහය | සහාය
assistant=අතවැසියා | අත්උදව්කාරයා | උදවුකාරයා | උප | ගෝලයා | දෙවන | දෙවැනියා | සහකාර | සහකාරයා | සහාය | සහායක | සහායකයා
assisted=ආධාර දුන් | උදව් වූ | උපකෘත | සනාථ
assisting=උදව් වන | උපකාරක | උපකාරී | සහාය
assize=අණ්ඩාධිකරණය | අපරාධ අධිකරණය | දණ්ඩාධිකරණය | නඩු විභාගවාරය | නියමිත බර | නියමිත මිල ප්‍රමාණය | ශ්‍රේෂ්ඨාදිකරණයෙහි වාරය | සැසි අධිකරණය | සැසි කොමිසම
assizes=අධිකරණ සැසිය | අපරාධාධිකරණය | ශ්‍රෙෂ්ඨාධිකරණයේ සභාවාරය
associate=ආශ්‍රය කරනවා | ආශ්‍රිත | ආශ්‍රිත සහචරයා | ආශ්‍රිතයා | ඇසුරු කරනවා | එකතු කරනවා | එකතු වෙනවා | බජනවා | මිත්‍රයා | සම්බන්ධ කරනවා | සම්බන්ධ වෙනවා | සම්බන්ධී වූ | සමාගම් පවත්වනවා | සහකාර | සහකාර සාමාකයා | සහකාරයා | සහචර | සහචරයා | සහභාග | සහභාගි වෙනවා | සහාය | සහායක | සහායකයා | හවුල් වෙනවා | හවුල්කාරයා
associated=ආශ්‍රිත | නිසේවිත | සංගමී | සංඝටිත | සන්නිහ්ශ්‍රිත | සහභාග | හවුල්
associating=සංඝටන
association=අභිසංගමය | ආශ්‍රය | ආශ්‍රිත අර්ථය | නිශ්‍රය | නිස්සය | නිහ්ශ්‍රය | පයිරුපාසනය | බජනය | භජනය | සංගමනය | සංගමය | සංඝටන | සංඝටනය | සන්ථවය | සන්නිශ්‍රය | සම්බන්ධය | සම්මේලනය | සමාගම | සමිතය | සහචාරය | සේවනය | සේවා
associationalism=සාහචර්යවාදය
associationism=සංඝටන වාදය | සංඝටනවාදය
associative=සංගමික | සංඝටන | හවුල්
associativity=සංඝටතාව
associaton=හවුල
associes=ප්‍රාග්සංගමය
assonance=සංස්වනය | සමස්වනය | සමාන ස්වර ඇතිවීම
assonant=සමාන ස්වර ඇති
assort=කොටස්වලට බෙදනවා | ගැළපෙනවා | තෝරනවා | වර්ග කරනවා | වර්ගවලට බෙදනවා | සරිලනවා
assorted=කලවම් | තෝරා ගත් | තෝරාගත් | මිශ්‍ර | වර්ග කරන ලද | වර්ග කළ
assorter=මිශ්‍ර කරන්නා | මිශ්‍රණය
assortment=තේරීම | තෝරා ගත් දෙය | නොයෙක් වර්ග එකතුව | විවිධ ජාති සමූහය
assuage=සනසනවා | සමනය කරනවා
assumable=සිතා ගත හැකි
assume=අපකල්පනය කරනවා | අභ්‍යපගමනය කරනවා | ආරූඩ කරගන්නවා | ආරෝපණය කර ගන්නවා | ආරෝපණය කරගන්නවා | උඩඟු වෙනවා | උපකල්පනය කරනවා | පිළිගන්නවා | භාර ගන්නවා | සලකා ගන්නවා
assumed=අපකල්පිත | අභ්‍යපගත | ආරුඩ | ආරූඩ කර ගත් | ආරූඩ කරගත් | බාරගත් | භාරගත් | සිතා ගත්
assuming=අහංකාර | නැති බල පෙන්වන | බාර ගන්නා
assumption=අභ්‍යපගතය | අභ්‍යපගමනය | අහංකාරය | උපකල්පනය | උපකල්පිතය | කල්පිත | කල්පිතය | බාරගැනීම | සිතා ගැනීම
assumptive=උපකල්පිත
assurance=අහංකාරකම | ආත්ම විශ්වාසය | ආරක්ෂණය | රක්ෂණය | සහතික කිරීම | සහතික ලෙස කීම | සහතිකය | සැක නැති වීම
assure=ආරක්ෂණය කරනවා | දැනගන්නවා | ධෛර්ය්‍යමත් කරනවා | සහතික කරනවා | සහතික වෙනවා
assured=ආරක්ෂිත | ආරක්ෂිතයා | රක්ෂිත | රක්ෂිතයා | සහතික කළ | ස්ථිර | ස්ථීර | සැක නැති
assuredly=සහතික ලෙස
assuredness=අධික විශ්වාසය
assurer=රක්ෂණය කරන්නා
assurgent=ආරෝහණ | උදා වන
assymetrical=අසම්මිතික
assyriology=මෙසපොටේමියාවේ භාෂාව
astable=අස්ථීර | චංචල
astasia=අපදස්ථාමය | අස්ථාමය
astatic=අස්ථීතික | අස්ථීර
astatine=ඇස්ටටීන්
aster=තරුව | තාරකාරූපය | තුරුව | ශාකයක්
astereognosis=අස්ථෛරීඥෙයය
asterick=තරු ලකුණ
asterisk=ඇස්ටරිස්කය | තරු ලකුණ | තරු සලකුණ | තාරකා ලක්ෂණය
asterism=තාරකා රාශිය | නැකත
asterity=තපස
asterium=ඇස්ටීරියම්
astern=අවරට | අවරයට | අවරයේ | පස්සට
asteroid=ක්ෂුද්‍ර ග්‍රහයා | ක්ෂුද්‍රග්‍රහයා | ග්‍රහකය | ග්‍රහාංශුව | ග්‍රහාභය
asterold=ග්‍රහාංශුව
asthenia=අනූර්ජ්‍යය | ගිලන් බව | දුබලකම
asthenic=අනූර්ජක
asthenopia=අනූර්ජදෘෂ්ටිය
asthenosphere=අධෝගෝලය
asthma=ඇදීම | ඇදුම | ඇඳුම | ඊළ | මුහ | මුහරෝගය | මූහ | ශ්ලේෂ්මාව | ශ්වාස | ශ්වාස රෝගය | ශ්වාසරෝගය
asthmatic=ඇදුම | ඇදුම ඇති | ඇදුම සහිත | මුහ
astichous=අපංක්තික
astigatism=ඇස්වල දෘෂ්ටියේ ආබාධයක්
astigmatism=ඇස්ටිග්මැටිසම | විෂම දෘෂ්ටිකතාව | විෂමදෘෂ්ටිකතාව
astipulate=නිරුපපත්‍රී
astir=උද්‍යෝග | උද්‍යෝගීව | කලබල | කලබලයට පත්ව | ක්‍රියාකාරී | ක්‍රියාකාරීව | නැගිට
astomatous=අමුඛ
astomous=විමුඛ
astonish=පුදුම කරනවා | පුදුම වෙනවා | පුදුමයට පත් කරනවා | මවිත කරනවා | විස්මය දනවනවා | විස්මයට පත් කරනවා
astonishing=පුදුම වන | මවිත වන | විස්මයජනක
astonishment=පුදුමය | පුදුමයට පත් කිරීම | මවිතය | විස්මය | විස්මයට පත් කිරීම | හි
astound=තෝන්තු කරනවා | පුදුමයෙන් ආකුල කරනවා | විස්මයට පත් වෙනවා
astounded=තෝන්තු කරන ලද
astr.=දශාව
astragal=කුළුණු ලීස්තරය
astragalus=ප්‍රකූර්චය | විළුඹු ඇටය
astrakanite=ඇස්ට්‍රකනයිට්
astrakhan=රුසියානු බැටළු වර්ගයක වක් වූ අඳුරු රැළි ගැසුණු ලො
astral=තරු | තාරකාමය | තාරකාවලට සම්බන්ධ | දිව්‍යමය
astral-body=සූක්ෂ්ම දේහය
astral-plane=භූවර්ලොකය
astraphobia=අශනි භීතිකාව | අශනීභීතිකාව
astray=නොමග යන | නොමඟ | නොමඟ ගොස් | මුළා වී
astrict=තද කරනවා | බඳිනවා | හිර කරනවා
astride=කකුල් පළල් කර | පා විහිදුවා
astringe=තද කරනවා | හිර කරනවා
astringency=කසට ද්‍රව්‍යය | කහ ගතිය | කහට ඇති වීම | කහට ගතිය
astringent=කසට | කසටද්‍රව්‍යය | කසටය | කහට | කහට ඇති | රූක්ෂ | හම හකුළුවන
astrochanite=ඇස්ට්‍රොකනයිට්
astrochemistry=නක්ෂත්‍ර රසායන විද්‍යාව
astrocyte=තරු සෛලය
astrofix=තරු මඟින් පිහිටුවීම
astroid=තාරාභය | තාරාවලය
astrolabe=තරික්සුව | තරු මාලිමාව | තරුමාලිමාව
astrolobe=තරික්සුව
astrologer=කේන්දර කාරයා | ගණිතයා | ජ්‍යෝජිතිශ්ශාස්ත්‍රඥයා | ජ්‍යෝජිතීර්වේදියා | දෛවඥ | දෛවඥයා | නක්ෂත්‍රඥයා | නක්ෂත්‍රාචාර්ය | නැකත්කරුවා
astrological=ජ්‍යෝජිතිශ්ශාස්ත්‍රය පිළිබඳ
astrologist=ජ්‍යෝජිතිශ්ශාස්ත්‍රඥයා | දෛවඥයා
astrology=ජ්‍යෝජිතිශ්ශාස්ත්‍රය | ජ්‍යෝජිතිෂ්ශාස්ත්‍රය | තාරකාශාස්ත්‍රය | දෝ | දෝසත | දෝසතර | නක්ෂත්‍රය | හෝරාශාස්ත්‍රය
astrometer=තාරකාමානය
astronaut=අජටාකාශගාමියා | අභ්‍යවකාශගාමියා | අභ්‍යාවකාශගාමියා | ගගනගාමියා | තරු නැවි
astronautical=අජටාකාශගාමී | ගගනගාමී
astronautics=අජටාකාශවිද්‍යාව | අභ්‍යවකාශ විද්‍යාව | නක්ෂත්‍රියාටනය
astronomer=තාරකා ශාස්ත්‍රඥයා | තාරකාවිද්‍යාඥයා | නක්ෂත්‍ර විද්‍යාඥයා
astronomical=ඉතා ඉහළ | තාරකා ශාස්ත්‍රය පිළිබඳ | තාරකාවිද්‍යාත්මක | නක්ෂත්‍ර
astronomy=තාරකා විද්‍යාව | තාරකා ශාස්ත්‍රය | තාරකාවිද්‍යාව | තාරකාශාස්ත්‍රය | නක්ෂත්‍ර විද්‍යාව | නක්ෂත්‍රය
astrophysical=තාරකාභෞතික විද්‍යාත්මක
astrophysicist=තාරකාභෞතිකවිද්‍යාඥ
astrophysics=තාරකා භෞතික විද්‍යාව | තාරකා භෞතිකවිද්‍යාව | නක්ෂත්‍ර භෞතිකය | නක්ෂත්‍රභෞතය
astute=කපටි නුවණ ඇති | කපටි නුවණින් යුතු | චතුර | තීක්ෂණ | නිපුණ | ශූර
asunder=කැබලිව | කැබලිවලට | දෙකඩව | විසිරී | වෙන්ව
asura=දිත් | සුරරිපු
asyllabical=අමාත්‍ර
asylum=ආරක්ෂාව | උන්මත්තකාගාරය | පිස්සන් කොටුව | රක්ෂණ ස්ථානය | රක්ෂස්ථානය | රක්ෂාස්ථානය
asymbolia=සංකේතාඥේයතාව
asymetry=අසමමිතිය
asymmetric=අසමමිතික | නොගැළපෙන
asymmetrical=අසමමිකික | අසමමිතික | නොගැළපෙන
asymmetry=අසමමිතිය | ඉලංගු නැති බව | නොගැළපීම | නොගැළපෙන බව
asymptote=ස්පර්ශෝන්මුඛය
asymptotic=ස්පර්ශෝන්මුඛ
asynatactic=අක්‍රමවත් | අවිධිමත්
asynchronous=අසමමුහූර්තක
asyndetic=හරස් යොමු රහිත
asynergia=අසමග්ර්යය | අසමග්‍රය
at=කාලය දැක්වීමේදී යෙදෙන නිපාතය | කෙරෙහි | ගණන දැක්වීමේදී යෙදෙන නිපාතය | දී | නිසා | බැගින් | වෙත | ස්ථානය දැක්වීමේදී යෙදෙන නිපාතය | හි | ළග
at-home=ප්‍රිය සම්භාෂණය | හරහට
atables=කැවිලි
atacamite=ඇටැකමයිට්
atakamite=ඇටැකමයිට්
atalaya=අට්ටාලය
ataraxia=නිහැඬියාව | මධ්‍යස්ථතාව | සන්සුන්බව
ataraxy=නිහැඬියාව
atavism=අතීත තත්ත්වයට පෙරළීම | අතීතාභරණය | අතීතාහරණය | ආතව වාදය | ආතවවාදය
atavistic=අතීතාහෘත
ataxia=අනත්වය | අනන්වය
ataxiagraph=අනන්වය රේඛය
ataxiameter=අනන්වය මානය
ate=කෑවා
atelectasis=නිස්ථාරය
atelier=කලාගාරය | නිර්මාණ කුටිය | වත්‍රාගාරය | ශිල්පායතනය
atempt=කැසකවනවා
atenuate=කෙට්ටු කරනවා | තුනී කරනවා | හීන් කරනවා
aterian=අතීරියානු
atheism=අදේව වාදය | අදේවවාදය | අනිශ්වරවාදය | දෙවියකු නැතැයි විශ්වාසය | නාස්තික වාදය
atheist=අදේව දෘෂ්ටිකයා | අදේවවාදියා | අනිශ්වරවාදියා | අනීශ්වරවාදියා
atheistic=අදේවවාදී
athermanous=අතාපදායී
atheroma=ඇතිරෝමා
atherosclerosis=රුධිර නාලිකා සිහින් වීමේ රෝගය
athirst=උත්සුක | තදබල ආශාවෙන් යුක්ත | පිපාසය ඇති
athlete=ක්‍රීඩකයා | දේහ ශක්තිය ඇත්තා | මල්ලක්‍රීඩකයා
athletic=මලල ක්‍රීඩා | මල්ල | මල්ලක්‍රීඩා
athletics=මලල ක්‍රීඩා | මල්ලක්‍රීඩා
athwart=ඇලේට | ප්‍රති | හරස්ව | හරහට
atlanthropus=අත්ලාන්ත්‍රෝපුස්
atlas=ඇට්ලසය | ඇට්ලස් | සිතියම් පොත | සිතියම් සංග්‍රහය
atmite=ඇට්මියිට්
atmology=ජලවාෂ්පවිද්‍යාව
atmolysis=වාය්වංශනය | වායුවිශ්ලේෂණය
atmometer=ඇට්මොමිීටරය | ඇට්මොමීටරය
atmos=වායුගෝලය
atmosphere=අන්තරීක්ෂය | ආකාශය | ආශ්‍රය | ගුවන්තලය | වාතාවරණය | වායුගෝලය
atmospheric=වාතය පිළිබඳ | වායුගෝලීය
atmospherical=වාතය පිළිබඳ
atmospherics=වායුගෝලීය කැළඹීම | වායුගෝලීය කැළැඹීම | වායුගෝලීය කැළැඹීම්
atmotheraphy=වාෂ්ප වකිත්සාව
atocia=ස්ත්‍රී වන්ධ්‍යතාව
atoll=අතොල | අතොළුව | මැද ජලාශයක් ඇතිව සෑදුණු හිරිගල් දිවයින
atollon=අටෝල
atom=අණුව | පරමාණුව | ලේශය
atomement=නිෂ්කෘතිය | වරදින් මිදීම
atomic=අණු | පරමාණු | පරමාණු හා සම්බන්ධ | පරමාණුක
atomicity=පරමාණුකතාව
atomise=පරමාණු කවනවා
atomiser=ශිඛරිකරණය
atomism=අණුවාදය | පරමාණුත්වය | පරමාණුවාදය
atomisor=ඇටමයිසරය | තුකුරුව
atomization=තූකරණය
atomize=පරමාණු කවනවා
atomizer=තුකුරුව | තූකුරුව | ද්‍රවසීකර යන්ත්‍රය | ශිඛරිකරණය
atomology=පරමාණු විද්‍යාව
atomosphere=පරිසරය
atoms=පරමාණු
atone=වරද සමා කරනවා | වරදට සමා කරනවා
atonement=ප්‍රායශ්වත්තය
atonic=අස්චරිත
atonicity=අතානතාව
atony=අතානය
atop=මුදුනෙහි | මුදුනේ
atopite=ඇටොපයිට්
atrichous=නිශ්කේශර
atrium=ආලින්දය | හෘදය වස්තුවේ කොටසක්
atrocious=කපටි | ක්‍රූර | ඝෝර | දාමරික | දාරුණ්‍ය | දුෂ්ට | නපුරු | පාපිෂ්ඨ
atrociousness=දාමරිකකම
atrocity=ක්‍රූරකම | දාමරිකකම
atrophy=ක්ෂය | ක්ෂය වෙනවා | ක්ෂිණ වෙනවා | ක්ෂීණතාව | දියවීයෑම | දිරායාම | මෙට්ටැහි වෙනවා | වැහැරීම | වෑරීම | වෑරෙනවා | හීනවීයෑම
atropin=ඇට්‍රොපින්
atropine=අට්‍රොපයින් | ඇට්‍රොපීන් | විෂ වර්ගයක්
atropous=උඩුකුරු
atropy=නිර්භරණය
atrox=දාරුණ්‍යය | දැඩි
atstake=අනුමාන පිට | අවදානම් තත්ත්වයෙන් | මහත් අනතුරට භාජනව
attach=අනුයුක්ත කරනවා | අමුණනවා | අලවනවා | ආග්‍රහණය කරනවා | ආඳිනවා | ආලය කරනවා | ඇලවෙනවා | තහනම් කරනවා | යා කරනවා | යොදනවා | සම්බන්ධ කරනවා
attachable=සම්බන්ධිත
attache=උප තානාපති | තානාපතියකුගේ පරිවාරකයා | පරිවාරකයා | සහායක නිලධාරියා
attached=ඇමුණූ | ඈඳූ | පරායන | බැඳි | යා වූ | සංසක්ත | සම්බන්ධිත
attachment=අනුයුක්ත කිරීම | අනුරාගය | ආග්‍රහණය | ආලය | ඇඟලුම්කම | ඇල්ම | ඇලීම | ඈඳුම | තහනම | බන්ධනය | බැඳීම | බැඳුම | සම්බන්ධනය | සම්බන්ධය | සම්බන්ධිතය
attack=ආක්‍රමණය | කොටනවා | තඩි ගහනවා | තඩි බානවා | දොස් පවරනවා | නිග්‍රහ කරනවා | පහර | පහර දීම | පහර දෙනවා | පහරදීම | ප්‍රහාරය | පාර | පෙළනවා | බැට | බැට දෙනවා | විරුද්ධකම් කරනවා
attacker=පහර දෙන්නා | ප්‍රහාරකයා
attacking=පහර දෙන | ප්‍රහාරක
attain=අත් කරගන්නවා | අවබෝධය ලබනවා | එළඹෙනවා | ගෙට වෙනවා | දැනමුතු වෙනවා | පැමිණෙනවා | මුදුන් පමුණුවා ගන්නවා | ලබනවා | ලබා ගන්නවා | ලොකුවෙනවා | සමවදිනවා
attainability=ප්‍රාප්‍යතාව
attainable=අත්පත් කරගත් | ගම්‍ය | ගම්‍යමාන | ප්‍රාප්‍ය | පැමිණුනු | ලබා ගත් | ලැබිය හැකි
attainder=ඇටෙන්ඩරය | ප්‍රජා අයිතිය අහිමිවීම
attained=ආගත
attaining-puberty=කොටහළුව
attainment=අධිගමය | ගෞරවය | ප්‍රාප්තිය | පැමිණි දේ | ලබාගත් දේ | ලබාගැනීම | ලාභය | ලැබීම | සමාපත්තිය | සාමර්ථ්‍යය
attaint=අහිමි කරනවා | දූෂිත කරනවා | පරිභව කරනවා | රාජද්‍රෝහි වරදට ප්‍රජා හිමිකම් අහෝසි කරනවා
attar=අත්තර,රෝස වතුර | සුවඳ විලවුන් විශේෂයක්
attempt=උත්සාහ කරනවා | උත්සාහය | උස්සාහය | තටමනවා | තතනනවා | තැටමිල්ල | තැත | තැත් කරනවා | තැත් කිරීම | දිරිය | ප්‍රයත්න දරනවා | ප්‍රයත්නය | මැරීමට තැත් කිරීම | යතනවා | යත්තය | යත්නය | යැතුම | වලිකනවා | ව්‍යායාමය | වෑයම | වෑයම් දරනවා | විරිය | වීර්ය කරනවා | වෙහෙසෙනවා | සිතට ගන්නවා
attend=උපස්ථාන කරනවා | උවටැන් කරනවා | ප්‍රතිඵල වශයෙන් ලැබෙනවා | පැමිණ පෙනී සිටිනවා | පැමිණෙනවා | පිරිවරනවා | පිරිවරා සිටිනවා | වැඩක යෙදෙනවා | සමග පවතිනවා | සාත්තු කරනවා | සිත යොමවනවා | හිත යොමු කරනවා
attendance=ආවතේව | උපස්ථානය | උවටැන | පැමිණ සිටීම | පැමිණි පිරිස | පැමිණීම | පෙනීසිටීම | සප්පායම | සාත්තුව | සිත යොමු කිරීම | සේවය
attendancy=පැමිණීම | පිරිවර
attendant=අනුවරයා | ආවතේවකාරයා | උපස්ථායක | උපස්ථායකයා | උවටා | කම්කරුවා | කැටුව යන | කැපකරුවා | පරිවාර | පරිවාරකයා | ප්‍රතිඵල වශයෙන් ලැබෙන | පිරිවරා සිටින | සමග යෙදෙන | සහායකයා | සාත්තු සේවිකාව | සාත්තුකාරයා | සේවකයා | හෙද
attender=කැටුව යන්නා | පැමිණි තැනැත්තා
attensity=අධ්‍යවධානය
attent=ඇහුම්කන් දෙන | සාවධාන
attention=අවධානය | උපචාර | උපස්ථානය | ගෞරව දැක්වීම | සත්කාරය | සමාධානය | සාත්තුව | සැලකිල්ල | සැළකිල්ල | සීරුවෙන් සිටින් | හිත යොමු කිරීම
attentive=ඇහුම්කන් දෙන | උපස්ථාන කරන | පරීක්ෂා සහිත | සත්කාර කරන | සම්පජානකාරී | සමාහිත | සාවධාන | සැලකිලිමත්
attentively=එකඟ සිතින් | සාවධානයෙන් | සාවධානව | සීරුවෙන්
attentiveness=අවධානය | සැලකිලිමත් බව
attenuant=කෙට්ටු කරන දෙය | දුර්වල කරන දෙය
attenuate=අඩු | අඩු කරනවා | තුනී | තුනී කරනවා | දුර්වල කරනවා | සිහින් කරනවා | හීන්
attenuated=තනුකෘත | තුනී වූ | වෑරී ගිය | වෑරුණු
attenuation=ක්ෂාමකරණය | තුනී කිරීම | භායනය | වැහැරීම | සිහින් කිරීම | හායනය | හීන් කිරීම
attenuator=හායකය
attercop=මකුළුවා
attest=ඔප්පු කරනවා | කැඳවනවා | දිවුරවනවා | සහතික කරනවා | සාක්ෂ්‍ය දරනවා | සාක්ෂ්‍යවත් කරනවා | සාක්ෂි දරනවා | සාක්ෂි දෙනවා | සාක්ෂි වෙනවා
attestation=අත්සන් තබා කරන ලද සහතිකය | සහතික කිරීම | සාක්ෂ්‍යකරණය | සාක්ෂි දැරීම
attested=සහතික කළ | සාක්ෂ්‍යකෘත | සාක්ෂ්‍යදැරූ | සාක්ෂි දැරූ
attester=සහතික කරන්නා
attesting=සහතික කරන
attestor=දෙස්කරු | සහතික කරන්නා | සාක්ෂ්‍යවත්කරු
attic=අටල්ල | අට්ටාලය | අටුව
attire=අඳිනවා | ආයිත්තම් | ඇඳුම් | ඈඳුම් | පළඳිනවා | වස්ත්‍රාභරණ | සරසනවා | සැරසෙනවා
attirement=ඇඳීම
attiring=වෙස් ගැනීම
attitude=අදහස | ආකල්පය | ආකාරය | ආකෘතිය | ඉරියව්ව | ඉරියවුව | ගතිය | චෛතසික ස්වභාවය | ලීලාව | හැඟීම
attitudinal=ආකල්පනික
attitudinaring=ආකල්පායනය
attitudinise=ආකල්ප ආවේශ කර ගන්නවා
attitudinize=ආකල්ප ආවේශ කර ගන්නවා | ලීලාවක් ආවේශ කර ගන්නවා
attollent=ආරෝහණ | ඔසවන
attomey-general=නීතිපති
attorn=අභියුක්ත කරනවා | අභියුක්ත වෙනවා | ආක්‍රාන්ත වෙනවා
attorney=ඇටර්නි | ඇටෝනි | ඇටෝර්නි | ඇටෝර්නි බලකාරයා | නීතිඥ | නීතිඥයා | නීතිවේදියා | පරකාර්යසාධක | ප්‍රතිනිධි | බලකාරයා | බලය ලත් කළමනාකාරයා
attorney-at-law=නීති උපදේශක | නීතිඥයා | නීතිවේදියා
attorney-general=නීතිපති
attornment=ආක්‍රාන්තිය
attracive=වත්තාකර්ෂණීය
attract=අලවනවා | ආකර්ෂණ ශක්තිය | ආකර්ෂණය | ආකර්ෂණය කරනවා | ඇදගන්නවා | ඇදගන්නා | ඇදගැනීම | ඇදෙනවා | ප්‍රියංකර | පොළඹවනවා | මනහර | මන් බඳිනවා | යොමු වෙනවා | සිත් අලවනවා
attractable=ඇදෙන
attracting=ආකර්ෂක
attraction=ආකර්ෂණය | ඇද ගැනීම | කලණ | රමණය | රුවය | රූපලාවණ්‍යය | විවත්‍රාංගය | සමාකර්ෂණය
attractive=ආකර්ෂණීය | ආකර්ෂී | කන්කලු | කමනීය | දර්ශනීය | දැකුම්කලු | පියකරු | මනකල් | මනවඩන | මනස්කාන්ත | මනෝහර | රමණීය | රුවකර | රුවර | ලාස්‍ය | විසිත්ත | ශෝභමාන | සලෙල | සාරාණීය | සිත් ගත් | සුන්දර | ළගන්නා
attributable=ආරූඩ කළ හැකි | ආරෝපණීය
attribute=ආරෝපණය කරනවා | ආරෝපණය කරනවා | ආරෝපණයකරනවා | උපලක්ෂණය | ගතිය | ගුණ දක්වනවා | ගුණය | ගුණාංගය | ලක්ෂණය | විශේෂණය | ස්වභාවය
attributed=ආරෝපිත
attributes=උපලක්ෂණ | උපලාක්ෂණික | විශේෂක
attribution=ආරූඩ කිරීම | ආරෝපණය | ගුණනාමය | ගුණය
attributive=ආරෝපණය කළ හැකි | උපලක්ෂණාමක | ගුණවාචක
attrite=ඉලීමෙන් ගෙවුණු | දජුවමට බියේ ගැහෙන
attrition=අනුතාපය | ඉලීම | ගැටීම | ගෙවී යාම | ගෙවීයාම | ඝර්ෂණය | සීරීයාම
attune=එකඟත්වයට පත් කරනවා | ගළපනවා | ගැළපෙනවා | තුල්‍යස්වර කරනවා | නාද සකසනවා | නියම නාදය ගන්නවා | නියම ස්වරය ගන්නවා
atypic=අනියම්
atypical=අනාකෘතික | අනියම | අසදෘෂ | ආදර්ශයට වෙනස් වන
aubergine=වම්බටු
aubrietia=මල් ගසක්
auburn=තඹවන් | රතට හුරු දුඹුරුපාට
auca=අවුකා
auceps=උකුස්සා
auction=වෙන්දේසි කරනවා | වෙන්දේසිය
auctioneer=වෙන්දේසිකරු | වෙන්දේසිකරුවා | වෙන්දේසිකාරයා
auctorial=කර්තෘ පිළිබඳ
auctoritas=අවුක්ටෝරිටාස් බලය | ආප්තය | වැඩිහිටි අධිබලය
audacious=ගරු සරු නැති | ගරුසරු නැති | නිර්භය | නිර්භීත | ප්‍රගල්භ | සාහසික
audacity=නිරභය | නිර්භීත කම | නිර්භීතකම | සාහසිකකම | සාහිසකකම
audibility=ඇසීම | ඇසෙන බව | ශ්‍රවණය | ශ්‍රව්‍යතාව | ශෘව්‍යතාව
audible=ඇසෙන | ශ්‍රව්‍ය | ශ්‍රාව්‍ය
audibly=ඇසෙන ලෙස
audicgram=ශ්‍රව්‍ය රේඛය
audience=අසාසිටින පිරිස | දර්ශනය | ප්‍රේක්ෂක ගණය | ප්‍රේක්ෂක ජනයා | ප්‍රේක්ෂා ගෘහය | බැහැදැක්ම | බැහැදැකීම | ශ්‍රාවක ජනයා | ශ්‍රාවක පිරිස | සභාව
audio=ශ්‍රවණ | ශ්‍රව්‍ය
audio-frequency=ශ්‍රව්‍ය සංඛ්‍යාතය
audio-oscillater=ශ්‍රව්‍ය දෝලකය
audiogram=ශ්‍රව්‍ය රේඛය
audiometer=වායුමානය | ශ්‍රව්‍ය මානය | ශ්‍රව්‍යමානය
audiometry=ශ්‍රවණමිතිය
audion=සඩියෝනය
audiphone=ශබ්ද වර්ධකය
audit=ගණන් පරීක්ෂණය | ගණන් පරීක්ෂා කරනවා | විගණක | විගණනය | විගණනය කරනවා | විගණනය කිරීම
auditee=විගණනලාභී
audition=ආශ්‍රාවණය | ඇසීම | කුසලතා පරීක්ෂණය | පරීක්ෂාව පිණිස ඇසීම | ශ්‍රවණ පරීක්ෂණය | ශ්‍රවණය | ශ්‍රවණශක්තිය | ශ්‍රවණේන්ද්‍රිය | ශ්‍රවණෝක්ෂණය
auditor=අසා සිටින්නා | ගණන් පරීක්ෂකයා | විගණක | විගණකයා | ශ්‍රෝතෘ
auditor-general=විගණකාධිපති | විගණකාධිපති | විගණනපති
auditorium=ප්‍රේක්ෂාගාරය | ශ්‍රවණාගාරය | ශ්‍රවණාගාරයේ කොටස | සවන් හල | සවන්හල
auditory=ශ්‍රවණ | ශ්‍රවණය පිළිබඳ වූ | ශ්‍රව්‍ය | ශ්‍රෝතේන්ද්‍රිය පිළිබඳ වූ
auferre=ගෙනයෑම
aufgabe=ඖප්ගාබය
aufhebung=ප්‍රාග් විවාහ හේතුක දික්කසාදය
augean=මහත් පරිශ්‍රමයෙන් ශුද්ධ කළ හැකි ගව මඩුවක් වැනි
augelite=ඔගලයිට්
augen=අක්ෂිරූපනය
augend=ආකලය
auger=අවගාරය | යවකාරය | ලොකු බුරුමය
aught=කිසිත් | කොටසක් | මොකුත් | යන්තම් වත් | යමක්
augite=සගයිට්
augment=ආගමය | ආවර්ධනය කරනවා | උපචය | වර්ධනය | වර්ධනය කරනවා | වැඩි කරනවා | වැඩි කිරීම | වැඩි වෙනවා | විශාල කරනවා | වෘද්ධිය
augmentation=ආගම | වර්ධනය කිරීම | වාසිය | වැඩි කිරීම | වෘද්ධිය
augnast=ආවර්ධනය
augur=නිමිත්ත | නිමිති කියනවා | නිමිති පහළ වෙනවා | පේනය | ලක්ෂණ පාඨකයා
augurer=නිමිති කියන්නා | පේනකාරයා
augury=නිමිති ශාස්ත්‍රය | නෛමිත්තය | පෙරනිමිති කීම
august=අගෝස්තු | අනුභාව සම්පන්න | උත්කෘෂ්ට | ප්‍රතාපවත්
augustinianism=ඔගස්තීනියානුවාදය
auk=කුඩා පියාපත් ඇති මුහුදු කුරුල්ලෙක්
aulophyte=සවරක පරපෝෂිතයා
aunt=පියාගේ සහෝදරිය | මවගේ සහෝදරිය
auntie=පියාගේ සහෝදරිය | මවගේ සහෝදරිය
aura=නිලංකාරය | බ්‍යාමප්‍රභාව | රැස් මජල
aural=කර්ණික | කර්ණික ශ්‍රවය
aurantium=ජම්බීරකය
aurate=සරේට්
aureculate=සකර්ණික
aureole=ප්‍රභාමණ්ඩලය | රශ්මිමාලාව
aureomycin=ඔරියොමයිසින්
aurichalcite=සරිකැල්සයිට්
auricle=කන්පෙත්ත | කර්ණිකාව | බාහිර කන
auricular=කනට අයිති | කර්ණාකාර | සකර්ණික
auriculare=කර්ණාකාර
auriferous=රන්මුසු
auriga=ඖරිගා
aurignacian=ඔරිඤ්ඤාසියානු
auripigmentum=ස්වර්ණ වර්ණය
aurist=කර්ණවෛද්‍යුවරයා
auristillae=ඔරිස්ටිලි
aurite=සරයිට්
auroauric=සරොසරික්
aurora=අරුණලු | අරුණාලෝකය | අරුණෝදය | උෂාලෝකය
auroral=අරුණෝද්ගමනය | උෂාලෝක
aurorean=අරුණෝද්ගමන
aurorium=සරෝරියම්
auscultation=රෝග විනිශ්චය සඳහා සිරුරේ ඇති වන ශබ්දවලට සවන්
ausgleich=ඖස්ග්ලයිසය
auspice=අනුග්‍රහය | ආරක්ෂාව | නිමිත්ත | පෙර ලකුණ | බලය
auspices=අන්‍රග්‍රහය
auspicious=මංගල | මංගල්‍ය | මඟුල් | යහපත් | ශුභ | සුබ | සුමංගල
aussie=සස්ටේලියා
austenite=ඔස්ටෙනයිට් | සස්ටනයිට්
austere=ඉතා චාම් | උග්‍ර | කටුක | කර්කශ | තද | රූක්ෂ | සැර
austereness=උග්‍රකම | සැරකම
austerity=ආත්මක්ලමථානුයෝගය | තපස | ලුහු පෙවත | ලුහුපෙවෙත
austism=ආතමානුත්වය
austral=දක්ෂිණ | දක්ෂිණාත්‍ය
australasian=දකුණු ශාන්තිකර දිවයින්වලට අයත්
australia=ඔස්ට්‍රේලියාව
australian=ඔස්ට්‍රේලියානු ජාතිකයා | ඔස්ට්‍රේලියාවට අයත්
australoid=ඖස්ත්‍රලාභ | ඖස්ත්‍රලාභයා
australopithecine=ඖස්ත්‍රලෝපිතෙසීනුවා
australopithecus=ඖස්ත්‍රලෝපිතෙකුස් | දක්ෂිණ වානරයා
austria=සස්ට්‍රියාව
aut=ස්ව | ස්වයං
autacoid=ස්වගදාභය
autarchy=දුෂ්ට පාලනය
autarky=ආර්ථික වශයෙන් සමෘද්ධිමත් වීම
autecology=ඓකපරිසර විද්‍යාව
authentic=අව්‍යාජ | තථ්‍ය | නිසැක | යථාභූත | විශ්වාස කටයුතු | සත්‍ය | සත්‍යවත් | සැබෑ
authenticate=කර්තෘත්වය ඔප්පු කරනවා | කර්තෘත්වය කියා සිටිනවා | සත්‍යවත් කරනවා | සහතික කරනවා | සැබෑ බවට සහතික කරනවා
authentication=සත්‍ය බව සහතික කිරීම | සහතික කිරීම
authenticity=අව්‍යාජත්වය | තථ්‍යතාව | නිසැක කම | පිළිගත හැකි බව | යථාභූතාව | සත්‍යතාව | සත්‍යවත් භාවය
author=උත්පාදකයා | කතු | කරතෘ | කර්තෘ | ගත්කරු | ග්‍රන්ථකර්තෘ | පොත් ලියනවා | මූලිකයා | ලේඛකයා
authoress=කර්තෘවරිය
authorisation=අවසර දීම | බලය දීම
authorise=අධිබලය දෙනවා | අවසර දෙනවා | බලය දෙනවා | බලය පවරනවා
authoritarian=ආධිකාරික | ඒකාධිපතියා | ඒකාධිපතිවාදී | ප්‍රාධිකාරක
authoritarianism=අධිකාරවාදය | ඒකාධිපතිවාදය | ප්‍රාධිකාරවාදය | බලාදිකාරී වාදය
authoritative=ආඥාත්මක | ප්‍රාධිකාරී | ප්‍රාමාණික | බල සහිත | බලය ඇති | විශ්වාස කළ හැකි | සාක්ෂි සහිත
authorities=අධිකාරීහු | බලධාරීහු
authority=අධිකාරත්වය | අධිකාරය | අධිකාරිය | අධිකාරී | අධිබලය | අනුභාවය | අවසරය | ආඥාව | ආධිපත්‍යය | ආප්තය | ආශ්‍රය | කම්සදනය | තත්ත්වඥයා | ප්‍රමාණිකත්වය | ප්‍රාධිකාරත්වය | ප්‍රාධිකාරය | ප්‍රාමාණ්‍යය | ප්‍රාමාණික භාවය | ප්‍රාමාණිකයා | බල මණ්ඩලය | බලකරු | බලකාරයා | බලතල | බලධරයා | බලධාරියා | බලධාරී | බලය | යුතුකම | වරම | විශේෂඥයා | ශක්තිය | සාක්ෂ්‍යය
authorization=අවසර දීම | බලය දීම
authorize=අවසර දෙනවා | බලය දෙනවා | බලය පවරනවා
authorized=අධිබලය ලත් | අනුදත් | බලය ලත්
authorless=නිර්නාමික
authorship=ආරම්භය | කර්තෘත්වය
authoxanthin=ඇන්තොසැන්තින්
autism=ස්වේච්ඡතාව
autistic=ස්වෙච්ඡ
autmobile=ස්වයංගාමී
auto=ඉබේ | ඉබේටම | තමා විසින්ම | මෝටර් රථය | ස්ව | ස්වයං | ස්වයම්භූ | සිය
auto-eroticism=ස්වකාමුකත්වය | ස්වාත්මකාමිත්වය
auto-ignition=ස්වයංජ්වලනය
auto-intoxication=ස්වයම්මාදනය | ස්වාධූලනය
auto-suggestion=ස්වයම්මන්ත්‍රණය
autoallogamy=ස්වපරසංසේචනය
autoatibiosis=ස්වයංප්‍රතිවනය
autobarotropy=ස්වසමඝනතාව
autobasidiomycetes=අවුටොබසිඩියොමිසේටේස්
autobiographic=තමන් විසින් ලියන ලද
autobiographical=තමන් විසින් ලියන ලද
autobiography=ආත්ම චරිතය | ආත්මචරිතකථනය | ආත්මචරිතය | ස්වයං ලිඛිත චර්තාපදානය
autocar=මෝටර් රථය
autocarpotropic=ස්වයංඵලීන
autocarpous=ස්වයංඵලීන
autocarpy=ස්වයංඵලනය
autocatalysis=ස්වයංඋත්ප්‍රේරණය
autocatalytic=ස්වයංඋත්ප්‍රේරක
autocatelysis=ස්වයංඋත්ප්‍රේරණය
autochore=ස්වයංචාලකය
autochoric=ස්වයංචාලක
autochory=ස්වයංචලනය
autochthenal=දේශජ
autochthomous=ස්වස්ථානික
autochthon=දේශජය
autochthonous=දේශජ | දේශීය | නෛසර්ගික | ස්වස්ථානික
autoclave=අධිපීඩන හුමාලය භාවිත කොට වාණුහරණය කරන උපකරණය | පීඩතාපකය | පීඩනතාපකය | සටක්ලේවය
autocode=ස්වයංකේතය
autocollimation=ස්වයංසමාන්තරණ
autocollimator=ස්වයංසමාන්තරකය
autocolony=ස්වසමුහය
autocompetition=ස්වස්පර්ධාව
autocorrelation=ස්වසහසම්බන්ධය
autocracy=ඒකාධිකාරය | ඒකාධිකාරවාදය | ඒකාධිපතියා | ඒකාධිපතිවාදය | ස්වෛරතන්ත්‍රය
autocrat=ඒකාධිපතියා | සෛවරී බලය ඇත්තා
autocratic=ඒකාධිකාරවාදී | ඒකාධිපති | ස්වාධිපති | සීමාරහිත බලය ඇති
autocross=දුර්ග මාර්ග ඔස්සේ රට හරහා කෙරෙන මෝටර් රථ තරඟය
autocue=රූපවාහිනී කථාවක පිටපත කියවීමට උපකාරී වන උපකරණයක්
autocytolysis=ස්වයංසෛලරණය
autocytotoxin=සටොසයිටොටොක්සින්
autodecomposition=ස්වයංවිභාජනය
autodial=සාක්වටය
autodigestion=ස්වයංරණය
autodyne=සියහැනුම්
autoecious=ස්වගෘහී
autofecundation=ස්වසංසේචනය
autogamic=ස්වයංජනක
autogamous=ස්වයංජනක
autogamy=ස්වයංජනනය
autogenesis=ස්වයංජනනය | ස්වයංසිද්ධජනනය
autogenetic=ස්වයංසිද්ධජාත
autogenic=ස්වජනක | ස්වයංජාත
autogenous=ස්වයංජනිත | ස්වයංජාත
autograph=අත් අකුරු සටහන | අත්අකුරින් ලියනවා | අත්අකුරු සටහන | ඔටෝග්‍රාපය | නිශ්වත කර්තෘක | නිශ්වත කර්තෘත්වය | සමරු පොත | සිය අතින් ලියනවා | සියත් ලිපිය
autoicous=ඒකගෘහී | ඓකගෘහී
autokinesis=ස්වචාලකතාව
autokinosis=ස්වචාලකතාව
autolithography=ස්වයංලිතෝග්‍රාපිය
autological=සමපරිමාණ
autolysed=ස්වයංර්ණ
autolysis=ස්වයංජීරණය | ස්වයංර්ණය
automata=රූකඩ
automatic=ඉබේ | ඉබේ ක්‍රියා කරන | ස්වයංක්‍රිය | ස්වයංක්‍රිය පිස්තෝලය | ස්වයංක්‍රීය | ස්වයංකාරී | ස්වයංසිද්ධ | ස්වයම්ප්‍රවර්තක | සියසල
automatical=ඉබේම ක්‍රියා කෙරෙන | ස්වයම්ප්‍රවර්තක
automatically=ඉබෙි | ඉබේ | යන්ත්‍ර බලයෙන්
automatics=ස්වයංක්‍රිය විද්‍යාව
automation=තාක්ෂණවේදී රැකියා වියුක්තිය හා සියැයුම | යන්ත්‍ර භාවිතය | රූකඩය | ස්වයංකරණය | ස්වයංක්‍රිය කරණය | ස්වයංක්‍රියකරණය | ස්වයංක්‍රියනය | ස්වයංකාරීත්වය | ස්වයම්ප්‍රවර්තක යන්ත්‍රය | ස්වායත්ත | සියැයුම
automatisation=ස්වයංක්‍රියකරණය
automatism=ස්වයංක්‍රියතාව | ස්වයංක්‍රියවාදය
automatist=ස්වයංක්‍රිය ලේඛක
automatograph=ස්වයංක්‍රිය ලේඛය
automaton=නොපෙනෙන උපක්‍රමයකින් ක්‍රියා කරන යන්ත්‍රයක් | රූකඩය | ස්වයං ප්‍රවර්තක යන්ත්‍රය
automobile=මොටෝරිය | මෝටර රිය | මෝටර් රථය
automolite=ඔටොමොලයිට්
automorphism=ස්වයංරූපතාව
automotive=ඉබේ පැදවෙන
autonastic=ස්වයංසන්නමන
autonomic=ස්වතන්ත්‍ර | ස්වයංසාධක | ස්වායත්ත
autonomous=ස්වතතන්ත්‍ර | ස්වතන්ත්‍ර | ස්වයංපාලක | ස්වාධීන | ස්වායත්ත
autonomy=ස්වතන්ත්‍රතාව | ස්වතන්ත්‍රය | ස්වයං පාලනය | ස්වයංපාලනය | ස්වරාජ්‍යය | ස්වාධිකාරය | ස්වාධිපත්‍යය | ස්වාධීනත්වය | ස්වායත්තතාව
autonym=නියම කර්තෘනාමය
autooxidation=ස්වයංඔක්සිකරණය
autoparasitism=උපරි පරපෝෂිතතාව
autopatrol=මෝටර සමකුරුව
autophilous=ස්වපරාගිත
autophyte=ස්වයංපෝෂී ශාකය
autophytes=ස්වයංපෝෂී ශාක
autopilot=ස්වයංක්‍රිය පදවන්නා
autopsy=මරණ පරීක්ෂණය | මළ සිරුරක් කපා පරීක්ෂා කිරීම | ශවපරීක්ෂණය | ස්වයංපරීක්ෂණය
autopsychosis=ස්වයංමනෝවිකාරය
autoradiography=ස්වයං විකිරණ රේඛණය
autoregression=ස්වයංප්‍රතිපායනය | ස්වයංප්‍රතීපායනය
autosome=අලිංග වර්ණදේහය | අලිංගවර්ණදේහය | අවුටොසෝමය
autospore=අවුටොස්පෝරය
autostoper=ස්වයංක්‍රිය තෝපරය
autosuggestion=තම ඉඟිය | ස්වයං මන්ත්‍රණය
autotelic=තත්පරායන | තප්පරායන
autotomy=ස්වයංඡේදනය
autotransformer=තනි දඟර පරිණාමකය | තනිදඟර පරිණාමකය | ස්වයං පරිණාමකය
autotroph=ස්වයංපෝෂකය
autotrophic=ස්වයංපෝෂී
autotrophy=ස්වයංපෝෂකතාව
autotropism=ස්වයං ආවර්තනය
autotype=ස්වයංදර්ශය
autovac=ඔටෝවැක් ටැංකිය
autovrotolysis=ස්වයංප්‍රොටෝනික විච්ඡේදනය
autoxidation=ස්වයංඔක්සිකරණය
autumn=විතයේ පශ්චාද්භාගය | විතයේ පසු කොටස | ශරත් | ශරත් සෘතුව | ශරත් සෘතුව | ශාරද | සර | සර කල | සරත් | සරා | සිසිර
autumnal=ශරත් | ශෘරදීය | සාරද
autunite=සටියුනයිට්
auxanometer=වෘද්ධිමානය
auxiliaries=පරදේශීය මිත්‍ර සේනා
auxiliary=අතිරේක | උප | උපක්‍රියා පදය | උපකාරක | උපකාරී | උපස්තම්භක | ශාඛා | සහකාර | සහකාරක | සහකාරකය | සහකාරයා | සහාය | සහායක
auxilliary=සහායක
auximone=ඔක්සිමෝනය | ඔක්සිමෝන්
auxin=ඔක්සින්
auxiometer=ඔක්සියෝමීටරය
auxochrome=ඔක්සොක්‍රෝම්
auxograph=වෘද්ධිරේඛකය
auxospore=ඔක්සොස්පෝරය | ප්‍රගුණබීජාණුව
avacado=අලිගැටපේර
avail=ආධාර ගන්නවා | ආධාර සලසනවා | උපකාරය | ප්‍රයෝජන ගන්නවා | ප්‍රයෝජන සලසනවා | ප්‍රයෝජනය | ලබා ගන්නවා
availability=උපයෝජ්‍යතාව | තිබෙන බව | ප්‍රයෝජනය | ලැබිය හැකි බව | වැඩෙහි යෙදීම
available=තිබෙන | ප්‍රයෝජනය සඳහා ඇති | ලැබිය කැකි | ලැබිය හැකි | වැඩෙහි යෙදිය හැකි
aval=ඇප වන
avalanche=ගිරිහිම නිපාතය | සඝය | හිමධාවය
avalite=ඇවලයිට්
avant-garde=කලා ක්ෂේත්‍රයන්හි පුරෝගාමියෝ | පෙරටුගාමී පරපුර | සාහිත්‍ය ක්ෂේත්‍රයන්හි පුරෝගාමියෝ
avarice=තෘෂ්ණාව | ධන තෘෂ්ණාව | ලාභාශාව
avaricious=තෘෂ්ණාධික | ධන තෘෂ්ණාව ඇති
avatar=අවතාරය | මූර්තිය
avaunt=පලායව
ave=සැරද
avenge=දජුවම් කරනවා | පලි ගන්නවා | පළිගන්නවා | පළිගහනවා | ප්‍රතිහිංසා කරනවා | වරදට පලි ගන්නවා | වරදට පලිගැනීම
avenger=ප්‍රතිහිංසක | වරදට පලි ගන්නා
avenging=වරදට පලි ගන්නා
avenue=ප්‍රවේශ පථය | මඟ | මාවත | වෘක්ෂශ්‍රෙණිය
aver=සම්ප්‍රකාශ කරනවා | සහතික කොට කියනවා | ස්ථිරව පවසනවා | ස්ථීරව පවසනවා
average=උසස් නොවූ | පොදු | මධ්‍ය | මධ්‍ය ප්‍රමාණය | මධ්‍යක | මධ්‍යකය | සාමානකය | සාමාන්‍ය | සාමාන්‍ය ගණන | සාමාන්‍ය ගණන බලනවා | සාමාන්‍යගණන | සාමාන්‍යය
averaging=මධ්‍යක සෙවීම | මධ්‍යනය
averment=දැඩි ප්‍රකාශය | සම්ප්‍රකාශය | සහතික ප්‍රකාශය
averring=ස්ථීරව කීම
averroism=ඇවරෝස්වාදය
averse=අකැමැති | ජුගුප්සාත්මක | නොකැමති | ප්‍රතීප | පිළිකුල් | ව්‍යවර්තන | විපක්ෂ | විපරීත | විරුද්ධ
aversion=අකැමැත්ත | අරුවය | ජුගුප්සාව | ප්‍රතීපත්වය | පිලිකුල | පිළිකුල | පිළිකුළ | ව්‍යවර්තනය | ව්‍යාවර්තනය
avert=ඉවත හෙළනවා | වළක්වනවා | වෙන අතකට හරවනවා
averted=වැළකූ
avertible=වැළක්විය හැකි
avertiment=වැළක්වීම
avertin=ඇවටින්
avertment=සම්ප්‍රකාශය
avesta=අවෙස්තා ග්‍රන්ථය | අවෙස්තාව
avian=කුරුලු
aviarist=කුරුලු කූඩු වෙළෙන්දා
aviary=කුරුලු ගේ | කුරුලුගෙය | පක්ෂිශාලාව | විටංකය
aviate=ආකාශ තරණය කරනවා
aviation=ආකාශ තරණය | ආකාශ සංචාරය | ආකාශතරණය | ගුවන් තරණය | ගුවන්‍යානා පැදවීමේ විද්‍යාව
aviator=අහස් යාත්‍රිකයා | ගගනයාත්‍රිකයා | ගුවන් නැවියා
aviatrix=ගගනයාත්‍රිකාවි | ගුවන් නියමුවරිය
avid=කැමති | කෑදර | තද ආශා ඇති | ලෝලුප
avidity=කෑදරකම | තද ආශාව
avine=කුරුලු
avionics=ගුවන් තාක්ෂණයේ භාවිත වන ඉලෙක්ට්‍රොනික ශිල්පීය ක්‍ර
avitaminosis=නිර්විටමිනොසියාව
avocado=අලිගැටපේර
avocation=රැකියාව | රැකීරක්ෂාව | ව්‍යාපාරය | වෘත්තිය
avocet=දිග පාද ඇති පක්ෂි විශේෂයක්
avoid=බේරෙනවා | මග හරිනවා | මඟ හරිනවා | මඟහරිනවා | වළකිනවා | වැළකෙනවා | හිස් කරනවා | හිස් බවට පත් වෙනවා
avoidable=මග හැරිය හැකි | මඟහැරිය හැකි | වැළකිය හැකි
avoidance=පරිවර්ජනය | මග හැරීම | මඟ හැරීම | මඟහැරීම | වැළකීම | වැළැක්වීම | හිස් කිරීම
avoirdupois=අවර්දුපුවා | රාත්තල් මිනුම
avometer=ඇවොමීටරය
avouch=දිවුරා කියනවා | වග කියනවා | වගකියනවා | සහතික කර කියනවා | සහතික කරනවා | සහතික කොට කියනවා
avow=අනුභාෂණය කරනවා | දිවුරනවා | ප්‍රකට සේ කියනවා | ප්‍රකාශ කරනවා | පැහැදිලි සේ කියනවා | වරද ප්‍රසිද්ධියේ පිළිගන්නවා
avowal=අනුභාෂණය | ප්‍රකට
avowals=ප්‍රකාශෝක්තිය
avowedly=ප්‍රකට ලෙස | වරද ප්‍රසිද්ධියේ පිළිගන්නවා
avulse=අහකට ඇදෙනවා | පස්සට අදිනවා
avulsion=අපකර්ෂණය
avuncular=බාප්පාගේ | මහප්පාගේ | මාමාගේ
avunculate=මාතුලය
avunulocal=මයිලවාසය | මාතුලවාසය
await=අපේක්ෂා කරනවා | බලාපොරොත්තු වෙනවා | බලාපොරොත්තුව සිටිනවා | සූදානම්ව සිටිනවා
awake=අවදි | අවදි කරනවා | අවදි වූ | අවදි වෙනවා | ඇහැ ඇරෙනවා | ජාගර | පරීක්ෂාකාරී | ප්‍රබුද්ධ | පිබිද සිටින | පිබිදි | පිබිදෙනවා | පුබුදිනවා | පුබුදු කරනවා | සීසන් ඇති
awaken=අවදි කරනවා | අවදි වෙනවා | තේරුම් ගන්නවා | පිබිදෙනවා | පුබුදු කරනවා
awakened=පුබුදු
awakening=අවබෝධය | ප්‍රබෝධය | පිබිදීම
awaking=අවදි වීම
award=ත්‍යාගය | තෑගි කරනවා | තිළිණය | තීන්දුව | තීරණය | දීමනාව | නඩු තීන්දුව | නියම කරනවා | ප්‍රදත්තය | ප්‍රදානය | ප්‍රදානය කරනවා | ප්‍රධානය | ප්‍රධානය කරනවා | පිරිනමනවා | පිරිනැමීම
awarder=ප්‍රදානය කරන්නා
aware=දැන | පරීක්ෂාකාරී | සත් සම්ප්‍රජන්‍යයෙන් යුක්ත | සාවධාන | සිහි ඇති
awareness=දැන සිටීම | දැනුවත්කම | පරීක්ෂාකාරී බව | වැටහීම | සම්ප්‍රජානනය | සිහිනුවණ
awash=පා වෙමින්
away=අප | අව | අහක | අහකට | ඉවත | ඉවතට | එපිට | බැහැර | ළඟ නැති
awe=ගරුබිය | ගරුසරු ඇති බය | ගරුසරු ඇති බව | භය | භය උපදවනවා | විස්මය | සම්භ්‍රමය
awe-struck=සම්භ්‍රාන්ත
aweary=ක්ලාන්ත වූ | මහන්සි | මහන්සි ඇති
awefully=අතිශයින් | භයානක ලෙස
aweigh=කිරමින්
awesome=කැත | ඝෝර | තේජස්වී | පූජ්‍ය | බිය උපදවන | බිය ඵලවන | භයංකර | භයානක
awful=භය උපදවන | භයානක
awfully=බියෙන්
awhile=ටිකකට | මඳ වේලාවකට | මඳ වේලාවක් | මෙහොතකට | මොහොතකට | මොහොතක්
awkawardness=නුහුරුගතිය
awkward=අදක්ෂ | අමනෝඥ | අවලක්ෂණ | කරදර සහිත | කැත | නුසුදුසු | නුහුරු | නොගැළපෙන
awkwardly=නුහුරට
awkwardness=අදක්ෂකම | අවලක්ෂණකම | නුහුරු බව | නොගැළපෙන බව
awl=අලිස් කටුව | අලිස්කටුව | ආරාව | ඇලිස්කටුව | උල් කටුව | උල්කටුව | තොරපනය | විදින කටුව
awn=නණ්ඩුව | වී නණ්ඩුව
awning=උඩුවියන | තෑන්ද | විතානය | වියන
awoke=පිබිදුණා
awry=ඇදට | ඇලේට | නුහුරට | නොමඟට | වකුටුව | විකෘතව
axe=අඩු කරනවා | අස් කරනවා | කපනවා | කෙටේරිය | පරශු | පරසු | පොරොව | පොරොවෙන් කපනවා | ඵරසුව
axe-head=පොරෝ තලය
axial=අක්ෂ | අක්ෂය පිළිබඳ වූ | ආක්ෂක
axil=කක්ෂය | ශාකපත්‍රයත් දණ්ඩත් අතර ඇති කෝණය
axile=අක්ෂ | ආක්ෂීය
axilla=කක්ෂය | කිහිල්ල
axillary=කක්ෂ | කක්ෂීය
axinite=ඇක්සිනයිට්
axiology=සාරධර්මවේදය | සාර්ධර්ම විද්‍යාව
axiom=අවිවාදිකය | ප්‍රත්‍යක්ෂ න්‍යාය | ප්‍රත්‍යක්ෂය | ස්වසිද්ධිය | සිද්ධාන්තය
axiomatic=අවිවාදික | ස්වසිද්ධිමූලක | සිද්ධාන්තමය
axiomatics=සිද්ධාන්තවිද්‍යාව
axiometry=ස්වසිද්ධිමිතිය
axiommatic=සිද්ධාන්තමය
axis=අක්ෂ රේඛාව | අක්ෂය | අක්ෂය පිළිබඳ වූ | අක්ෂස්ථිය | අක්ෂීය | ධ්ර්ැව රේඛාව
axle=අකර | අක්ෂ දණ්ඩ | අක්ෂදණ්ඩ | අලවංගුව
axle-tree=අලවංගුව
axolotl=ඇක්සොලොටල්
axon=අක්සනය | ආවේගවාහකය
axonometric=අක්ෂානුමිතික
axonometry=අක්ෂමිතිය
ayah=ආයා | පරිවාරක ස්ත්‍රි | ප්‍රසාධිකාව
aye=පක්ෂයි | සදහට | හැමවිට
ayword=ආප්ත වචනය | කවුරුන් දන්නා දේ
azalea=මල් විශේෂයක්
azande=අසන්ද
azeotrope=ඇසෙයොට්‍රෝපය
azeotropy=ඇසෙයොට්‍රෝපිය
azide=ඇසයිඩ්
azilian=ඇසිලියානු
azimid=ඇසිමයිඩෝ
azimuth=උද්දිංගශය | උද්දිගංශය | දිගංශය
azimuthal=උද්දිගංශ | දිගංශ
azionic=කලාපීය නොවූ | ප්‍රාදේශික නොවූ
azobacter=ඇසෝබැක්ටර්
azoic=අවී
azoimide=ඇසෝඉමයිඩ්
azonal=නිෂ්කලාප
azoosporium=අචලබීජාණුව
azorite=ඇසොරයිට්
azotobacter=ඇසටොබැක්ටර්
azotobacteria=ඇසොටොබැක්ටීරීයා
azotometer=ඇසටොමීටරය
aztec=ඇස්ටෙක්
azure=ඝන නීල | නිල් අහස | නීල ආකාශය | ලා නිල් | ලානිල | වලාකුල් නැති අහස
azurean=ලා නිල්
azurine=නිල්කළු | ලා නිල්
azurite=ඇශූරයිට් | ඇෂුරයිට්
azury=නිල්
azygospore=අසංයෝගාණුව
azygous=ආඳා නැති | යුගල නොවූ
