bominate==ද්වෙෂ කරනවා | ද්වේෂ කරනවා | පිළිකුල් කරනවා
bunantly=සන තරම්
b=ඉංග්‍රිසි හෝඩියේ දෙවෙනි අකුර | ඉංග්‍රීසි හෝඩියේ දෙවන අකුර හා ප්‍රථම ගාත්‍රාක්ෂරය | ඉංග්‍රීසි හෝඩියේ දෙවෙනි අක්ෂරය
b=ඉංග්‍රිසි හෝඩියේ දෙවෙනි අකුර | ඉංග්‍රීසි හෝඩියේ දෙවන අකුර හා ප්‍රථම ගාත්‍රාක්ෂරය | ඉංග්‍රීසි හෝඩියේ දෙවෙනි අක්ෂරය
b-type=බී වර්ගය
b.f.o.=නුගැසුම් සංඛ්‍යාත දෝලකය
b.i.p.p.=බිස්මත් අයොඩපෝම් පැරපින් විලේපය
b.o.t.=වාණිජ මණ්ඩලය
b.s.=බ්‍රිතාන්‍ය සම්මතය
b.t.u=බ්‍රිතාන්‍ය තාප ඒකකය
b.th.u=බ්‍රිතාන්‍ය තාප ඒකකය
b/f=ඉදිරියට ගෙනාවා
baa=බාබා කියමින් හජනවා | බැටළුවන් හජ නගනවා | බැටළුවාගේ හජ
baalbek=බාල්බෙක්
baas=බාස්
baba=කේක් වර්ගයක්
babaralalia=බර්බරාලපනය
babbitting=බැබිට් ලෑම
babble=කට මැත | කුඩා බිළිඳකු සේ දොඩවනවා | කෙඳිරිය | කොඳුරනවා | ජල්පනය | දොඩවනවා | බිලිඳකුමෙන් කතා කරනවා | රහස් එළි කරනවා | ලාලාපය | වාචාල කථාව | වාචාල කියනවා | සම්ඵප්‍රලාප කියනවා
babbler=වාචාලයා
babe=අතදරුවා | බබා | බිලිඳා | බිළිඳා | ළදරුවා
babel=කරච්චලය | කලබලය | කෝලාහලය | ගාලගෝට්ටිය | සංකීර්ණ නාදය
babish=බොළඳ | ලාමක | ළදරුවකු වැනි
babism=බාබ්වාදය
baboo=හින්දි භාෂාවෙන් මහත්මයා
baboon=බබුනා | බැබූන් | විශාල වානර වර්ගයක්
babu=හින්දි භාෂාවෙන් මහත්මයා
baby=අත දරුවා | කුඩා සතා | බබා | බිලිඳා | බිළිඳා | සප්පයා | සිඟිත්තා | ළදරු | ළදරු ගති ඇත්තා | ළදරුවා
baby-sit=ළදරුවන් බලනවා
baby-sitter=ළදරුවන් බලන්නා
baby-talk=ළදරු කථාව
babyfarming=කුලියට ලමයින් ඇති දැඩි කිරීම
babyhood=ළදරු වයස | ළදරු විය
babyish=සුරතල් | ළදරු
bacca=බදරිය
baccalaureat=විශ්වවිද්‍යාලයේ ප්‍රථම උපාධිය
baccalaureate=ප්‍රථම උපාධිය
baccarat=කාඩ්වලින් කරන සූදුවක්
baccate=බදරි
baccausus=සමුච්චය
bacchanal=බැකනලානුවා | බේබද්දා | සුරාධූර්තයා
bacchanalia=බැකස් පූජෝත්සවය | රෝමයේ මධුපානෝත්සව
bacchanalian=බැකනලියානු | බැකස් භක්තිකයා | බේබද්දා | සුරාධූර්තයා
bacchanaliar=බැකනලානු උත්සවය
bacchanals=රෝමයේ මධුපානෝත්සව
bacchant=ග්‍රීකයේ සුරාවට අධිපති දෙවියන් අදහන්නා
bacchus=බැකස් | බැකස් දෙවියා | සුරාවට අරක්ගත් ග්‍රීක්වරුන්ගේ දේවතාවා
baccy=දුම්කොළ
bachelier=බැචෙලියර්
bachelor=අවිවාහකයා | තනිකඩයා | ප්‍රථම උපාධිලාභියා | ස්නාතකයා
bachelorhood=අවිවාහකත්වය
bachelorship=විශ්ව විද්‍යාලයක ප්‍රථම උපාධිධරයා වීම
bacillar=බැසිලාකාර
bacillary=රෝග බීජ සහිත
bacilli=ඉතා සියුම් රෝග බීජ | බැසිල
bacilliform=බැසිලාකාර
bacilluria=බැසීල මූත්‍රතාව
bacillus=බැසිලය
back=අනුබල දෙනවා | ආධාර කරනවා | ආපස්සට | ආපසු | ආපිට | ඇන්ද | ඉහත | උදව් කරනවා | උදවු කරනවා | ඔට්ටු අල්ලනවා | නැවත | පස්ස | පස්ස ගහනවා | පස්සට යනවා | පස්සා | පස්සෙන් | පස්සෙහි | පස්සෙහි පිහිටි | පසු | පසුගිය | පසුපස | පැරණි | පිට | පිටදාරය | පිටපැත්ත | පිටිපස | පිටිපස්සේ | පිටුපස | පෙරළා | පොත් නාරටිය | බරණිය | බාහ්‍ය
back-bencher=පසුපෙළ මන්ත්‍රීවරයා
back-bite=කේලාම් කියනවා
back-cross=පිළිදෙමුහුම | පිළිමුහුම
back-door=පස්ස දොර | බාහ්‍යද්වාරය
back-painting=පසු චිත්‍රනය
back-side=පිටුපස
back-to-back=පිටට පිට
back-up=ආධාර කරනවා | සහාය දෙනවා
back-ward=අග සිට මුලට | උඩුපැල්ලෙන් | උඩුබැල්මෙන් | දුර්වලභාවයට | පස්සට | ප්‍රතිලෝමව
back-wards=අග සිට මුලට | උඩුපැල්ලෙන් | උඩුබැල්මෙන් | දුර්වලභාවයට | පස්සට | ප්‍රතිලෝමව
backacter=පිළිකැණිය
backbite=කේලාම් කියනවා | සපාදූප කියනවා
backbone=කශේරුකාව | කශේරුව | කොන්ද | කොඳු ඇටය | තුනටිය | ප්‍රධාන රුකුළ | ප්‍රාණ නාළිය | පිටිකොන්ද | වසට
backchat=එකට එක කීම
backdate=පසුදාතම් කරනවා
backdrop=පසුතිරය
backer=අනුබල දෙන්නා
backfill=පසු පිරවීම
backfire=ආපසු කැරකෙනවා | වරදිනවා
backformation=පශ්චාත්සාධනය
backgammon=දාදුවලින් කරන ක්‍රීඩාවක්
backgorund=පසුතලය
background=පරිසරය | පශ්චාද් භූමිය | පසු කොටස | පසුතලය | පසුබිම
backhand=පිටි අත් පහර
backhanded=පිටි අතින් ගැසූ | ව්‍යාජ
backing=ආධාරක | ආධාරකය | ආධාරය | උදව්ව | පිටදාර තැනීම | පිටුබල දීම
backlash=අවර ගැස්ම | අවරගැස්ම | ආපස්සට ඒම | ආපස්සට වැදීම
backlog=අතපසු වූ වැඩ | ප්‍රමත්ත සමුදාය
backnumber=පැරණි කලාපය
backplane=පසුතලාව
backrest=පසු ඇන්ද
backshore=පෑළ වෙරළ
backside=තට්ටම | තට්ටම් පෝරුව | පස්සපැත්ත | පස්සා පැත්ත | පසුපස | පිටුපස
backslide=ප්‍රතිපත්ති කඩ කරනවා
backspace=ආපසුයවනය
backtract=ආපසු යනවා | පස්ස ගහනවා
backup=උපස්ථ
backward=අවවර්ධිත | අවිදග්ධ | ආපසු | ඉගෙනීමට දුර්වල | දුර්වල | නොදියුණු | පසුපස | පසුබට | පසුබාන | බුද්ධිහීන
backwardation=අතමාරු බැංකු ගාස්තුව | ප්‍රමාද බැංකු ගාස්තුව
backwardness=පසුබට බව
backwards=ආපස්සට | පස්සට
backwash=බාදිය | රැල්ල ආපසු යෑම
backwaters=කලපු
backwoods=කැලෑ පෙදෙස | පිටිසර
backyard=අගුව | පස්සා මිදුල | පසුමිදුල | පිළිකන්න
bacon=ලුණු දමා වියලි ඌරු මස් | ලුණු දමා වියළූ ඌරු මස් | ලුණු දැමූ වියලූ ඌරු මස්
baconian=බේකන
bacteraemia=බැක්ටීරිමියාව
bacteria=ක්ෂුද්‍ර වීහු | බැක්ටීරියා | බැක්ටීරියාව | බැක්ටීරීයා | ශාකාණු
bacterial=බැක්ටීරියා | බැක්ටීරීය | රෝග බෝ කරන | ශාකාණු
bactericidal=බැක්ටීරීයානාශක
bactericide=ක්ෂුද්‍රවිනාශකය | බැක්ටීරියානාශකය | ශාකාණුනාශකය
bacteriochlorophyll=බැක්ටීරීයොක්ලෝරොපිල්
bacterioid=බැක්ටිරියාහය | බැක්ටීරියාහය
bacteriologic=බැක්ටීරියා විද්‍යාත්මක
bacteriological=බැක්ටීරියා විද්‍යාත්මක
bacteriologist=ක්ෂුද්‍රව විද්‍යාඥයා | බැක්ටීරිවේදියා | බැක්ටීරීයා විද්‍යාඥයා
bacteriology=ක්ෂුද්‍රව විද්‍යාව | ක්ෂුද්‍රවවිද්‍යාව | බැක්ටීරියා විද්‍යාව | බැක්ටීරියාවේදය | බැක්ටීරිවේදය | ශාකාණුවිද්‍යාව
bacteriolysin=බැක්ටීරියා ශ්ලථකය
bacteriolysis=බැක්ටීරියාජාරණය
bacteriophage=බැක්ටීරියා භක්ෂකය
bacteriophagy=බැක්ටීරියා භක්ෂණය
bacteriosis=බැක්ටීරියා රෝගය
bacteriotatics=බැක්ටීරියා ස්ථිතික
bacteriotoxin=බැක්ටීරියා විෂ
bacteroid=බැක්ටිරියාහය | බැක්ටීරියාහය
baculiform=දණ්ඩාකාර
bad=අගුණ | අමාරු | අයහපත් | අයෝග්‍ය | අව | අවලංගු | අසත් | අසත්පුරුෂ | අසාර | අහිත | උග්‍ර | කෂ්ට | කුණු වූ | දුර් | දුෂ් | දුෂ්ට | දුහ් | දූ | නපුරු | නරක | නුසුදුසු | නොමනා | බාල | සදොස් | හොර
bad-character=අවචරිතයා
bad-mouth=කේලාම් කියනවා | දොස් කියන්නා
bade=අණ කළා | ඉල්ලුවා | නියම කළා
badge=අඩයාලම | නිල ලකුණ | නිලය හැඳින්වීමේ ලකුණ | ලාංඡනය | වහ්නය | විහ්නය | සාමාකත්වය හැඳින්වීමේ ලකුණ
badger=කරච්චල් කරනවා | කරදර කරනවා | පොළවෙහි වළ හාරන සතෙක් | බැජර් | හිරිහැර කරනවා
badinage=නිර්මාලාපය | විහිළු තහළු
badly=තදින්ම | දුර්වල අන්දමට | නරක අන්දමින්
badminton=ටෙනිස් වැනි ක්‍රීඩාවක්
badness=නරකකම
baffle=අනපලුව | අනුපලුව | අපොහොසත් කරනවා | අවහිර කරනවා | එවැනි ප්‍රතිරෝධකය | කඩා කප්පල් කරනවා | කඩාකප්පල් කරනවා | නිශ්ප්‍රභ කරනවා | පැටලෙනවා | මාවරය | වරදවනවා | වාරකය
bafflement=අවහිරය | පැටලීම
baffler=අනුපලු තහඩුව
bafling=ගැටමුසු
bag=අල්ලා ගන්නවා | අහුරනවා | ඔලොගුව | නියමිත ප්‍රමාණයක් | පැස | පිම්බී සිටිනවා | පිම්බෙනවා | පුටය | බෑගය | මඩිස්සලය | මල්ල | මල්ලක දමනවා | මලු | මුට්ටය | සොරකම් කරනවා
baganda=බගන්ඩා
bagasse=රොට
bagatelle=ඉතා කුඩා වස්තුවක් | ඉතා සුළුදෙයක් | බිලියඩ්ස් වැනි සෙල්ලමක් | සොච්චමක්
bagbing=ගෝනි රෙදි
bagful=පිරුණු මල්ල | පුරා පැස | පුරා මල්ලක්
baggage=ආම්පන්න | ගමනට ගෙනයන බඩුබාහිරාදිය | ගමන් මල්ල | පාථෙය්‍ය | පොදිය | බඩු පොදි | බඩුබාහිර | බරබද්දර | මාර්ගෝපකරණ | යුද්ධ හමුදාවක මාර්ගෝපකරණ | සම්බල
baggy=එල්ලෙන | පිම්බුණු | ලිහිල්
bagman=පොට්ටනිකාරයා
bagnet=කෙමන
bagpipe=එනම් සංගිත භාණ්ඩය
bags=කලිසම
baguio=බාගියෝ
bah=චහ් මතක් කරන්ට එපා
baht=බාට්
bail=අජුව | ඇප තියනවා | ඇප දෙනවා | ඇප මුදල | ඇප වෙනවා | ඇපකාරයා | ඇපය | කොක්ක
bail-bond=ඇප ඔප්පුව
bailable=ඇප දිය හැකි | ඇප දියහැකි
bailbond=ඇප ඔප්පුව | ඇපකරය
bailee=ආභාරධාරියා | ඇප ලබාගන්නා | උපනිධාන ලාභී | උපනිධානලාභියා | උපනිධානලාභී | බඩු භාර ගන්නා | බඩුබාර ගන්නා
bailer=ඉහින්න | ඉහින්නා
bailey=මාලිගාවට වට කොට ඇති තාප්පය
bailiff=කළමනාකරුවා | පිස්කල් මුලාදෑනියා | පිස්කල් මුළාදෑනියා | වතුයායක කළමනාකාරයා
bailment=ආභාරය | ඇප දීම | උපනිධානය
bailor=ආහාරදායකයා | ඇප දෙන්නා | උපනිධායක | උපනිධායකයා | බඩු බාර දෙන්නා
bailsman=ඇපකාරයා
baiment=උපනිධානය
bairn=පැංචා | බිලිඳා | බිළිඳා
bait=ආමිෂය | ඇම | ඇම දමනවා | ඇම යොදනවා | ගොදුර | පෙළඹවීම | පොළඹවනවා
baiter=ඇමකාරයා
baitfish=ඇම මාළුවා
baiting=ඇම දැමීම
baize=කම්බිලි | කම්බිලිය | ගොරෝසු ලෝම වස්ත්‍ර
bajada=බාහාඩාව
bake=පුළුස්සනවා
bake-house=ගඩොල් පුළුස්සන තැන | පාන් පුළුස්සන තැන | පෝරණුව
baked=ප්ලුෂ්ට
bakelite=බේක්ලයිට්
baker=පාන් කාරයා | පාන් වෙළෙන්ඳා | බක්කරේ
bakery=ගඩොල් පුළුස්සන තැන | පාන් පුළුස්සන තැන | පෝරණුව | බේකරිය
baking=කර කිරීම | පිළිස්සීම
baking-pan=තාච්වය
baksheesh=පාරිතෝෂකය
bakshish=පාරිතෝෂකය
balalaika=එනම් සංගීත භාණ්ඩය
balance=අඩුවැඩිකම් සේන්දු කරනවා | අවශේෂය | ඉතිරි මුදල | ඉතිරිය | ඉතුරු | ඉතුරුව | කිරනවා | කිරා බලනවා | ගුණාගුණ විවේචනය | තරාදිය | තුලනය | තුලනය කරනවා | තුලාව | තුලිතය | ශක්තිය ඇති බව | ශේෂණය කරනවා | ශේෂය | සංතුලනය | සංතුලනය කරනවා | සංතුලිතතාව | සම කරනවා | සම බර | සම බලය | සම වෙනවා | සමව තබනවා | සැසඳීම | සෙස්ස | සෙසු
balanced=තුලිත | සමබර | සැසඳූ
balancer=සංතුලකය
balancing=තුලනය | තුලනය කිරීම | ශේෂණය | සංතුලන | සංතුලනය | සංතුලනය කරනවා | සැසඳීම
balanitis=මුණ්ඩදාහය
balanophorin=බැලනොපොරීන්
balantidiasis=බැලන්තිදියාව
balantis=මුණ්ඩදාහය
balata=බලාත
balcony=උඩුමහලේ ඉස්තෝප්පුව | බැල්කනිය | සඳලුතලය | සඳැල්ල | සැඳැල්ල
bald=අනලංකෘත | කෙස් නැති | තට්ට | නොවැසුණු | මුඩු | ශුන්‍ය | ශූන්‍ය
baldachin=චන්ද්‍රාතපය
balder-dash=ප්‍රලාපය | විකාරය | හෑල්ල
balderdash=ප්‍රලාපය | හෑල්ල
baldly=තට්ටයෙන්
baldness=තට්ටය | මුඩු බව
baldric=ස්කන්ධ මේඛලාව
bale=පොදිය | බේලය | මිටි බඳිනවා | මිටිය | රෙදි මිටිය | ව්‍යසනය | විනාශය | විශාල බඩු මිටිය
baleen=තල්මසාගේ ඇට
baleful=අනර්ථ | දුහ්ඛිත | බියකරු | රෞද්‍ර | විපත්තිදායක
bali=බාලි
balistic=ප්‍රක්ෂේපණවලට සබැඳි
balistics=ප්‍රක්ෂේපණ පිළිබඳ විද්‍යාව
balk=අගාලුව | නියර | නිෂ්ප්‍රභ කරනවා | නිෂ්ඵල කරනවා | පරතරය | බාධා කරනවා | බාධාව | බාල්කය | මඟහරිනවා | රවටනවා | වළකනවා | සීරැසිය
ball=ආලිංගන නැටුම | උණ්ඩය | උණ්ඩිය | කන්දුකය | ගුලාව | ගුලිය | ගුළ | ගුළාව | ගුළිය | ගෝලය | නෘත්‍යෝජිත්සවය | පන්දුව | පිණ්ඩය | පෙද | බාල් නැටුම | බාල්නැටුම | බෝලය | භෙණ්ඩුව | මණ්ඩලය | වටකුරු වූ දේ | වර්තිකාව
ball-bearing=ගුලා බෙයාරිම | ගුලා බෙයාරිම | බෝල බෙයාරිම
ball-cock=ගුලා කරාමය
ballad=කථා කාව්‍යය | කවි කතාව | කවිකතාව | ගීතය | බැලඩ් කාව්‍යය | සැහැල්ල
ballad-monger=කවි කොළ කාරයා
ballast=තුලබරු | තුලබරුව | පුරවන ද්‍රව්‍යය | බැලස් | යාත්‍රාවක බඩු නොමැති විට බරවීම සඳහා වූ පිරවුම් දැය
baller=ගුළාකරුවා
ballerina=අභිනේතා | නාටිකාංගනාව | බැලේ නළඟන | මුද්‍රා නළඟන | මුද්‍රා නාටකය
ballet=අභිරංගය | බැලේ රැඟුම | මුද්‍රා නාටකය | මුද්‍රා නාට්‍යය | මුද්‍රානාට්‍යය
balletomane=නෘත්‍ය සහෘදයා
balling=ගුළා කිරීම
ballista=විශාල ගල් විසි කිරීම සඳහා අතීතයේ යුද්ධවලදී භාවි
ballistic=ප්‍රක්ෂේප | ප්‍රාක්ෂේප
ballistics=ප්‍රාක්ෂේප විද්‍යාව
ballistite=බැලිස්ටයිට්
ballocks=අණ්ඩය
balloelectric=බැලෝඉලෙක්ට්‍රික්
ballometer=බැලෝමීටරය
ballon=බැලූනය
balloon=බැලුනය | බැලුම | බැලූනය | ව්‍යෝමයානාව
ballooning=බිබිලිපිලීම
balloonist=ව්‍යෝම යානයෙන් යන්නා
ballot=ඡන්ද පත්‍රිකාව | ඡන්දය | රහසින් ඡන්දය දීම | රහසින් ඡන්දය දෙනවා
balloting=ඡන්දය
ballroom=උත්සව ශාලාව
ballroom-dancing=බාල් නැටුම | සාද නැටුම
bally=ඉලව් | කරදර සහිත
bally-hoo=පුහු ඝෝෂාව | බොරු ප්‍රචාරය
ballyhoo=අධික ප්‍රචාරය | බොරු ප්‍රචාරය
balm=ආලේපය | ගුගුල් | වේදනා නැසීමේ උපක්‍රමය | සහනය
balminess=සහනය | සුවය
balmy=සුගන්ධී | සුරභිගන්ධී | සුවපහස් දෙන | සෞම්‍ය
balneology=ඔසු දිය විද්‍යාව
baloney=පව | බොරු
balsa=ඉතා සැහැල්ලු ලී
balsam=කූඩලු ගස | බෝල්සම් | සුවඳැති තෛලය | සුවඳැති ලේපනය
baluable=අර්ඝ
baluster=කුඩා කුලුණ | කුඩා කුළුණ | ගරාදිය | ලඝුස්තම්භය
balustrade=කොරවක්ගල | ගරාදි වැට | වේදිය
bambino=ක්‍රිස්තු කුමරු
bambocciata=පාමර ජනයා
bamboo=උණ | බට | බම්බුව | වේණි | වේණු | වේළු | හුණ | හුණු
bamboozle=කලබල කොට වංචා කරනවා | ප්‍රෝඩාවෙන් රවටනවා | රවටනවා | වංචාවෙන් රවටනවා | විස්මයට පත් කරනවා
ban=අක්‍රෝශය | තහනම | තහනම් කරනවා | ප්‍රතිෂේධය | පිටමං කරනවා | පිටමන් කරනවා | මහාජන විරෝධය | ශාප කරනවා | ශාපය
banal=තුච්ඡ | නිසරු | සුලබ | හිස්
banality=අවිශේෂය | තුච්ඡකම | හිස් බව
banana=කදලී | කෙසෙල් | කෙසෙල් ගස | කෙසෙල් ගෙඩිය
banausic=ග්‍රාම්‍ය
bancogiro=බැංකු ගයිරෝච | බැංකු ගයිරෝව
bancor=බැංකෝරය
band=එක්‍රුස් වෙනවා | ඔතනව | කණ්ඩායම | කලාපය | ගණන | තරංග පථය | තීරුව | නඩය | පටිය | බඳිනවා | බැන්ඩ් වාදක වෘන්දය | බැඳෙනවා | බැම්ම | මිනුම් පටිය | වෙළනවා | සංගීත කණ්ඩායම | සමූහය
band-master=තූර්යවාදකයන්ගේ ප්‍රධානයා
bandage=ඔතනවා | පටියකින් වෙළනවා | වෙලීම | වෙළනවා | වෙළීම | වෙළුම | වෙළුම් පටිය
bandana=පටලේන්සුව
bandanna=පටලේන්සුව
bandeau=උෂ්ණීෂය
banderol=පතාකය
banderole=පතාකය | රූපිතපටය
banderolle=ධජ පතාකය
bandicoot=ඌරුමීයා
banding=පටි දැමීම | පටි ලෑම | වෙළීම
bandit=කොල්ලකරුවා | චණ්ඩියා | දාමරිකයා | මංකොල්ලකාරයා | මංපහරන හොරා
banditi=දාමරිකයෝ
bandits=දාමරිකයෝ
bandlicoot=ඌරුමීයා
bandoleer=පතරොම් ගෙනයන පටිය | භටවාපනය
bandolier=පතරොම් ගෙන යන පටිය
bandsman=බෑන්ඩ් තූර්යවාදකයා
bandstand=බෑන්ඩ් වේදිකාව
bandwidth=කලාප පළල
bandy=කරත්තය | දණ වක ගැසී | දමා ගසනවා | දමාගසනවා | පන්දු ක්‍රීඩා විශේෂයක් | බැණ ගන්නවා
bandy-legged=බකල
bane=අනර්ථතය | අනර්ථය | නපුර | විනාශය | විපත | විෂ | විස | හානිය
baneful=අනර්ථකර | අනර්ථදායක | අනර්ථදායි | විනාශක | විනාශකාරී | විපත්තිකර | විෂසහිත
bang=ගසනවා | තඩි බානවා | තද පහර | තද පිපිරීම | තදින් | තදින් පහර දෙනවා | මහ හජ | මහත් උනන්දුව | මහත් ශබ්දයෙන් | වදිනවා | වැදෙනවා | වැසෙනවා | වේගයෙන් | සැරෙන් පහර දෙනවා | හදිසියෙන්
banger=රතිඤ්ඤා
bangle=නූපුරය | වළය | වළල්ල | වළා | සිලම්බුව
banian=අංගරකාව | නුග ගස | නුගගස | බැනියම
banish=අස් කරනවා | උද්වාස කරනවා | නෙරපනවා | පලවාහරිනවා | පිටමංකරනවා | පිටවහල් කරනවා | පිටුවහල් කරනවා | රටින් නෙරපනවා
banishment=උද්වාසනය | නෙරපීම | පිටවහල් කිරීම | පිටුවහල් කිරීම | පිටුවාහල් කිරීම
banister=අත්වැල | ගරාදිවැට
banjo=බැන්ජෝව | සංගීත භාණ්ඩය
bank=අරමුදල | අහුරනවා | ඇල කරනවා | ඇලේට යනවා | ඉවුර | කණ්ඩිය | කැන | ගැටිය | ගොඩ | ගොඩ වෙනවා | ගොඩනගනවා | ගොඩැල්ල | තීරය | තීරුව | තෙර | බැංකු | බැංකු ගත කරනවා | බැංකුව | මුදල් තැන්පත් කරනවා | මුදල් භාණ්ඩාගාරය | රාශිය | රැස් කරනවා | රැස් කළ මුදල | රැස් වෙනවා | වෙරළස | වෙලළ | වේලාන්තය
bank-note=මුදල් නෝට්ටුව
banker=බැංකරය | බැංකු හිමියා | බැංකුකරු | වැඩ බංකුව
bankers=බැංකුකරුවෝ
banket=තිරුවාණ පරය
banking=ඇල කිරීම | ඇලය | බැංකු ව්‍යාපාරය | බැංකු විද්‍යාව | බැංකුමය කටයුතු
bankrupcy=පරිහීනත්වය | වස්තුභංගත්වය | ශූන්‍යතාව
bankrupt=නට්ටම් | බංකලොත් කාරයා | බංකොලොත් | බංකොලොත් වෙනවා | බංකොලොත්කරු | බංකොලොත්කාරයා | බූන්වත් | වස්තු භංග | වස්තුබංගයට පැමිණි | වස්තුභංග | ශූන්‍ය | හිස්
bankruptcy=බංකොලොත්කම | බංකොලොත්තුව | බංකොලොත්බව | බුන්වත් බව | බුන්වත්බව | බූන්වත් වීම | වස්තු භංගත්වය | වස්තුභංගත්වය
banksia=සස්ට්‍රෙිලියාවේ පඳුරු විශේෂයක්
banksman=සන්කරු
banner=කේතු | කේතුව | කොඩිය | ධජ | ධජය | පත්‍රයක විශාල ශීර්ෂපාඨය | පතාකය | බැනරය | සිරස්තලය
bannister=ගරාදිවැට
banns=කසාදයක පෙරනම් දීම
banquet=කවුළසුන | බාල් කනවා | භෝජන උත්සවය | භෝජනසංග්‍රහය | මංගල භෝජන දෙනවා | මංගලභෝජනය
banquette=බෑවුම් පාර | හේපියාර
banshee=අඳෝනා පවත්වන අවතාරයක්
banshie=අඳෝනා පවත්වන අවතාරයක්
bantam=කුරු කුකුළා | කුරු සතා
banter=මෘදු පරිහාසය | විහිළු කරනවා | විහිළුව | සමච්චල් කරනවා | සරදම | සරදම් කරනවා
bantu=අප්‍රිකාවේ ගෝත්‍රික ජනකොටසක් | බංටු
banyan=අංගරකාව | නුග ගස | නුගගස | බැනියම
baobab=අප්‍රිකානු ගසක්
bap=පැතැලි පාන් විශේෂයක්
baptism=ඥාන ස්නානය | නාමකරණය | බව්තීස්මය | බෞතීස්මය
baptismal=බෞතීස්මය පිළිබඳ
baptist=බෞතීස්ම කරන්නා
baptistery=බෞතීස්ම කරන ජලාශය | බෞතීස්ම කරන ස්ථානය
baptize=ක්‍රිස්තියානි කරනවා | නම් කරනවා | පිරිසිදු කරනවා | බව්තීස්ම කරනවා | බෞතීස්ම කරනවා
bar=අගුලු ලනවා | අවහිර කරනවා | අවහිරය | අවුරුව | ආපානශාලාව | ඇවුරුම | ඉවත් කරනවා | කටු දණ්ඩ | ගීතයක ස්වර ඛණ්ඩය | දණ්ඩ | දොර පොල්ල | නීතිඥ මජුල්ල | නීතිඥ මණ්ඩලය | නීතිඥකුලය | නීතිමජුල්ල | පටිය | පරය | පරිඝය | පාදය | පොල්ල | බාධකය | බාධා කරනවා | බාධාව | බාරය | බීම විකුණන ස්ථානය | බීමහල | රෝධය | වළකනවා | වළක්වනවා | විනිශ්චය ස්ථානය | වියුති | ස්ථම්භය | හරස
bar-bell=බර ඉසිලීමේදී භාවිත කරන හරස් දණ්ඩ
barathea=ලොම් රෙදි වර්ගයක්
barb=අංකුශය | ඇවුළුම්කටුව | ඊ කටුව | ඊකටුව | උල් කරනවා | තුඩ තබනවා | නාරටිය | බිලී කටුවක උල | බිලීකටුව
barbarian=අශිෂ්ටයා | පුලින්දයා | බරබරයා | ම්ලෙච්ඡයා | ම්ලේච්ඡ | ම්ලේච්ඡයා | රෞද්‍ර | වනචර | වනචරයා
barbaric=අශිෂ්ට | චණ්ඩ | ම්ලේච්ඡ | රළු | රෞද්‍ර | වනචර
barbarism=අශිෂ්ටකම | අසභ්‍ය ව්‍යවහාරය | අසභ්‍යත්වය | ම්ලේච්ඡකම | ම්ලේච්ඡත්වය | වනචරකම
barbarity=අසභ්‍ය ව්‍යවහාරය | අසභ්‍යත්වය
barbarous=චණ්ඩ | තිරිසන් | ම්ලේච්ඡ | රළු | රෞද්‍ර | වනචර
barbate=රැවුල් සහිත
barbecue=කැබලි නොකොට පුළුස්සන ලද සතා | පලහන ලද ආහාර ඇති උත්සවය | මස් පලඟන ලෝහ මැස්ස | මුළුමනින් පැලහීම
barbed=කටු සහිත | තුඩු සහිත | රළු
barbel=අංකුටය | යුරෝපීය මිරිදියේ වෙසෙන විශාල මත්ස්‍යයෙක්
barbellate=අංකුශිකාධර
barber=ඇම්බැට්ටයා | කපුවා | කරණවෑමියා | කරනවෑමියා | කෙස් කපන්නා | පණික්කියා | පනික්කියා | මුණ්ඩකයා
barberity=ම්ලේච්ඡත්වය | ම්ලේච්ඡභාවය
barberry=රතු මල් ඇති පඳුරක්
barbershop=කෙස් කැපුම්හල
barbet=කොට්ටෝරුවා
barbican=කාලතුවක්කු කපොල්ල
barbierite=බාබියරයිට්
barbitone=බාංබිටොන්
barbiturate=නිද්‍රා ඖෂධය | නිදි බේතක් | බාංබිට්‍යරේට්
barbiturates=බාබිටියුරේට
barbule=පිච්කාංගය
barcenite=බාසෙනයිට්
barchan=අඩ කව වැලි වැටිය
bard=කවියා | වන්දිභට්ටයා | විරුඳු කාරයා
bardic=විරුඳු කියන
bare=අනලංකෘත | අනාවරණය කරනවා | අලංකාරයක් නැති | අවම | ආවරණයක් නැති | කෙස්සක් අඩුයි | කේවල | තනි | නග්න | නිර්වස්ත්‍ර | පාළු | මුඩ | මුඩු | වස්ත්‍ර ඉවත් කරනවා | වස්ත්‍ර හරිනවා | ශූන්‍ය | හිස්
bare-headed=තට්ට
bareback=හුදු පිට
barefaced=නිර්ලජ්
barefoot=පාවහන් නොමැති
barefoot-doctors=සංචාරක වෛද්‍යුවරු
barefooted=පාවහන් නොමැති
barely=අමාරුවෙන් | යන්තම් | ස්වල්ප වශයෙන්
baren=උපස්ථිති ග්‍රාහකය
barffed=බාප් කළ
bargain=අඩ මිලට ඉල්ලනවා | අඩු මිලට ගත් දෙය | අඩු මිලට ලැබීම | කේවල් කරනවා | කේවල් කිරීම | කේවෙල | කේවෙල් | කේවෙල් කරනවා | තැරැව් කරනවා | තැරැව්ව | මිලයට ගත් දෙය | වාසිගනුව | වාසිය | වෙළඳාම ගැන ගිවිසුම | සම්පණ්‍යය | හෙට්ටු කරනවා | හෙට්ටුව
bargaining=කේවෙල | කේවෙල් කිරීම | තැරැව්ව | මිල අඩු කිරීම | සම්පණ්‍යයනය | හෙට්ටු කිරීම
barge=අඟුල | පඩව්ව | පාරුව | පාරුවෙන් ගෙනයනවා | බත්තල | මඟුල් ඔරුව | හැප්පෙනවා
barge-board=වඩිම්බුව
barge-steerman=බත්තල් පදවන්නා
bargee=පාරුකාරයා | බත්තල්කාරයා
bargein=හදිසියෙන් හමු වෙනවා
bargeman=බත්තල්කාරයා
baritone=අතිමන්ද්‍ර ස්වරය | අතිමන්ද්‍ර ස්වරිකයා | බැරිටෝනය | බැරිටෝනිකයා
barium=බේරියම් | බේරීයම් | සුදුපාට රසායන මූලද්‍රව්‍යයක්
bark=තච | තච්ඡ | ත්වචය | පට්ට | පට්ටය | ප්‍රපටිකාව | පොත්ත | පොතු ගලවනවා | පොතු ගහනවා | බිරීම | බිරීම වැනි හජ | බුරනවා | බුහ්ගානවා | රිටිසුඹුළු | රුවල් තුනේ යාත්‍රාව | ලොඹු | වල්කය | වල්කලය | වල්කලාව | වාලක | වැහැරී | ශකල | ශල්ක | සැව්ව | සිවිය | සුඹුල | සුඹුළු
barker=පොතු තලන්නා | පොතු තළන්නා
barkevite=බාකෙවයිට්
barkhan=අඩ කව වැලි වැටිය
barking=බිරීම
barking-deer=සලුමුවා | සලුවා
barkometer=බාකොමීටරය
barky=පොතු සහිත
barley=බාර්ලි | යව
barleycorn=යව ඇට
barm=මත්පැන් පෙණ | මද්‍ය මණ්ඩ | මද්‍යමණ්ඩය
barmy=පෙණ සහිත | මත් වූ | මෝඩ | සිහි විකල්
barn=අටුව | ධාන්‍ය ගබඩාව | ධාන්‍යාගාරය | බානය
barnacle=කුඩාකාවාටි වර්ගයක් | ඛණ්ඩාචරකයා | යාත්‍රා බෙල්ලා | යාත්‍රාබෙල්ලා
barnstorm=ගම් දෙවනත් කරනවා | රට පුරා පෙන්වනවා
baroclinic=විෂමඝනතා
barodynamics=භාරගතිවිද්‍යාව
barogram=වායුපීඩන ප්‍රස්තාරය | වායූපීඩන ලේඛය
barograph=පීඩන දර්ශකය | පීඩන ලේඛය | පීඩන සූචක ප්‍රස්තාරය | පීඩනදර්ශකය | පීඩනරේඛය | පීඩනලේඛය | වායුපීඩන ප්‍රස්තාරය
barometer=පීඩනමානය | බැරෝමීටරය | භාරමානය | වායු පීඩනමානය | වායුපීඩන මානය | වායුපීඩනමානය
barometric=වායු පීඩන | වායුපීඩන | වායුපීඩනමාන
barometrograph=වායුපීඩනේක්ෂ ලේඛය
barometry=වායුපීඩනමිතිය
baron=වංශාධිපතියා | සාමිවරයා | සිටුවරයා
baronet=කණිෂ්ඨ සාමිවරයා | කනිෂ්ඨ සාමිවරයා | බැරන් කෙනෙකුට පහළ
baronetcy=කණිෂ්ඨ සාමිකම
barony=බැරන් හෙවත් වංශාධිපතියෙකුට අයිති පළාත
barophoresis=පීඩනසරණය
baroque=බැරොක් | බැරෝක් | විවත්‍රාකෘති නොහොත් අධික කැටයම් ඇති
baroscope=පීඩනේක්ෂය
barotheromograph=පීඩනතාප ලේඛය
barotropism=පීඩනාවර්තනය
barotropy=සමඝනතාව
barque=රුවල් තුනේ යාත්‍රාව
barrack=බැරැක්කය | බැරුක්කය | හූ කියනවා | හේවා මඩම | හේවා ශාලාව | හේවාමඩුව
barracouta=මත්ස්‍ය විශේෂයක්
barracuda=ලාවා
barrage=එක දිගට වෙඩි තැබීම | නොකඩවා වෙඩි තැබීම | බාධකය | මහ අමුණ | හරස් අමුණ
barranca=බරංකාව
barrandite=බැරන්ඩයිට්
barratrous= නඩුභ්‍රංශනීය | නෞභ්‍රංශනීය
barratry=නඩුභ්‍රංශය | නාවික වංචනය | නැව් හිමියාට පාඩු වන සේ නාවිකයන් ක්‍රියා කිරීම | නෞභ්‍රංශය | බැරටිය
barre=නැටුම් ඉගෙනීමේ භාවිත කළ හරස් දණ්ඩක්
barred=අගුලු ලන ලද | වළකන ලද | හැර
barrel=කඳ | තුවක්කු කාණුව | නළ කඳ | පීප්පය | බරණිය | බැරලය | බෙරය | බෙරෙය | ලේගරය
barrel-drain=වටකුරු කාණුව
barrel-organ=අතින් කරකවන සර්ගනය
barren=අඵල | අසාර | නිෂ්ඵල | නිසරු | පාළු | මුඩු | වන්ධ්‍ය | වඳ | ශූන්‍ය | හිස්
barrenland=කනත
barrenness=නිෂ්ඵලත්වය | වෛකල්‍යය
barretter=බැරතරය
barricade=අවහිරය | බාධකය | බාධාව
barrier=බාධක | බාධකය | බාධාව | මායිම | මුරපළ | මුරපොල | මුරපොල්ල | සීමා අවහිරය
barriers=බාධක
barring=පෙර බැමවුම
barrister=අධිනීතිඥයා | අධිනීතිඥවරයා
barrow=අත්කරත්තය | සොහොන් ගොඩැල්ල | සොහොන් ගොඩැලි
bars=තීරු
bartar=ද්‍රව්‍ය හුවමාරුව
barter=ගනුදෙනු කරනවා | ගනුදෙනුව | ද්‍රව්‍ය හුවමාරුව | නිමය | නිමයනවා | නිමේයය | පරිවෘත්තිය | බඩු හුවමාරු කරනවා | බඩු හුවමාරුව | විනිමය | හුවමාරුව
bartlett=බාට්ලෙට්
bartonellosis=බාටනෙල්ලාව
barycentre=ස්කන්ධ කේන්ද්‍රය
barycentric=ස්කන්ධ කේන්ද්‍රීය
barylalia=ගරුලාලපනය
barylite=බැරිලයිට්
baryon=බරැති මූලික අංශුවක් | බැරියෝනය
baryphonia=ගරුස්වනතාව
barysilite=බැරිසිලයිට්
barysphere=අන්තර්ගෝලය
baryta=බැරීටා | බේරියම් ඔක්සයිඩ්
barytes=තීන්ත නිෂ්පාදනයේදී භාවිත කරන සංයෝගයක් | බේරයිටීස්
barytone=පුරුෂ හජ
bas-relief=පේකඩ නෙළීම | ලීයේ හෝ ගලේ මඳක් නෙරා සිටින ලෙස කැටයම් කිරීම
bas-reliefs=පේකඩ නෙළීම | පේකඩ නෙළීම්
basagenic=භස්මජනක
basal=ආධාරක | පදස්ථ | පාද | පාදස්ථ | පාදික | පාදීය | මූල | මූලස්ථ | මූලික
basalt=කඳු වලින් ලැබෙන තද ගල් වර්ගයක් | බැසෝල්ට්
basaltic=තද ගල් හා සම්බන්ධ
base=අඩිය | අත්තිවාරම | අධම | අධෝබාගය | ආධාරකය | ආධාරය | තලය | තුච්ඡ | නීච | පතුල | පදනම | පදනම් | පදනම් කර ගන්නවා | පර්යන්ත | පහත් | පහත් කොට්ඨාසය | ප්‍රාතිපදිකය | පාතුර | පාද | පාදක | පාදකය | පාදම | පාදය | පේසා | පේසාව | භස්ම | භස්මය | භුජය | මන්ද්‍රස්වර | මන්ද්‍රස්වරය | මුල | මුල් | මූල | මූලය | මූලික | ලාමක | වටිනාකමක් නැති | සමුදාය
baseball=බේස්බෝල් ක්‍රීඩාව
baseboard=ආධාරකලෑල්ල | පාදලෑල්ල | පේසාලෑල්ල
baseborn=අවජාත | හීන
baseless=අභූත | අමූල | අමූලික
baseline=ආධාරක රේඛාව | පාද රේඛාව | පාදම් රේඛාව | මුල්ඉර
basement=අධස්ථලය | පතුල්මාලය | යටමාලය
baseness=අවජාතක කම | නීචකම
basenji=අප්‍රිකානු දඩයම් බල්ලෙක්
bases=භස්ම
bash=පොඩි කරනවා | පොඩිපට්ටම් කරනවා | ලජ්ජා වෙනවා | වැරෙන් තළනවා
bashful=කුලෑටි | කොහොල් | ලජ්ජා සහිත | ලජ්ජාශිලී | විළි සහිත
bashfulness=බයාදුකම | ලජ්ජාව
basic=අවශ්‍ය | ආධාරක | භාස්මික | මුලික | මූලික | මෞලික | සමූලික
basically=මූලිකව
basichromatin=බේසික්‍රොමටින්
basicity=භාස්මිකතාව | හාස්මිකතාව
basid=බැසිඩිය
basidial=බැසිඩි
basidiolichenes=බසිඩියොලිකේනේස්
basidiomycetes=බසිඩියොමිසේටේස්
basidiophore=බැසිඩිධරය
basidiospore=බැසිඩිබීජාණුව
basidiosporous=බැසිඩිබීජාණුක
basidium=බැසිඩිය
basifixed=පාදලග්න
basifugal=පාදාපසාරී
basigamic=පාදයෝගී
basigamous=පාදයෝගී
basigamy=පාදයෝගිතාව
basil=සුවඳැති ගස් වර්ගයක්
basilica=බැසිලිකා ශෛලිය | බැසිලිකාව | විශාල පල්ලිය | විශාල ශාලාව
basilisk=දේවස්ථාවන්හි සඳහන් සර්පයෙක් | බෝදිලිමා
basin=තලිය | ද්‍රෝණිකාව | ද්‍රෝණිය | දෙණ | නදී පරිවේෂ්ටය | නදී ප්‍රදේශය | නිම්නභූමිය | නොගැඹුරු භාජනය | පාත්‍රය | බේසම | රැඳිය
basinerved=පාදශිරා
basipetal=පාදාභිසාරී
basipodite=ආධාරාංගය
basis=අත්තිවාරම | ක්‍රමය | පදනම | ප්‍රතිෂ්ඨාව | මුල්කාරණය | මූල | මූල ප්‍රතිෂ්ඨාව | මූලාධාරය
basiscopic=පාද්‍රභිමුඛ
bask=උණුසුම ලබනවා | කරුණාව ලැබ සන්තෝෂ වෙනවා
basket=කූඩය | ගොට්ට | ගොටුව | පැවිද්දා | පැස | පිටකය | පෙරහන් පැස | මල්ල | වට්ටිය
basket-word=වට්ටිකාරී
basketball=පැසිපන්දු
basketful=පැස පුරා | මල්ල පුරා
basketry=පැසකම
basketwork=පැසි විවීම | මලු විවීම
basophilic=භස්මකාමි
bass=මත්පැන් වර්ගයක් | මදර | මන්ද්‍ර | මන්ද්‍රස්වර | මන්ද්‍රස්වරය | මන්ද්‍රස්වරික | මඳුරු
basset=දඩයම් බල්ලෙක්
bassetaille=බස්තයි ශිල්පය
bassinet=ආවරණය සහිත ළදරු තොටිල්ල
bassoon=බැසූන් නලාව | ලීයෙන් තනන ලද ඉතා පහත් ස්වරය ඇති නලාවක්
bassoonist=පහත් ස්වරය ඇති නලාව වයන්නා
bast=පට්ටිය | සිවිය
bastard=අවජාත | අවජාතක | අවජාතක දරුවා | අවජාතකයා | අවජාතයා | අසත්‍ය | සංකරයා | හොර
bastardy=අවජාතක | අවජාතක බව | අවජාතකබව
bastcity=භාෂ්මිකතාව
baste=එකට අල්ලා මහනවා | තළනවා | දියාරුවට උයනවා | නූල් අදිනවා | නූල් ඇද යා කරනවා
bastille=බලකොටුව
bastinado=යටි පතුලට පහර දීමෙන් දජුවම් කරනවා
bastion=අට්ටාලය
bastite=බැස්ටයිට්
bastnasite=බැස්නසයිට්
bat=කුඹල් ලෑල්ල | පන්දු පිත්ත | පිත්ත | පිත්තෙන් ගසනවා | පිති පහර දෙනවා | වවුලා
bat,malleting=තළන පිත්ත
batch=කට්ටලය | කට්ටිය | කණ්ඩායම | කාණ්ඩය | ගණය | ගොන්න | පොදිය | සමුදාය | සමුදාව | සමූහය | සුමුව
batching=කාණ්ඩ ක්‍රමය | කාණ්ඩ කිරීම | සුමු කිරීම
bate=අඩු කරනවා | අවහිර කරනවා | බලාපොරොත්තු කඩ කරනවා | බලාපොරොත්තු කඩ වෙනවා | මඩිනවා | මඳ කරනවා
bated=බලාපොරොත්තු කඩ වූ
bath=ඔරුව | තාපකය | දෙණ | දෝවණය | නහනවා | නාන ඔරුව | නාන බඳුන | නාන භාජනය | නාන වතුර | නාන ස්ථානය | නානගෙය | නාවනවා | නැහැවුම | නෑම | ස්නානය
bath-room=නාන කාමරය
bath-tub=නාන බාල්දිය
bathe=දියෙහි බැස නානවා | නානවා | සැනසෙනවා | සැනහෙනවා | සෝදනවා
bather=ස්නානය කරන්නා
bathetic=ගම්භීර
bathing=නෑම | ස්නානය
bathing-dress=නානකඩය
bathmism=වර්දනබල වාදය
batholite=බැතොලයිට්
batholith=නිතලාක්‍රාන්තය
bathophobia=අගාධභීතිකාව
bathos=අර්තාවරෝහණය | අර්ථ පිරිහීම | අර්ථාවරෝහණය | කිසිසේත් උවත නැති දේ | ගම්භිරතාව | ගම්භීරතාව | රසපතනය | හාත්පසින් අනුවත සිද්ධිය
bathroom=නාන කාමරය
bathtub=නාන බාල්දිය
bathybic=අගාධ
bathylith=නිතලාක්‍රාන්තය
bathymeter=අගාධමානය
bathymetrical=අගාධමිතික
bathymetry=අගාධ මිතිය
bathyorography=තලාතල විෂමතාව
bathypelagic=අගාධසාගරික | අවසාගරික
bathyscaphe=දියඹේ කිමිදීමට යොදන යාත්‍රාව
bathysphere=අගාධ ගෝලය | අන්තර්ගෝලය | දියඹ ගවේෂණ ජලයාත්‍රාව
batik=බටික් වැඩ | බතික් | බතික් කර්මාන්තය
batiste=කපු රෙදි
batman=යුද හමුදා නිලධාරියාගේ සේවකයා
baton=නිලය හඟවන යෂ්ටිය | පොල්ල | බස්තම | බැටන් පොල්ල | යටිය
batsman=පන්දුවට පහර දෙන්නා | පිතිකරුවා
batta=පාරිතෝෂික මුදල | බටා | බඩා | මඟ වියදම්
battalion=පාබල සේනාංකය | පාබල සේනාංගය | බල සේනාව | බලකාය | බළ ඇණිය | බළමුළුව
battation=සෙබළමූළ
batten=අඩුත්තුව | අනුන්ගෙන් යැපෙනවා | අනුන්ගේ වියදමින් කනවා | අලසකමින් කල් ගෙවනවා | අලුව | ආරනවා | කලම්ප දොර ලෑල්ල | කෑදරකමින් කනවා | තර වෙනවා | දොරපොල්ල | ලී පටිය | සවි කරනවා
batter=කාලතුවක්කුවලින් පහර දෙනවා | තුවාල කරනවා | පන්දු ක්‍රීඩකයා | පහර පිට පහර දෙනවා | පිටපිට පහර දෙනවා | පිතිකරුවා | පිළිබෑවුම | විනාශ කරනවා | සංකුට්ටනය කරනවා
batter-peg=හැඩ කූඤ්ඤය
battered=කඩා දමන ලද | තුවාල කරන ලද | දිරාපත් වූ
battering-ram=ප්‍රාකාර බිඳීම පිණිස යෙදූ පැරණි යුද්ධෝපකරණයක්
battery=අඩන්තේට්ටම | කාලතුවක්කු කණ්ඩායම | පෙළ | පේළිය | බතරොයිය | බැටරිය | යන්ත්‍ර ශ්‍රේණිය | විදුලි කෝෂය
batting=පන්දුවට පහර දීම
battle=අවිසරම | අවිසරඹ | දඟලනවා | පොරය | පෝෂණය කරනවා | යුද්ධ කරනවා | යුද්ධය | සටන | සටන් කරනවා | සමර | හටන්
battle-field=රණබිම
battle-ship=විශාල යුද්ධ නැව
battleaxe=පුරාණ යුද්ධවලදී පාවිච්ව කළ දිග පොරව
battlecry=යුද්ධඝෝෂාව
battledoor=කුඩා පන්දු පිත්ත
battledore=කුඩා පන්දු පිත්ත
battledress=හේවායාගේ දිනපතා ඇඳුම
battlefield=යුද්ධභූමිය
battleground=යුද්ධභූමිය
battlement=ආරක්ෂක ප්‍රාකාරය | කොටුපවුර
battleship=යුද්ධ නැව
batty=අසාමාන්‍ය | පිස්සු
bauble=කෙළිබඩුව | සොච්චම
baud=බෝඩ්
baulk=අගාලුව | නියර | නිෂ්ප්‍රභ කරනවා | නිෂ්ඵල කරනවා | පරතරය | පරාජය | බාධා කරනවා | බාධාව | බාල්කය | මඟහරිනවා | රවටනවා | වළකනවා | හීරැසිය
bauxite=ඇලුමිනියම් ලෝහය ලබාගන්නා ඛණිජය | බොක්සයිට් | බෝක්සයිට්
bawd=කුට්ටිණී | ගණිකා මඩමක් පවත්වාගෙන යන්නී
bawdy=අශික්ෂිත | ග්‍රාම්‍ය | නීච | පහත්
bawl=උස් හන් කියනවා | කෑ මොර ගසනවා | කෑගසනවා | බුරනවා | බෙරිහන් දෙනවා | හජ නඟනවා
bay=අතුරිඩ | උඩුබුරලනවා | කඩ | ගස් වර්ගයක් | ගුරුපාට හෝ පිඟුවන් | නොනැවතී බුරනවා | ප්‍රවේශ | ප්‍රවේශ මාර්ගය | පිඟුවන් | බල්ලන්ගේ උඩබුරලීම | බිරීම | බුරනවා | බොක්ක | බොකු | මහා බොක්ක | මුහුදු බොක්ක | මූදු බොක්ක | රතට හුරු දුඹුරු | රාක්කය
bayberry=සුවඳැති ශාක විශේෂයක්
bayerite=බයරයිට්
bayes=බේස්
bayesestimation=බේස් නිමානය
bayldonite=බේල්ඩනයිට්
bayonet=බයිනෙත්තුව | බයිනෙත්තුවෙන් අනිනවා | බයිනේත්තුව
bayou=බයියුව
baywood=බේදැව
bazaar=කඩපළ | කඩපොළ | කඩමණ්ඩිය | කඩවීදිය | වෙළඳ පොළ
bazooka=යුද්ධ ටැංකි ප්‍රහාරක උපකරණයක්
be=ඉන්නවා | තිබෙනවා | තියෙනවා | පවතිනවා | වත් වෙනවා | වෙනවා | සිටිනවා
beach=ගොඩට අදිනවා | වැල්ල | වෙරළ
beach-seine=මාදැල
beachcomber=අලසයා
beachflora=වෙරළබඩ ශාක
beaching=කා වැරුම
beacon=අනතුරු හඟවන ලකුණ | ගිනිමැලය | දිලිසෙනවා | පහන් කණුව | ප්‍රදීපය | සන්වැට | සනෙළිය | හිවිසන
bead=අමුණනවා | කැටයම් වැල | පබළු ඇටය | පබළුව | පවලම් හැඩ ලීස්තරය | බුබුල | බුබුළ | බොරදම | බොරදම් ගානවා | ලීස්තර ගානවා
beading=කැටිති සෑදීම | බීඩිම | බොර දම් පටිය | බොරදම් පටිය
beadle=විදානෙ
beads=ගුලිකා | පබළු | පවලම් | ප්‍රවාල
beagle=බීගල් නම් සුනඛ වර්ගයක්
beah-head=වැල්ලේ කඳවුර
beak=චඤ්චූව | තුඩ | තුණ්ඩය | හොට | හොටය
beaked=තුඩැති
beaker=චෂකය | ද්‍රව මනින භාජනය | බිකරය | බීකරය
beam=එළිය දෙනවා | කදම්බය | කාන්තිමත් බැල්ම | තරංගය | තරාදි කඳ | තලාඳ | තලාඳය | තළාඳ | දණ්ඩ | දන්ඩ | නඟුල් කඳ | බබලනවා | බල්කය | බාල්කය | බෝන් ලීය | යටලීය | යටිය | යාත්‍රාවේ පළල | රශ්මිය | රැස් විහිදුවනවා
beaming=කාන්තිමත් | මඳ සිනහවෙන් යුත් | මඳලසින් යුත් | වටකඳේ එතීම | සමුද්දීපනය
bean=ඔළුගෙඩිය | කඩල ඇට | කෝපි ඇට | බෝංව | බෝන්ව | මාෂ | මෑ ඇට
bean-feast=උත්සවය | ජයට කන මඟුල
bean-stalk=බෝන්ව වැල
beanpole=උස් හීන් තැනැත්තා | කෙසඟයා
beans=බෝංව
bear=අසුලාගෙන යනවා | ඇතුව සිටිනවා | ඉවසනවා | උසුරුවනවා | උසුලනවා | ඔබිනවා | ගෙනයනවා | තරච්ඡ | තරසා | දඩබ්බරයා | දරනවා | පල දරනවා | පලදෙනවා | ප්‍රසූත කරනවා | බර කරනවා | බිහි කරනවා | වලසා | වලහා | වලහෙකු වැනි අයෙක් | විකුණුම් ජාවාරම්කාරයා | සුවහ පොංවය
bear-garden=මහත් ගෝට්ටියක් ඇති තැන
bear-hug=දැඩි හාද්ද
bearable=ඉසිලිය හැකි | දැරිය හැකි
beard=කෙඳි | රැවුල | රැවුළ | රැවුළෙන් අල්ලනවා | විරුද්ධ වෙනවා | විරුද්ධව සිටිනවා
bearded=කෙඳි සහිත | රැවුල් සහිත
bearer=උසුලන්නා | ගෙනයන්නා | දරන්නා | ධාරකය | ධාරකයා | බර ගෙනයන්නා | භාරකයා | මිනී උසුලන්නා | රැගෙන එන්නා | වාහකය | හාරකයා
bearing=ආචාරය | ඉවසීම | ඉසිලුම | දිගංශය | දිශාමානය | දිශාව | දිසාව | පල දැරීම | ප්‍රසූතය | පැවැත්ම | බරුව | බෙන්සෝල් බෙයාරිම | බෙයාරිම | මාලිමා | යන්ත්‍රබරුව | සම්බන්ධය
bearish=අවිනීත | වලසෙකු වැනි
beast=තිරිසන් සතා | තිරිසනා | මිග | මෘගයා | මෘගව්‍යාධ | සතා | සිවුපාවා
beastly=ක්‍රූර ලෙස | කාලකණ්ණියා | තිරිසන් | තිරිසනෙකු පරිදි | මෘගයකු වැනි
beat=අපුල්ලනවා | ආඝාතය | කලවම් කරනවා | කුඩු කරනවා | ගසා මිශ්‍ර කරනවා | ගහනවා | ගැස්ම | ගුටි බානවා | තඩි ගහනවා | තඩි බානවා | තළනවා | තැළීම | තිත | තුවාල කරනවා | නුගසනවා | නුගැස්ම | නුගැසුම | පරදවනවා | පහර | පාගනවා | පැරදීම | පුරුදු පාර | මුර කොටස | වදිනවා | වැදීම | වැයික්කිය | ස්පන්දනය | ස්පන්දනය වෙනවා | ස්පන්දය
beaten=කුඩු කරන ලද | ගෙවුණු | තළන ලද | පැරදුණු | පුරුදු
beater=කෙටීමට යොදන උපකරණය | ගසන්නා | තළන ගල් කටුව | තැළීමට යොදන උපකරණය | දඩයමේදී සතුන් එලවන්නා
beathollow=අත්‍යන්තයෙන් පරදවනවා
beatific=පරම සුඛදායී | මනස්කාන්ත
beatification=පරම සුඛෝත්පාදනය | ශුද්ධවන්ත භාවයට එසවීම
beatify=ශුද්ධවන්ත භාවයට ඔසවනවා | ස්වර්ග සම්පත් දෙනවා
beating=ගැසීම | තැලීම | තැළීම | නුගැස්ම | නුගැසීම
beatitude=අපවර්ග සම්පත්තිය | අමෘතත්වය | කෛවල්‍යය | නිර්වාණය | පරමානන්දය | ප්‍රමෝදය | මෝක්ෂය
beats=නුගැසුම් | නුගැසෙයි
beau=ජේත්තු කාරයා | පෙම්වතා | මනමාලයා | සල්ලාලයා
beaujolais=ප්‍රංශයේ සාදන වයින් වර්ගයක්
beaumontague=පිරැවිය
beaut=හැඩ දෙය හෝ පුද්ගලයා
beauteous=ලස්සණ | ලස්සන
beautician=රූපලාවණ්‍ය ශිල්පිනි | රූපලාවණ්‍ය ශිල්පියා | ශෝභක | ශෝභිකා | හැඩ ගන්වන්නා
beautiful=අභිරූප | අලංකාර | කමනීය | කල්‍යාණ | රුවරානන | රුවැති | රුසිරු | රූපත් | රූපසම්පන්න | රූබර | රූමත් | ලක්ෂණ | ලලිත | ලස්සණ | ලස්සන | විරාත | විවත්‍ර | විසිතුරු | ශෝභන | සශෝභන | සුමන | සොඳුරු | සොබන | සොබමන් | හැඩ | ළකල්
beautifully=ලස්සණට
beautify=අලංකාර කරනවා | සරසනවා | හැඩ ගන්වනවා
beauty=අලංකාරය | කලණ | කල්‍යාණ | කාන්තිය | රමණීයත්වය | රමණීයතාව | රම්‍යතාව | රුව | රුසිර | රූ | රූපකල්‍යාණය | රූපය | රූපලාවණ්‍යය | රූපලාවන්‍යය | රූපසම්පත්තිය | රූසපුව | ලක | ලක්ෂණ | ලස්සණ | ලාවණ්‍යය | විලාසිනී | ශ්‍රී | ශ්‍රීය | ශෝභාව | සිරිසර | සුන්දරත්වය | සුන්දරභාවය | සුන්දරිය | සොබා | සෞන්දර්ය | සෞන්දර්යය | හැඩ | හැඩකාරිය | හැඩය
beauty-queen=රූප සුන්දරී
beaver=අත්මේස් ආදිය | රැවුල්කාරයා
beaverite=බීවරයිට්
bebop=ජෑස් සංගීතය
becalm=නිශ්චල කරනවා
becalmed=නිශ්චල
became=වුණා
because=නිසා | බැවින් | හන්දා | හින්දා | හෙයින් | හේතු කොට | හේතුකොට
beccarite=බෙකරයිට්
beche=බෙෂය
bechilite=බෙකිලයිට්
beck=අතින් ඉඟි කරනවා | අතින් කරන සංඥාව | ඉඟි කරනවා | දික් සට්ටම | දොළ | දොළදෙණිය | සංඥා කරනවා | හිසින් ඉඟි කරනවා | හිසින් කරන සංඥාව
beckelite=බෙකෙලයිට්
becket=පුඩුව
beckon=ඉඟි කරනවා | කැඳවනවා | සංඥා කරනවා
becloud=අඳුරු කරනවා | වසා දමනවා
become=ඇති වෙනවා | ඔබිනවා | යෝග්‍ය වෙනවා | වෙනවා | හට ගන්නවා
becoming=ඉපදීම | උවත | බව | භවය | මනා | යෝග්‍ය
becomingly=අනුරූපසේ
becquerel=විකිරණශීලිතාව මනික ඒකකය
becquerelite=බෙකරලයිට්
becterioviridin=බැක්ටීරියෝවිරීඩින්
bed=අතුරනවා | ඇඳ | තට්ටුව | තැන්පත් කරනවා | නිදාගන්නවා | නිදි කරනවා | පත්ල | පාත්තිය | මඤ්ච | මඤ්චක | මැස්ස | යහන | රෝපණය කරනවා | විවාහය | ශයනය | සයනය | හැඳ
bed-chair=ගිලන් පුටුව
bed-chamber=සයනාගාරය
bed-fellow=එක ඇඳේ නිදාගන්න තැනැත්තා
bed-frame=ඇඳ විට්ටම
bed-pan=ගිලන් ඇඳේ මල මූත්‍ර කිරීමට භාවිතා කරන ද්‍රව්‍යය
bed-ridden=ඔත්පළ වූ | ඔත්පොළ වූ
bed-rock=මූලාධාරය
bed-room=නිදන කාමරය | යහන් ගබඩාව | සයනාගාරය
bed-spread=ඇඳ ඇතිරිල්ල
bed-stead=ඇඳ | ඇඳේ කූඩුව
bed-table=ඇඳ අද්දර පිහිටි කුඩා මේසය
bedabble=තෙත් කරනවා | පැල්ලන් ගසනවා
bedaub=ගානවා | තවරනවා
bedazzle=අන්දමන්ද වෙනවා | මුළා වෙනවා
bedbug=ඇඳමකුණා
bedclothes=ඇඳ රෙදි
bedding=ඇතිරීම | ඇඳ රෙදි | ඇඳකට අවශය උපකරණ | තට්ටු පිහිටීම | තැන්පත් කිරීම | පිරිහෙවුම | පිරිහොවනාව | යහන් උවාරණ
bedeck=අලංකාර කරනවා | සරසනවා
bedevil=කලබල කරනවා | හිරිහැර කරනවා
bedevilment=හිරිහැරය
bedew=ඉසනවා | පින්නෙන් තෙමනවා
bedizen=නොමනා අලංකාරයෙන් සැරසෙනවා
bedlam=උන්මත්තාලය | ගාලගෝට්ටිය | පිස්සන් කොටුව | මහත් කලබලය
bedlamite=පිස්සා | පිස්සා
bedlington=සුනඛ විශේෂයක්
bedouin=කාන්තාරවාසියා | නිත්‍යවාසයක් නැති අරාබිකාරයා | රස්තියාදු කාරයා
bedpan=ඇඳ පෝච්වය
bedraggle=කුණු තැවරුණු
bedraggled=අවුල් වූ | අශෝභන | කුණු තැවරුණු | තෙතබරිත
bedrock=පතුල් ගල් තලය | පිහිටි ගල | මූලාධාරය | යටි පාෂාණය
bedroom=නිදන කාමරය | සවරකය
bedside=ඇඳ ළඟ
bedsitter=නිදන සාලය
bedsore=ඇඳ වණය
bedsores=ඇඳ වණ
bedstead=වියල
bedstraw=කුඩා පැලෑටියක්
bedwetting=නින්දෙහි මුත්‍රා කිරීම
bee=තරඟය | දෙහිරු | බඹරා | බිඟු | භ්‍රමර | භෘංග | මීමැස්සා | මීලොල් | රාශිය | ෂට්පදී | සපා
bee-bread=මීහකුරු
bee-culture=මී මැසි පාලනය | මීමැස්සන් ඇති කිරීම
bee-eater=කවුඩා
bee-hive=මීමැසි පෙට්ටිය හෝ කළය | මීය
bee-keeper=මීමැසි පාලකයා
bee-line=ඉතා කොට පාර
beech=ගස් වර්ගයක්
beef=ගවමස් | ගවයෙකුගේ වැනි ශක්තිය | ගෙරිමස් | හරක් මස් | හරක්මස්
beef-eater=ලන්ඩන් කුළුණ ආරක්ෂකයා
beef-steak=ඝන පෙති කොට බැදපු ගවමස්
beef-tea=ගෙරිමස් රසය
beefeater=ලංඩන් කුළුණ ආරක්ෂකයා
beefy=ගවයෙකු වැනි | තරබාරු
beegerite=බීගරයිට්
beehive=මීවදය
beeline=ඉදුරා යෑම | කෙළින් යෑම
beelzebub=යක්ෂයා | සාතන්
beemerose=බීමරෝස්
been=ගිය | වූ
beep=නළා හඬ | නාද කරනවා | නාදය | මෝටර් රථවල නලා හඬ
beer=බියර | බීර | යව සුරා
beerbachose=බියර්බැකෝස්
beery=යව සුරා බඳු
bees-wax=මීඉටි
beeswax=මී ඉටි
beeswaxing=මී ඉටි ගෑම
beet=එළවලු වර්ගයක් | බීට් අලය | බීට් පැළය
beet-root=බීට් ගසේ අලය
beeting=නෙරා සිටින | ප්‍රලම්බ
beetle=අතකොලුව | කුරුමිණියා | තාප්ප මෝල | නෙරා සිටිනවා | ලොකු අතකොළුව
beetles=කුරුමිණියෝ
beetroot=බීට් අලය
befall=සිදු වෙනවා
befit=ඔබිනවා | ගැළපෙනවා | සෑහෙනවා
befitted=පෑහෙනවා
befitting=ඔබින | ගැළපීම | සෑහීම
befog=අවුල් කරනවා | මීදුමෙන් ගසනවා | මීදුමෙන් වසනවා | මුළා කරනවා
before=ඉදිරිපිට | ඉදිරියෙහි | ඉස්සර | ඉස්සරහ | ඉස්සරින් | කලින් | කෙලින් | පුරන් | පුරෝ | පෙර | පෙරටුව | පෙරාතුව | මෙපිට | සං
before-hand=කල් ඇතිව | කල්තියා
beforehand=කල්තබා
befoul=කැත කරනවා
befreed=මිදෙනවා
befriend=අනුග්‍රහ කරනවා | උදව් වෙනවා | පිහිට වෙනවා | මිතුරු වෙනවා
befuddle=මුළා කරනවා | සිහි විකල් කරනවා
befuddled=අවුල් වූ | මෝඩ වූ | සිහි විකල් වූ
beg=අත දික්කරනවා | අත පානවා | අයදිනවා | ඉල්ලනවා | යටහත්ව ඉල්ලනවා | යාච්ඤා කරනවා | සනෑකමින් ඉල්ලනවා | සිඟනවා | හිඟනවා | හිඟමනක් ඉල්ලනවා | හිඟමනට පත් කරනවා | හිඟාකනවා
begad=දෙවියන් පල්ල
began=ඇරඹුවා | පටන් ගත්තා
beget=උපද්දනවා
begetter=උත්පාදකයා
beggar=අනුකම්පා කළ යුත්තා | කාලකණ්ණියා | පරපුටු | යදියා | යාචකයා | සිඟන්නා | හිඟන්නා
beggarly=අසරණ | දුප්පත් | මසුරු | හිඟන
beggary=දරිද්‍රතාව | දිළිඳු බව | දිළිඳුකම | දුප්පත් කම | දුප්පත්කම | යාචකත්වය | හිඟාකෑම
begged=අයදූ | ඉල්ලූ
begging=භික්ෂාව | යාචනය | සිඟමන | සිඟාකෑම | සිඟීම | හිඟමන
beggr=යදියා
begin=අරඹනවා | ආරම්භ කරනවා | ආරම්භ වෙනවා | පටන් ගන්නවා
beginingless=අනාදිමත්
beginner=ආධුනිකයා | නවකයා | මුල පුරන්නා
beginning=ආරම්භය | ප්‍රභවය | මුල | සාරම්භය
begird=වට කරනවා | වටකරනවා | වෙළනවා
begirdle=වට කරනවා | වෙළනවා
begirt=වට කරන ලද | වෙලූ
begone=පලා යව | යව | වහා යව
begonia=බෙගෝනියා පැල | බෙගෝනියා මල්
begot=ඉපදවිය
begotten=ඉපිද වූ | ඉපිදවූ | දා වූ | දාවූ
begrime=කැත කරනවා | කැත කුණු තවරනවා
begrudge=ඉරිසියා කරනවා | ඊර්ෂ්‍යා කරනවා
beguile=කාලය පහසුවෙන් ගෙවනවා | ගත කරනවා | රවටනවා | වංචා කරනවා | වශී වෙනවා | විමෝහනය කරනවා
beguilement=මුළා කිරීම | වශී වීම
beguiling=මුළා කරන | වශී වන
beguine=බටහිර ඉන්දීය නැටුමක්
begum=කුලීන කත | කුලීන කාන්තාව | මෙහෙසිය
begun=ආරබ්ධ | ඇරඹූ
begunk=රවටනවා
behalf=වෙනුව | වෙනුවට
behappen=සිදු වෙනවා
behave=ක්‍රියා කරනවා | පවතිනවා | හැසිරෙනවා
behavior=හැසිරීම
behaviorism=චර්යාවාදය
behaviour=ආචාරය | කල්කිරියාව | චර්යාව | චරිතය | හැසිරීම
behavioural=චර්යා | චරිත
behaviourism=චර්යාවාදය
behaviourist=චර්යාවාදියා
behead=හිස ගසනවා | හිස ගසා දමනවා
beheading=ශීර්ෂච්ඡේදනය | ශීර්ෂච්ඡේදය | හිස ගසා දැමීම
beheld=බැලුවා
behemoth=යමෙක මැවුම්කරුවා
behest=අණ | ආඥාව | නියමය | නියෝගය
behicle=වාහනය
behight=ගිවිසිනවා | පොරොන්දු වෙනවා
behind=ඉතිරිව | පස්සෙන් | පස්සෙහි | පසුපස | පසුපසින් | පසුව | ප්‍රමාදව | පිටිපසින් | පිටුපස | සැඟවී
behind-hand=කලට වේලාවට නැති | ප්‍රමාද
behold=අවලෝකනය කරනවා | ඇන්නෑවේ | ඇස් ඇර බලනවා | දකිනවා | නිරීක්ෂණය කරනවා | බලනවා | බලව | සනෑකමින් බලනවා
beholden=ණය ගැති | ණයගැති
beholder=බලන්නා
beholding=අවලෝකනය | දැකීම | බැලීම
behoof=අර්ථය | පහසුව | ප්‍රතිලාභය | ලාභය | වාසිය
behoove=යෝග්‍ය වෙනවා | සුදුසු වෙනවා
behot=ප්‍රතිඥා දෙනවා
behote=ප්‍රතිඥා දෙනවා
behove=අවශ්‍යව තිබෙනවා | යුතුව තිබෙනවා | යෝග්‍ය වෙනවා | සුදුසු වෙනවා
beidellite=බයිඩලයිට්
beige=බේජ් වර්ණය | ලා දුඹුරු පාට | වැලි පාටට හුරු
bein=පොහොසත් | රසනහර | සුවපහසු
being=ජීවය | පාණ | පැවැත්ම | භාවය | භූතයා | සක් | සත්තාව | සත්තාව සත්වයා | සත්වයා | සතා
beingless=නොපවතින
beingness=පැවැත්ම
beinness=සම්පත | සුවපහසුව
bejewelled=මැණික් ඇල්ලූ | මුතු මැණික් ආභරණවලින් සැරසුණ
beknave=වංචා කරනවා
beknown=ප්‍රකට වෙනවා
bel=බෙල | බෙලය | බෙල් | ශබ්දය මනින සාපේක්ෂක ඒකකයක්
belabour=තදින් පහර දෙනවා | තළා පෙළා දමනවා | තාඩන පීඩන කරනවා | පහර ගසනවා | බණිනවා
belated=කල්ගිය | කල්පසු වූ | ප්‍රමාද | ප්‍රමාද වූ | බෝව පැමිණි
belaud=පසසනවා | ප්‍රශංසා කරනවා
belay=ඔප දමනවා | කඹ දානවා | වට කරනවා
belch=රාමතෙල් අරිනවා
belcherose=බෙල්කරොස්
belching=උද්ගීරණය
beldam=ආච්චි | ආත්තා | මැහැල්ල
beldame=ආච්ව | ආත්තා | මැහැල්ල
beldongrite=බෙල්ඩොන්ග්‍රයිට්
beleaguer=අවරෝධනය කරනවා | අවහිර කරනවා | වට කරනවා | හිරිහැර කරනවා
belee=මුවාවෙහි තබනවා
belemnite=පාෂාණධාතු හුල
belfry=ඝණ්ටාගාරය | සීනු කණුව
belgard=කාරුණික බැල්ම
belgian=බෙල්ජියානුවා
belial=යක්ෂයා
belie=බොරු කියනවා | බොරු සේ දක්වනවා | රවටනවා | වංචා කරනවා
belief=ඇදහිල්ල | ඇදහිලි | ඇදහීම | දිට්ඨිය | දිටු | භක්තිය | මතිය | ලබ්ධිය | විශ්වාසය | හැදහිල්ල | හැදහිලි
beliefless=විශ්වාස නැති
believable=ඇදහිය හැකි | විශ්වාස කළ හැකි
believe=අදහනවා | විශ්වාස කරනවා | හදහනවා
believeable=විශ්වාස කටහැකි
believer=අදහන්නා | ආස්තිකයා | ඇදහිලිවන්තයා | බැතිමතා | විශ්වාසියා
believing=අදහන | ඇදහීම | විශ්වාස කරන | විශ්වාස කිරීම
belite=බෙලයිට්
belittle=පහත් කොට සලකනවා | මදිපුංවකම් කරනවා | ලඝු කොට දක්වනවා
belittlement=මදිපුංවකම | ලඝු කොට දැක්වීම | ලඝු කොට සැලකීම
belittling=මදි පුංව
belive=යහුසුලුව | වහා
bell=කෑගසනවා | කිංකිණිය | ඝණ්ටාකාර වූ දේ | ඝණ්ටාරය | ඝණ්ටාව | ඝණ්ඨාව | ටංගනාව | මිණි | මිණිගෙඩිය | මුවාගේ නාදය | මොර දෙනවා | සීනුව | සීනුවක් එල්ලනවා | සීනුවක් යොදනවා
bell-metal=කාංස්‍ය | ලෝකඩ
bell-pull=ඝණ්ටාවේ කඹය හෝ දම්වැල
bell-rope=ඝණ්ටාවේ කඹය හෝ දම්වැල
bell-shaped=ඝණ්ටාකාර
belladonna=බෙලඩෝනා | විෂ සහිත ගස් වර්ගයක්
belle=ජනපද කල්‍යාණී | රාත්‍රි සුන්දරිය | රූපසුන්දරී | රූමත් කාන්තාව | රූමතිය | විලාසිනී
belle-de-nuit=සුන්දර කාන්තාව
belles-letters=සාහිත්‍යය
belleter=සීනු තතන්නා
bellibone=සුන්දර කාන්තාව
bellicose=දබරයට කැමති | යුද්ධශීලි | යුද්ධශීලී | රණකාමී
bellicosity=රණකාමී බව
bellied=බණ්ඩිමත් | මහ බඩ සහිත | මහෝදර
belligerant=රණකාමී
belligerent=දබරයට කැමති | යුද්ධකාරී | යුද්ධයක යෙදී සිටින පක්ෂය | යුද්ධයක යෙදී සිටින රාජ්‍යය | යුද්ධයෙහි යෙදී සිටින | රණපත් | සංග්‍රාමාවතීර්ණ
belligerents=රණපත්හු
bellmouth=සීනු කට
bellow=ගර්ජනා කරනවා | ගිගිරීම | ගුගුරනවා | ගොරවනවා | තප්පුලනවා | තැහ්ලනවා | බෙරිහන් දෙනවා | මොරගහනවා | මොරගැසීම
bellower=ගුගුරන්නා
bellows=මයිනහම
belly=ඉදිරියට නෙරා වැටෙනවා | උදරය | කුක්ෂිය | කුස | ගැබ | බඩ | බණ්ඩිය | බන්ඩි ගහනවා | බොක්ක
belly-band=උරපටිය
belly-full=උදරපූරණ | බඩ පිරෙන තරම් | බඩපුරා
bellyful=බඩපුරා
bellying=බොකු වැටීම | මඩ පිරීම
belomancy=ඊතල නිමිත්ත
belonesite=බෙලොනසයිට්
belong=අඩංගු වෙනවා | අඩුත්තු වෙනවා | අයිති වෙනවා | අයිතිවෙනවා | ඇතුළත් වෙනවා | හිමි වෙනවා
belonging=අයිති | හිමි වන
belongingness=ආයත්තතාව
belongings=අයිතිවාසිකම් | දේපළ | වස්තුව
belonite=බෙලොනයිට්
beloved=ආදරණීය | ප්‍රිය | ප්‍රියා | ප්‍රේමවන්තයා | පෙම්බර | වල්ලභ | වල්ලභ ස්ත්‍රී
beloving=ආදරණීය
below=අධස් | අධහ් | අධෝ | නීච | පහත | පහත් | පහතින් | පහලින් | පහළ | පහළින් | පාත | පාත් | යට | යටි | යටින්
belt=කලාපය | තීරය | තීරුව | පටිය | පටියක් පළඳනවා | පටියක් බඳිනවා | පටියෙන් පහර දෙනවා | බඳපටිය | බාපනය | මේඛලාව
belted=පටබැඳි | සම්මානනීය
belting=තැළීම | පටි | පටිරෙදි | පහර දීම
beluga=මුහුදු මාළුවෙක් | සුදු තල්මසා
belvedere=සඳලුතලය | සී මැදුරු කවුළුව | සීමැඳුරු කවුළුව
bema=පීඨය
bemaul=තළනවා | පහර දෙනවා
bemazed=පුදුම වූ | වික්ෂිප්ත
bemean=පහත හෙළනවා | බාල කරනවා
bemire=මඩ ගානවා
bemoan=තැවෙනවා | වැලපෙනවා | වැළපෙනවා | ළතවෙනවා
bemoaner=වැළපෙන්නා
bemock=විහිළු කරනවා | සරදම් කරනවා
bemoil=මඩ ගාගන්නවා
bemonster=බියකරු වෙනවා
bemouth=හඬ නඟනවා
bemud=මඩ ගානවා
bemuddle=අවුල් කරනවා
bemuffle=ඔතනවා | වහනවා
bemuse=අවුල් කරනවා | භ්‍රාන්ත කරනවා
ben=ඇතුල්කාමරය | ඇතුළට | කදු මුදුන | භය කරනවා | හොඳ අතට
bename=නම් කරනවා | සඳහන් කරනවා
bench=පීඨය | ඵලකය | බංකුව | විනිශ්චය මණ්ඩලය | විනිශ්චයාසනය
bench-mark=මිනින්දෝරුවාගේ සලකුණ
bencher=පීඨධාරි
benching=පිල
benchmark=මිණුම් ලකුණ
bend=ඇද කරනවා | ඇදය | කුදය | නමනවා | නවනවා | නැම්ම | නැමීම | නැමෙනවා | මුල්ල | යටත් කරනවා | යටත් වෙනවා | යොමු කිරීම | වංගුව | වක | වකගහනවා | වකය | හැරෙනවා
bender=නමනය | නමන්නා
bending=ආනමනය | නමන | නම්‍ය | නැම්ම | නැමීම | නැමුම්
bendy=නැමි සහිත
bene=සු
beneath=නුසුදුසු | නොහොබින | නොහොබිනා | පහත | පහත් | පහළ | පාත | යට
beneceptor=සද්ග්‍රාහකය | සද්ග්‍රාහකයා
benediction=ආශිංසනය | ආශීර්වාදය | ආසිරි
benedictive=ආශිර්වාදාත්මක | ආශීර්වාදාත්මක
benedictory=ආශීර්වාදාත්මක
benefaction=උදව්ව | උපකාරය | පරිත්‍යාගය | යහපත | යහපත සැලසීම | හිතවැඩ
benefactor=උපකාරකයා | දායකයා | පරිත්‍යාගශීලියා | හිතවතා
benefactory=වැඩදායක | හිතකාමී
benefice=දේවගැතියෙකුගේ දිවිපෙවෙත | බඩවැඩිල්ල
beneficence=පරෝපකාරය | යහපත කිරීම
beneficent=ත්‍යාගශීලී | ප්‍රයෝජනවත් | හිතවත්
beneficial=අර්ථදායි | පථ්‍ය | ප්‍රයෝජනවත් | ඵලදායක | ඵලදායී | යහ | වැඩදායක | ශංකර | සුභසාධන | හිතකර | හොඳ
beneficiary=අර්ථලාභියා | අර්ථලාභී | නින්දගම්කාරයා | ප්‍රතිලාභියා | ප්‍රයෝජන ලබන්නා
benefit=අර්ථය | අර්ථලාභය | අරුත | උපකාර වෙනවා | උපකාරය | කම | ප්‍රතිඵලය | ප්‍රතිලාභය | ප්‍රයෝජන ලබනවා | ප්‍රයෝජනය | ප්‍රයෝජනයක් සලසනවා | ප්‍රයෝජනයක් සැලසෙනවා | ඵලප්‍රයෝජනය | ඵලය | යහපත | යහපත කරනවා | යහපත සලසනවා | ලාබය | ලාභය | වාසිය | වාසියක් ලැබෙනවා | වැදගැම්ම | ශුභසිද්ධිය | හිය
benefits=ප්‍රතිලාභ
benelux=බෙනෙලක්ස්
benemid=බෙනමිඩ්
benevolence=කරුණාව | ගුණවත්කම | ත්‍යාගවන්තකම | හිතකාමිත්වය
benevolent=කරුණාවන්ත | ත්‍යාගශීලී | දයාපත් | දයාබර | යහසාධක | හිතකාමි | හිතකාමී
bengal=බෙංගාලය
bengali=බංගලි | බංගාලි | බෙංගාලි | වංග | වංග දේශයේ භාෂාව | වංග දේශයේ වැසියා
benighted=අන්ධකාරයෙන් පීඩිත | ඉතා නූගත් | මුග්ධ | මෝඩ
benign=අඛර | කරුණාවන්ත | කාරුණික | දයාන්විත | මෘදු | මොළොක්
benignant=කාරුණික | ගුණවත් | දයාන්විත | දයාබර
benignity=මෘදුභාවය
benison=ආශිර්වාදය | ආශීර්වාදය
bent=අහිප්‍රාය | දැරුම් රාමුව | නතු | නම්‍ය | නම්‍යතාව | නැමි | නැමුණා | නැමුණු | පොකුටු | බොකුටු | වංක | වක | වක් | වකුටු | සොකර | හුරුකම | හුරුව
benthal=නිතල | නිතලවාසී
benthamism=බෙන්තම්වාදය
benthic=නිතල | නිතලවාසී
benthonic=නිතල | නිතලවාසී
benthophyte=අගාධශාකය
benthos=නිතල වාසීහු | නිතලවාසිහු | බෙන්තෝස් | මුහුදු පත්ලෙහි ඇති ශාක හා සත්ව වර්ග | මූදු පතුලේ වියා | මූදු පතුලේ ශාකය
bentname=බෙන්ට්නේම්
bentonite=බෙන්ටොනයිට්
bentwood=කවාකාරව නවන ලද ලී දජු
benumb=දුර්වල කරනවා | පණ නැති කරනවා | වේදනාව නොදැනීමට සලසනවා | සතම්භනය කිරීම | සිරි වැටෙනවා | හිරිවැටීමට සලසනවා | හිරිවැටෙනවා
benumbed=ඇඟ හිරි වැටී | හිරි වැටුණු
benus=ඉරබටු තරුව
benzene=බෙන්සීන් | රට ඉඟුරුවලින් පෙරාගන්නා ලද ද්‍රවයක්
benzenoid=බෙන්සිනොයිඩ්
benzenyl=බෙන්සිනිල්
benzine=පෙට්‍රෝලියම්වලින් ලබාගන්නා ස්ප්‍රීතු විශේෂයක්
benzoin=කට්ටකුමංජල් | ගසකින් ලබාගන්නා සුවඳැති රෙසිනයක් | බෙන්සොයින්
benzol=බෙන්සොල් | බෙන්සෝල් | ශුද්ධ නොකරන ලද බෙන්සීන්
benzole=බෙන්සෝල්
benzoline=බෙන්සොලීන්
beprotected=රක්ෂා වෙනවා
bequeath=උරුම වශයෙන් පවරනවා | උරුම වශයෙන් පැවරීම | දේපළ හිමි කර දෙනවා | පරික්ථ කරනවා | පවරනවා | රික්ථවාරණය කරනවා | රික්ථවාරනය කරනවා
bequest=අන්තිම කැමති පත්‍රයෙන් කරන පැවරීම | අන්තිම කැමැත්තෙන් කරන පැවරීම | උරුමය | පරික්ථනය | පරික්ථය | පැවරීම | රික්ථවරණය | රික්ථවාරණය
berate=බණිනවා | බැණ වදිනවා | බැණවදිනවා
berbally=වචනානුසාරයෙන්
berber=උතුරු අප්‍රිකානු භාෂාව | උතුරු අප්‍රිකානු වැසියා
berceuse=දරු නැලවිලි ගී
berdache=බර්ඩාෂ්චාරය | බර්ඩෑෂයා
bereave=අභාවයට යනවා | අහිමි වෙනවා | ඉවත් කරනවා | තොර කරනවා | පැහැර ගන්නවා | වියෝ වෙනවා | වියෝග කරනවා
bereaved=තොර වූ | මරණයෙන් දුකට පත්
bereavement=මරණය | වයිධූර්යය | වියෝ වීම | වියෝගය
bereft=අසරණ | තුරන් වූ | තොර | බලාපොරොත්තු හීන වූ | වියෝග | වියෝබවට පැමිණි
beret=කුඩා හිස්වැස්ම | හිස්වැස්ම
berg=කන්ද
bergamot=සුවඳැති ශාක විශේෂයක්
berginization=බෙන්සිල්කරණය
beri-beri=බැරි බැරියාව
beriberi=බැරි බැරියා රෝගය
berk=අමනයා | මෝඩයා
berkeleianism=බංක්ලියානුවාදය
berkelium=විකිරණශීලී කෘත්‍රිම ලෝහමය මූලද්‍රව්‍යයක්
berm=ගැටිය | තට්ටුව
berry=දං වැනි ගෙඩියක් | දම් වැනි ගෙඩියක් | බදරිය
berserk=ක්‍රෝධයෙන් උමතු වූ | ක්‍රෝධෝන්වාදිත | කිපුණු
berth=තනතුර | නැංගුරම්පළ | නැවක යහන | නැව් ලැගුම | නිදන මැදිරිය | මිරියක යහන | යහන් නියම කරනවා | රක්ෂාව | රක්ෂාව කරන ස්ථානය | රක්ෂාවක පිහිටුවනවා | රැකියාව
berthing=නැංගුරම්පළ | නැවතුම්පළ
bertzcell=යෝධ සෛලය
bervitus=වහල් භාවය
beryl=ගෝමේද | බෙරිල් | වෙරළුමිණ | වෙරළුමිණි | වේළුරිය | වෛදූර්ය
beryllium=බෙරිලියම් | සුදු පැහැති ලෝහමය මූලද්‍රව්‍යයක්
bery=පච්චපඩියම්
beseech=අයදිනවා | ඉල්ලනවා | උදක් ඉල්ලා සිටිනවා | කන්නලව් කරනවා | ප්‍රයාචනය කරනවා | පෙරැත්තය | යදිනවා
beseeching=අයදින | ඉල්ලන
beseechment=කන්නලව්ව | ප්‍රයාචනය
beseem=ඔබිනවා
beset=අවහිර කරනවා | ආකුල | තර්ජනය කරනවා | පීඩිත | වට කරනවා | වෙළුණු
besetting=නිතර පීඩා කරන | බේරිය නොහැකි
beshrew=හෙන ගහපන්
beside=අමතර තවද | අසල | කිට්ටු | බාහිර වූ | වෙන | සමව | සමීපයෙහි | හැර | ළඟ
besides=අමතරව | ඇරත් | ඒ ඇරත් | තවද | පමණක් නොව | යළිත් | වැඩිමනත් | හැර
besiege=රැස් කකා තෙරපනවා | වට කරනවා | වටකර ගන්නවා | වටලනවා
besmear=අපිරිසිදු කරනවා | ආලේප කරනවා | කිලිටි කරනවා | කිළිටි කරනවා | තවරනවා
besmirch=කිළිටි කරනවා | දුර්වර්ණ කරනවා
besom=ඉදල | ඉලාත | බෝලත්ත | මුස්න
besotted=අඥ | නිතර මත්පැන් බොන | මත් වූ | මුග්ධ | මෝඩ
besought=අයැදියා | ඉල්ලුවා
bespangle=දිලිසෙන දෙයින් සරසනවා
bespangled=වැඩ දමා | සරසා
bespatter=කුණු ආදිය ඉසිනවා | ද්‍රවයක් ඉසිනවා | බැණ වදිනවා
bespattered=පැල්ලම් සහිත | බැණ වැදුණ
bespeak=කලින් කථා කර ගන්නවා | කලින් කථාබස් කරගන්නවා | දක්වනවා | යෝජනා කරනවා | සාධක වෙනවා
bespectacled=උපැස් පැළඳි | කණ්ණාඩි පැළඳි
bespoke=දැක්වූ | නියමිත පරිදි නිම කළ
bespoken=කලින් නියම කරගත්
bessermerisation=බෙසමරීකරණය
best=ඉතා හොඳ | ඉතා හොඳ දේ | ඉතා හොඳින් | ඉස්තරම් | ඉහළම දෙය | ඉහළම පුද්ගලයා | ඉහළින් | උත්කෘෂ්ට | උත්තම | උතුම් | පරදනවා | ප්‍රශස්ත | විශිෂ්ට | විශිෂ්ට දෙය | විශිෂ්ට පුද්ගලයා | විශිෂ්ට ලෙස | ශ්‍රෙෂ්ඨ | සර්වශ්‍රේෂ්ඨ
best-house=තානායම
best-seller=විශාල වශයෙන් විකිණෙන පොත
bestead=සහාය වෙනවා
bested=පිහිටි
bestial=තිරිසන් | මෘග | මෘගයෙකු වැනි
bestiality=තිරිසන් කම | තිරිසන්කම | පශු මෛථුනය | මෘගතාව
bestiary=පුරාණ කථා සංග්‍රහය
bestir=උනන්දු කරනවා | ක්‍රියාශීලි වෙනවා
bestow=තැන්පත් කරනවා | ප්‍රදානය කරනවා | පාවා දෙනවා | පිරිනමනවා | යොදනවා
bestowal=ප්‍රදානය | පාවා දීම | පාවාදීම
bestrew=අතුරනවා | ඉසිනවා
bestride=යමක් හරහ යනවා | හරහ වාඩි වෙනවා
bet=ඔට්ටම | ඔට්ටු අල්ලනවා | ඔට්ටුව | තරක් වෙනවා | පරදුව
beta=ග්‍රීක හෝඩියේ දෙවෙනි අකුර | බීටා
betake=එළඹෙනවා | පැමිණෙනවා | යෙදෙනවා
betatron=ඉලෙක්ට්‍රෝනවල ත්වරණය වැඩි කරන උපකරණය | බීටාට්‍රෝනය
betel=තාම්බූල | දැහැත් | බුලත්
betel-nut=පුවක්
betel-server=වට්ටාව
betel-tray=ඉලත්තට්ටුව
bethink=මතක් කර ගන්නවා | සිහියට නඟනවා
betide=සිද්ධ වෙනවා
betimes=උදෑසනම | කල් ඇතුව | කල්තබා | වේලාසනින්
betoken=දක්වනවා | නිමිති වලින් දක්වනවා | නිමිති වලින් දැක්වෙනවා | යෝජනා කරනවා | සංඥා වශයෙන් දැක්වෙනවා | සංඥාවශයෙන් දක්වනවා | සලකුණක් වෙනවා
beton=කොන්ක්‍රීට්
betony=දම්පාට මල් ඇති ශාකයක්
betray=ද්‍රෝහීව පාවා දෙනවා | පාවා දෙනවා | විශ්වාසය කඩ කරනවා
betrayal=පාවා දීම | පාවාදීම
betrayer=පාවා දුන් තැනැත්තා
betro=බෙට්‍රෝව
betroth=විවාහ ගිවිසිනවා | සරණ ගිවිස ගන්නවා
betrothal=විවාහ ගිවිස ගැනීම | විවාහ ගිවිසගැනීම
better=ඔට්ටු අල්ලන්නා | තරමක් සුව වූ | වඩා හොඳ | වඩා හොඳ දෙය | වඩා හොඳ වෙනවා | වඩා හොඳින් | වැඩිදියුණු කරනවා
betterment=අභ්‍යදය | අභිවෘද්ධිය | ප්‍රතිලාභ | ප්‍රතිලාභ බද්ද | වැඩිදියුණුව
betting=ඔට්ටු ඇල්ලීම | ඔට්ටුඇල්ලීම | පරදු තැබීම | රේස් තිප්පොල
bettor=ඔට්ටු අල්ලන්නා
betty=අලවංගුව
betulin=බෙටුලින්
between=අතර | අන්තර | අස්සෙහි | අස්සේ | තුළ | මධ්‍යයෙහි | මැද
betwixt=අතර | අතරතුර | මධ්‍යයෙහි
beutiful=කල්
bevatron=බීවාට්‍රෝනය
bevel=ඇල හැඩය | ඇලය | පට්ටම
bevelled=ඇල වූ
bevelling=පට්ටම් ගෑම | පට්ටම් වැටීම
beverage=පානය | පානීය | බීම
bevy=කණ්ඩායම | ගණය | සමූහය
bewail=වැලපෙනවා | වැළපෙනවා | විලාප කියනවා
beware=කල්පනාවෙන් සිතනවා | පරෙස්සම් වෙනවා | බලා ගන්නවා
bewilder=අවුල් වෙනවා | කලබල වෙනවා | සිත අවුල් කරනවා
bewildered=අවුල් වූ | වික්ෂිප්ත | සිහි විකල වූ
bewildering=කලබල වීම | සිත අවුල් වීම
bewilderment=අවුල | කලබලය | සම්මෝහය
bewitch=කොඩිවින කරනවා | මායාකරණය කරනවා | මෝහන කරනවා | මෝහනය කරනවා | වශී කරනවා | සිත් ඇදගන්නවා
bewitching=මනෝහර | වශී කරන
bewitchment=මායාකරණය
beyond=අධි | ඈත | ඉක්මවා යන | එපිට | එහා | එහාට | ඔබ්බට | පිටත | වඩා
bezel=ඇල මුවාත | හැඩ වූ අගක් ඇති නියනක්
bezique=දෙදෙනෙකු අතර කෙරෙන කාඩ් සෙල්ලම
bezoar=ගෝරෝචන
bhairavas=බහිරව රූප
bhang=කංසා | කංසා පැලය | ගංජා
bhikhu=භික්ෂුණී
bhikkhu=භික්ඛු | භික්ඛුණී | භික්ෂු | මහණ | මෙහෙණ | මෙහෙණිය | යති | යතිඳු | සංඝ | සඟ | සඟු | හිමිනම
bhikkhy=සාමඤ්ඤ
bi-annual=අර්ධ වාර්ෂික | අර්ධ වාර්ෂිකය | අර්ධවාර්ෂික | දෑවුරුදු
bi-aquo=ද්විඋදක
bi-indusiate=ද්විඉන්දුසික | ද්විකසු
bi-monthly=ද්විමාසික | ද්විමාසිකය
biachaenium=ද්විචර්මලය
biacuminate=ද්විඅතිතීව්‍ර
biangulate=ද්විකෝණික
biannual=අර්ධවාර්ෂික | අවුරුද්දකට දෙවරක් | ද්විවාර්ෂික
biaruculate=ද්විසන්ධාන
bias=අගතිගාමී වෙනවා | අගතිය | අනුශය | අභිනතිය | නැඹුර | නැඹුරුතාව | නැඹුරුව | පක්ෂපාතිත්වය | පක්ෂභජනය | පක්ෂභජනය ඇති කරනවා | පැත්තක් ගන්නවා | මතිග්‍රාහය | හිත දූෂ්‍ය කරනවා
biased=අගති සහිත | නැඹුරු | පක්ෂග්‍රාහී | පක්ෂපාතී
biassed=අගති සහිත | අභිනත | පක්ෂපාතී
biauriculate=ද්විකර්ණික
biauritus=ද්විකර්ණික
biaxial=ද්වි ආක්ෂක | ද්විආක්ෂක | ද්විආක්ෂය
bib=බරොත්තිය
bib-cock=නැමුණු කටක් ඇති වතුර පයිප්පය
bibasic=ද්විභාස්මික
bibiliography=පුස්තක නාමාවලිය
bible=ක්‍රිස්තියානීන්ගේ ධර්ම පුස්තකය | බයිබලය
biblical=බයිබලය හා සම්බන්ධ
biblio=ග්‍රන්ථප්‍රකාශන සටහන
biblioclasm=ග්‍රන්ථනාශය
biblioclast=ග්‍රන්ථනාශක
bibliogenesis=ග්‍රන්ථනිෂ්පාදනය
bibliographer=ග්‍රන්ථනාමාවලිකාරක | ග්‍රන්ථනාමාවලී සංස්කාරක | ග්‍රන්ථවිද්‍යාඥයා
bibliographical=ග්‍රන්ථනාමාවලී
bibliographize=ග්‍රන්ථනාමාවලිකරණය
bibliography=ග්‍රන්ථ නාමාවලිය | ග්‍රන්ථ ලේඛනය | ග්‍රන්ථනාමාවලිය | ග්‍රන්ථවිද්‍යාව | පොත්පත් පිළිබඳ තොරතුරු | ලේඛන නාමාවලිය
bibliolater=ග්‍රන්ථ අභිවන්දක
bibliolatry=ග්‍රන්ථ අභිවන්දනය | ග්‍රන්ථාභිවාදනය
bibliologist=ග්‍රන්ථවේදී
bibliology=ග්‍රන්ථවේදය
bibliomania=ග්‍රන්ථෝන්මාදය
bibliomaniac=ග්‍රන්ථ උන්මත්තක
bibliopegist=පොත් බැඳුම් කලාකරු
bibliophile=ග්‍රන්ථ අනුරක්තක | ග්‍රන්ථ අභිරෝචක | ග්‍රන්ථප්‍රියයා | පොත්ගුල්ලා
bibliophobia=ග්‍රන්ථ භීතිකාව | ග්‍රන්ථභීතිකාව
bibliopole=දුර්ලභ ග්‍රන්ථ වෙළෙන්දා
bibliopolism=දුර්ලභ ග්‍රන්ථ වෙළඳාම
bibliothecar=පුස්තකාලයාධිකාරී
bibliothecarian=පුස්තකාලයාධිකාරී
bibracteate=ද්විනිපත්‍රී
bibracteolate=ද්විනිපත්‍රිකා
bibulous=උරාගන්න | පිපාසා ඇති | පිපාසිත | බේබදු | සුරාසොඬ | සූරාසොඬ
bicameral=ද්වි මණ්ඩල | ද්විමණ්ඩල
bicarbonate=බයිකාබනේට්
bicarinate=ද්විනෞතල
bicarpellary=ද්විඅණ්ඩප | ද්විකාපල | ද්විකාපලීය | දෙපියලි | දෙපෙති
bicarpellate=ද්විඅණ්ඩප | ද්විකාපල
bicellular=ද්විසෛලික
bicentenary=ද්වි ශත වාර්ෂිකය
bicentennial=ද්වි ශත වාර්ෂික | ද්විශතවාර්ෂික
bicenternary=ද්විශතවාර්ෂිකය
bicephalous=හිස් දෙකක් ඇති
biceps=ද්විමූර්ධය | ද්වීමූර්ධකය | බාහුවෙහි මස්ගොබය
biciliate=ද්විපක්ෂ්මිය
bicimal=ද්විමය
bicker=කැඳ බඳුන | නිකරුණේ කලහ කරනවා | නිකරුණේ කලහා කරනවා | මත්පැන් බඳුන
bicollateral=ද්විසංලග්න
bicompact=ද්විසුසංහිත
bicompactum=ද්විසුසංහිතාව
biconcentric=ද්විසංකේන්ද්‍රික
biconditional=ද්විකොන්දේසික
biconjugate=ද්වියුග්මක
bicorn=ද්විශෘංගය
bicornis=ද්විශෘංග
bicornuate=ද්විශෘංග
bicotyledonary=ද්විකොටීල | ද්විබීජපත්‍රික
bicrenate=ද්විසභංග
bicultural=ද්විසංස්කෘතික
biculturalism=ද්විසංස්කෘතිතාව
bicuspid=ද්විතුණ්ඩ | දෙතුඩු
bicuspidate=ද්විතුණ්ඩ
bicycle=පාපැදිය | බයිසිකලය
bicyclist=පාපැදිකරුවා | බයිසිකලයක් පදින්නා
bid=අණ කරනවා | ආචාර කරනවා | ආඥාව | ඉදිරිපත් කරනවා | ඉල්ලනවා | ඉල්ලීම | ඉල්ලූ ගණන | උදක් කැඳවනවා | කැඳවීම | නියම කළ ගණන | මහත් ප්‍රයත්නය | ලංසු තබනවා | ලංසුව | වෙන්දේසියේ ඉල්ලීම
biddable=ඉල්ලිය හැකි
bidder=ඉල්ලන්නා | ලංසු ඉල්ලන්නා | ලංසු තබන්නා
bidding=ලංසු තැබීම
biddy=මැහැල්ල
bide=ඉවසිල්ලෙන් බලාපොරොත්තු වෙනවා | කල් බලනවා | වෙලාව බලා ඉන්නවා
bidentate=ද්විදන්තුර
bidet=මිටි වැසිකිළි පෝච්වය | සාධන කාමරයේ බේසම
bidigitatus=ද්විආංගුලික
bidimensional=ද්විමාන
bidirectional=දැත් | දෙ අත්
biedermeierstil=බීඩමයර් ශෛලිය
bief=සං
bienayeme=බියෙනෙයිම්
biennial=ද්විපාර්ශ්වික | ද්විවාර්ෂකය | ද්විවාර්ෂික | ද්විවාර්ෂිකය
bier=තූම්බය | දරහැව | මිනී ගෙනයන දෙණ | මිනී ගෙනයන මැස්ස | මිනීමැස්ස | රන්සිවි ගෙය
biface=දෙපැති
bifacial=ද්විමුඛ | දෙවත්
bifactor=ද්විසාධක
bifarious=ද්විපංක්තික
bifer=ද්විධරය
biferae=ද්විධරයෝ
biferous=ද්විධර
biff=තද පහර | පහර දෙනවා | මිට මොළවා දෙන පහර
bifid=ද්විහින්න | දිග විවරයකින් දෙකට බෙදුණු
bifidate=ද්විහින්න
bifilar=ද්විසූත්‍ර
bifiorate=ද්විපුෂ්පී
bifiorous=ද්විපුෂ්පී
bifocal=ද්විනාභීය | දුර හා ළඟ පෙනෙන
bifoliate=ද්විපත්‍රී
bifollicular=දෙවරා
bifolliculus=දෙවරාව
bifooted=දිපද
biforate=දෙසිදුරු
biformis=ද්විරූපී
biforns=ද්විපෘෂ්ඨ
biforous=දෙසිදුරු
bifurcate=දෙකට බෙදෙනවා | දෙබල් | දෙබල් හැදෙනවා | දෙබිඩි | බෙදෙනවා
bifurcation=කරුව | ද්විභේදනය | දෙකට බෙදීම | දෙබල | දෙබල් කිරිම | දෙබල්වීම
big=තඩි | තුමුල | මහ | මහත් | මහා | ලොකු | වැදගත් | විපුල | විශාල
big-headed=ඔළුව ඉදිමුණු
bigamy=ද්විවිවාහය | ද්වීවිවාහය
bigeminate=ද්වියුග්මක
bight=උපසාගරය | දුනු බොක්ක | බොකටිය | ලණු පුඩුව | වරාය
bigit=ද්ව්‍යංකය
biglandular=ද්විග්‍රන්ථීක
biglumis=ද්විතුෂ
bigness=කෙරුමා | ලොක්කා
bigot=ආධානග්‍රාහියා | ස්වමතාසක්තයා
bigoted=ස්වමතාසක්ත
bigotry=අභිනිවේශනය | ස්වමතාසක්ත භාවය
bigwig=කෙරුමා | ලොක්කා | වැදගතා
bihilatus=දෙකැලැල්
bijection=සමක්ෂේපණය
bijou=ක්ෂුද්‍රභූෂණය | කුඩා මැණික | කුඩා මෙන්ම මනහර
bike=පාපැදිය | බයිසිකලය | යතුරුපැදිය
bikini=කාන්තා නාන ඇඳුම
bilamellar=ද්විපට්ට
bilamellate=ද්විපට්ට
bilateral=උභය පාර්ශවික | උභය පාර්ශ්වික | ද්විපාරශ්වික | ද්විපාර්ශවික | ද්විපාර්ශ්වික | ද්විපාර්ශ්වික | ද්විපාර්ශ්වීය | පක්ෂ දෙකක් ඇති
bilateralism=ද්විපාර්ශ්විකතාව | ද්විපාර්ශ්වීයතාව
bilaterality=ද්විපාර්ශ්විකතාව
bilberry=යුරෝපීය ශාක විශේෂයක්
bile=පිත | පිත්ත | බඳුන
bilge=නැව් පතුල | පළලම කොටස | පීප්පයක බණ්ඩිය | පීප්පයක බන්ඩිය
bilharzia=පණුවන් නිසා ශුෂ්ක රටවල ඇති වන රෝගයක්
biliary=පිටතට සම්බන්ධ | පිත්ත
bilind=අන්ධ
bilineal=ද්විපාර්ශ්වික
bilinear=ද්ව්‍රේඛීය | ද්විරේඛය | ද්විරේඛීය
bilinearity=ද්විරේඛීයතාව
bilingual=ද්විභාෂා | ද්විභාෂික | ද්විභාෂී | දෙබස්
bilingualism=ද්විභාෂාත්වය
bilious=පිත්තාධික | පිත්බර
bilk=මඟ හරිනවා | මඟහරිනවා | රවටනවා | වංචා කරනවා
bill=අයපත | කෙටුම්පත | කෙටුම්පත් පනත | තුඩ | තුණ්ඩය | තොල්ගානවා | දැන්වීම් පත්‍රය | නියම කර ගන්නවා | පටු තුඩුව | පටුතුඩුව | පනත | පනත් කෙටුම්පත | ප්‍රසිද්ධ කරනවා | බඩු ගණන් ලේඛනය | බිල | බිල්පත | මිල සටහන | මිල සටහන් කරනවා | යෝජිත පනත | ව්‍යවස්ථා කෙටුම්පත | වාර්තාව | සහතිකය | සොට | හොට | හොටය
bill-board=දැන්වීම් පුවරුව
billabong=බිලබොං
billboard=වෙළඳ දැන්වීම් සඳහා එළිමහනේ ඇති පුවරුව
billet=තුණ්ඩුව | පත්‍රය | භට නවාතැන | රක්ෂාව | ලෝහ යෂ්ටිය
billets=යකැටිති
billhook=නැමුණු තලයක් ඇති ආයුධය
billiards=බිලියඩ් ක්‍රීඩාව | බෝල මේඝ ක්‍රීඩාව | බෝල මේස ක්‍රීඩාව
billion=ප්‍රකෝටිය | බිලියනය | සංඛ්‍යාවක් | සිය කෝටිය
billow=ඌර්මි | මහා තරංගය | මහා රැල්ල | රලපතර
billowy=තරංග සහිත
billposter=පුවරුවල දැන්වීම් අලවන්නා
billy=කූඩාරම්වල උයන භාජන විශේෂයක් | මිත්‍රයා
billy-goat=එළුවා
billygoat=එළුවා
bilobate=ද්විඛණ්ඩිකීය
bilobed=ද්විඛණ්ඩිකීය
bilocality=ද්විප්‍රදේශ
bilocellate=ද්විකෝෂ්ඨ
bilocular=ද්විකෝෂ්ඨ
bilomentum=ද්විසලාකිතය
biltong=වේළූ ලුණු මස් තීරුව
bimaculate=දෙලප
bimestris=දෙමස්
bimetal=ද්විලෝහ
bimetalism=ද්විලෝහතාව
bimetallic=ද්විලෝහක | දිවිලෝහ | ලෝහ දෙකකින් සෑදුණු
bimetallism=ද්විලෝහතාව
bimodal=ද්විමාත | ද්විමාන
bimodality=ද්විමාතිය
bimolecular=ද්විඅණුක
bimonthly=ද්විමාසික
bimus=දෙවස්
bin=අටුව | පෙට්ටගම | බඩු පෙට්ටිය | බඳුන | රාක්ක පෙට්ටිය | විශාල පෙට්ටිය
bin,clay=මැටි ඔරුව
binary=ද්ව්‍යංගී | ද්වි | ද්විමය | දෙ | යුග්ම
binate=ද්විත්ව
binationalism=ද්විජාතිකවාදය
binato-pirnatus=ද්විපක්ෂවත්
binaural=ද්විකර්ණික | ද්විකර්ණික ස්පන්ද | ශබ්දය කන් දෙකටම වෙන වෙනම ඇසෙන්නට සලස්වන
bind=ආබද්ධකරණය | ඇඟ බැදීම | ගැට ගසනවා | බන්දනවා | බඳනවා | බඳිනවා | බැඳගන්නවා | බැඳෙනවා | හිර කරනවා
bind-over=ඇඟ බඳිනවා
bind-weed=ගිරිතිල්ල ජාතියක්
binder=පොත් බඳින්නා | පොත් බැඳුම්කරු | පොත් බැඳුම්කරුවා | බද්ධකය | බන්ධකය | බඳනය | බඳපටිය | බඳින පටිය | බඳින්නා | සම්බන්ධකය
bindery=පොත් බැඳුම්හල
binding=අනුගම්‍ය | පටිය | පොත් බැඳීම | බන්දනය | බන්ධකය | බන්ධනය | බලපාන | බැඳ තබන | බැඳීම | බැඳෙන | බැම්ම | ස්ථීර
bine=ශාකයක දඟර ගැසුණු දණ්ඩ
binervate=දෙනාරටි
binge=අඩි ගැසීම | බඩජාරිකම | සිත් සේ සුරාබීම
bingo=ක්‍රීඩාව | බ්‍රුන්ඩි
biniflorus=යුගපුෂ්පී
binnacle=නැවේ මාලිමා යන්ත්‍රයේ වැස්ම
binocular=ද්විනේත්‍ර | ද්විනේත්‍රික | දූරදර්ශකය | දෙනෙති | දෙනෙතිය
binoculars=ද්විනේත්‍ර කණ්ණාඩිය | දූරදර්ශකය | දෙනෙතිය
binomial=ද්වි පද | ද්විපද | ද්විපදය
binormal=අපර අභිලම්බය
binoxide=ඩයොක්සයිඩ්
bint=කාන්තාව
binuclear=ද්වින්‍යෂ්ටික
binucleate=ද්වින්‍යෂ්ටික
binucleolate=දිවින්‍යෂ්ටිකාමය
bio=ජෛව
bio-data=පුද්ගල දත්ත | වතගොත
bio-osmotic=ජෛවාස්‍රතික
bioanalysis=ජෛව විශ්ලේෂණය
bioassay=ජෛවාර්ඝණය
biobibliography=කර්තෘ අපදාන නාමාවලිය
biocatalyst=එන්සයිම | ජෛවෝත්ප්‍රේරකය
biocellate=දිවිප්‍රාගක්ෂික
biocenesis=ජීව ප්‍රජාව | ජීවසහතාව
biocharacter=ජෛවලක්ෂණය
biochemical=ජෛවරසායනික | ජෛවරසායනික
biochemist=ජෛවරසායනඥයා,ජෛවරසායනවිද්‍යාඥයා
biochemistry=ජීව රසායන විද්‍යාව | ජෛවරසායන විද්‍යාව | ජෛවරසායනය | ජෛව රසායන විද්‍යාව | ජෛවරසායනවිද්‍යාව
biochore=සමජෛවවාසය
biocoenesis=ජීව ප්‍රජාව | ජීවසහතාව
biocoenose=ජීවප්‍රජාව
biocoenosis=ජෛවප්‍රජාව
biocolloid=ජෛව කලිලය | ජෛවකලිලය
bioculture=ජෛව සංස්කෘතිය
biodegradable=ක්ෂුද්‍ර වීන් නිසා විනාශයට පත් වන
biodynamics=ජෛවගති
bioelement=වක මූලද්‍රව්‍යය
bioengineering=ජෛව ඉංනේරු විද්‍යාව
biogenesis=ජීවාජ්ජනනය | ජෛවඥනය | ව පදාර්ථවලින් පමණක් අනෙක් ව පදාර්ථ සැදේය යන ක | වජ්ජනනය
biogenetic=ජීවාජ්ජනක
biogenic=වජනක
biogenous=ජෛවස්ථ
biogeochemistry=ජෛව භූරසායන විද්‍යාව
biogeographic=ජෛවභූගෝලීය
biogeography=ජෛව භුගෝල විද්‍යාව
biographer=අපදාන කර්තෘ | චරිතකථාකරුවා | වන චරිත කර්තෘ
biographic=අපදාන පාත්‍රක | චරිතකථාමය
biographical=චරිත කථාමය
biography=අපදානය | අවදානය | චරිතකථාව | චරිතාපදානය | චරිතාවදනය | ජීවන චරිතය | ජීවිත කතාව | ජීවිත කථාව | වන චරිතය | වලේඛනය | සිරිත
biological=ජෛව | ජෛව විද්‍යාව පිළිබඳ | ජෛවවිද්‍යාත්මක
biologism=ජීවවිද්‍යා කරණය
biologist=ජීවවිද්‍යාඥයා | ජෛවවිද්‍යාඥයා
biology=ජීව විද්‍යාව | ජීවවිද්‍යාව | ජෛව විද්‍යාව | ජෛවවිද්‍යාව
bioluminescence=ජෛව සන්දීප්තිය | වප්‍රකාශය | ශරීරයෙන් පිට වන එළිය
biolytic=ජෛවජාරක
biome=ජෛව දර්ශය | බියෝම
biometrical=ජෛවමිතික
biometrician=ජෛවමිතඥයා
biometry=ජීවමිතිය | ජෛවමිතිය |  ජෛවමිතිවිද්‍යාව
biomolecule=ජෛවාණුව
biomone=ජෛවාංශුව
bion=ජීවියා
bionergy=ජෛවශක්තිය
bionic=යාන්ත්‍රික ශරීරාංග ඇති
bionomics=ජෛව පරිසර අධ්‍යයනය | ජෛව පරිසර විද්‍යාව | ජෛවාර්ථීක විද්‍යාව | ජෛවපරිසරවිද්‍යාව
bionomy=ජෛවවිභාගය
biont=ජීවියා
biophage=ජෛවභක්ෂකය
biophagous=බැක්ටිරියා භක්ෂක
biophore=ජෛවාංශුව
biophoric=ජීවධර
biophysics=ජෛවභෞතික විද්‍යාව | ජෛවභෞතිකය | ව භෞතික විද්‍යාව | වභෞතිකවිද්‍යාව
bioplasm=ජෛවප්ලාසමය | ප්‍රාක්ප්ලාස්මය
bioplasmatic=ප්‍රාක්ප්ලාස්මීය
bioplason=ප්‍රාක්ප්ලාස්මය
bioplast=ජෛවලවය
biopsy=වාණු පරීක්ෂණය | ශරීරයේ පටක විශ්ලේෂණය
biopsychic=ජෛව චෛතසිකය
biopsychology=වමනෝවිද්‍යාව
biorhythm=ව රිද්මය | වතාලය
biorization=ජෛව පැස්ටරීකරණය
biorthogonal=ද්වි ප්‍රලම්බ
biorthogonalization=ද්විප්‍රලම්බනය
bios=බියොස්
bioscope=ජෛවත්‍රපටය
biosocial=ජෛව සාමාජීක
biosociologic=ජෛව සාමාජ විද්‍යාත්මක
biosociology=ජෛව සමාජ විද්‍යාව
biosphere=ජෛව ගෝලය | ජෛවගෝලය | ව ස්තරය
biospheric=ජෛව ගෝලීය
biostatistics=ජීව සංඛ්‍යාති | ජීවි සංඛ්‍යාති
biosynthesis=ජෛව සංශ්ලේෂණය
biota=ජෛව සමුද්‍රය
biotechnology=ජෛවතාක්ෂණවිද්‍යාව
biotic=ජෛව | ජීවිතයට සම්බන්ධ
biotin=බයටින් | බයොටීන් | බිත්තරවල ඇති විටමිනයක්
biotite=බයෝටයිට්
biotope=ජෛවස්ථානය
biotype=ජීව වර්ග | ජීවදර්ශය
biovular=ද්විඅණ්ඩජ
biparous=ද්විජායි | ද්විජායී
bipartisan=ද්විපක්ෂ | පක්ෂ දෙකක් අතර
bipartite=කොටස් දෙකින් යුක්ත | ද්විපාර්ශ්වික | ද්විභාක
biparty=ද්විපක්ෂ
bipectinate=ද්විකංකත
biped=දෙපය ඇති | දෙපාවා
bipedal=දෙපා
bipetalous=ද්විදල
biphase=ද්විකලා
bipinnate=ද්විපක්ෂවත්
bipinnatifid=ද්විමිතපක්ෂ
bipinnatiparted=ද්විමිතපක්ෂ
bipinnatisect=ද්විපක්ෂච්ඡේද
biplane=අත්හැඳි තට්ටු දෙකක් ඇති ගගන යාත්‍රාව
biplicate=දෙපට වැටුණු
bipolar=අග්‍ර දෙකක් ඇති | ද්විධ්‍රැව | ද්විධ්‍රැවිය | ද්විධ්‍රැවීය | ද්වීධ්‍රැව | දෙදු | දෙදූ
bipolarity=ද්වීධ්‍රැවීයතාව
bipole=ද්විධ්‍රැවය
biporose=දෙසිදුරු
biprism=ද්වි ප්‍රිස්මය
bipunctate=දෙලප
biquadratic=ද්විවර්ගජ | ද්විවර්ගජය | ද්විවර්ගීය
biquartz=දෙතිරුවාණය
biquinary=ද්විපංචමය
biradiate=ද්විඅරීය
biramous=ද්විශාඛ
birch=බර්ච් ඉපලකින් තළනවා | මූර්ජ ශාකය | ශීතාදික රටවල වැවෙන ගස් වර්ගයක්
birching=වේවැල් පහර දීම
bird=අණ්ඩජ | කුරුල්ලා | දද | ද්විජ | දිජ | පක්ෂියා | ලිහිණියා | විහග | විහඟ | ශකුන | සියොත් | සෙළි | ළිහිණි | ළිහිණියා
bird-cage=කුරුලු කූඩුව
bird-footed=පාදාභ
bird-lime=කොහොල්ලෑ
bird-seed=පක්ෂීන්ට දෙන ධාන්‍ය
birdcaging=කූඩු වැටීම
birdsmouth=අලුප්පුව
birectification=විශෝධනය
birefractive=ද්විවර්ති
birefringence=ද්විවර්තනය | ද්විවර්තනය
birotation=භ්‍රමණ විකෘතිය
birth=ආත්මභාවය | ඉපදීම | උත්පත්තිය | උද්භවය | උපත | උපත් | උප්පැන්නය | ජන්මය | ජම්මය | ජාතක | තෙමඟුල | ප්‍රභවය | ප්‍රසූතිය | මූලාරම්භය | වංශය | සම්භූතිය | හට ගැනීම
birth-control=උපත් පාලනය | ප්‍රතිසන්ධිය වැළැක්ම
birth-mark=උපන්ලපය
birth-place=උපන් තැන
birth-rate=උපත් අනුපාතිකය
birth-right=සහජ උරුමය
birthday=උපන් දිනය | උපන්දින | ජන්ම දිනය | ජන්මෝත්සවය
birthmark=උපන්ලපය
birthright=ජන්ම අයිතිය
bisaccate=ද්විකෝෂීය
biscuit=ඔප නොදැමූ පිළිස්සූ මැටි භාණ්ඩය | වරක් පැලහූ | විස්කෝත්තුව | විස්කෝතු | විස්කෝතුව
biscuits=විස්කෝතු
bise=බයිස් සුළං
bisect=දෙකට බෙදනවා | දෙපළු කරනවා | පර්ච්ඡේදනය | සමච්ඡේද කරනවා | සමච්ඡේදනය කරනවා | සමච්න්න
bisecting=සමච්ඡේදනය කිරීම
bisection=සමච්ඡේදනය | සමච්ඡේදය
bisector=ද්විභාජකය | සමච්ඡේදකය
bisectrix=සමච්ඡේදකය
biseptate=ද්විආවාරක
biserial=ද්විශ්‍රෙණි | ද්විශ්‍රේණි
biseriate=ද්විපංක්තික
biserrate=ද්විකරපත්‍රික
bisetose=ද්විශුල
bisetous=ද්විශුල
bisexual=ද්විලිංගික | ද්විලිංගිකය | දිවිලිංගික
bisexuality=ද්විලිංගිකතාව
bishop=නායක දේවගැති තැන | පූජාප්‍රසාදිතැන | රාජගුරු
bishopric=පූජාප්‍රසාදිතැනගේ පදවිය
bisimal=ද්විම
bismuth=බිස්මත් | ලෝහ වර්ගයක්
bismuthine=බිස්මතීන්
bismuthite=බිස්මතයිට්
bison=කුළු හරක් වර්ගයක් | කුළුහරකා | ගවරා
bispinose=ද්විකණ්ටක
bisporangiate=ද්විබීජාණුධානික
bisporous=ද්විබීජාණුක
bisque=ක්‍රීඩාවලදී ලැබෙන අතිරේක ලකුණ
bissextile=අධිමාස වර්ෂය | අධිවර්ෂීය
bistable=ද්විස්ථායි | ද්විස්ථායී
bistelic=ද්විසථුණ
bisteo=කුඩා කෝපි කඩය
bistipular=ද්විඋපපත්‍රී
bistipulate=ද්විඋපපත්‍රී
bistrate=ද්විස්තර
bistratose=ද්විස්තර
bistre=දැවුණු ලීවලින් ලබා ගන්නා සායම් | බිස්ටර් වර්ණකය
bistro=කුඩා කෝපි කඩේ
bisulcate=ද්විඛාත
bisymmetric=ද්විසමමිතික
bisymmetrical=ද්විසමමිතික
bit=කටකලියාව | කටකලියාවේ තලය | කටුව | කැබැල්ල | කැබෙල්ල | කෑල්ල | කුඩ | ටික | ඩිංග | ඩිංගිත්ත | තලය | පංගුව | බිට් | බිටුව | බුරුම කටුව | බුරුමකටුව | මඳ | මාත්‍රය | මාත්‍රාව | විත | ස්වල්පය | සැපුවා
bitch=දියබැල්ල | බැල්ල | බැල්ලී | වෘකධේනුව | සිවලිය
bite=කනවා | ඩසිනවා | ඩැසීම | දෂ්ට කරනවා | රිදවනවා | විකනවා | සපනවා | සැපෙනවා | හපනවා | හපා කනවා | හපාකනවා | හපාගත් කොටස | හැපීම | හැපුමෙන් වන තුවාලය
biter=හපාකන්නා
biternate=ද්විත්‍රිත්ව
bithynia=බිතීනියා
biting=කාගෙන යාම | තියුණු | විකන | විකීම | සපන | සැපීම | හපාකන
bits=බුරුම කටු
bitten=දෂ්ට | සැපූ
bitter=අමිහිර | අමිහිරි | උග්‍ර | කටුක | කහට | තද | තික්ත | තිත්ත | තිත්තය | පරුෂ
bitter-gourd=කරවිල
bitter-sweet=මිශ්‍රාස්වාදය ඇති
bitterly=මහත් ශෝකයෙන්
bittern=කුරුලු විශේෂයක්
bitterness=තිත්ත බව | මහත් දොම්නස
bitty=කැබලිතිවලින් සෑදුණ
bitumen=ගල්කීල | ජතු | ජතු බිටුමන් | තාර | බිටුමන්
bituminous=ගල්කීල සහිත | ජතු | බිටුමන්මය
bitypic=ද්විදර්ශීය
biunique=එකට එක
bivalence=ද්විසංයුජතාව
bivalency=ද්විසංයුජතාව | ද්විසායුජතාව
bivalent=ද්විසංයුජ | යුගපට
bivalve=ද්විකපාට | දෙපියලි | පියලි දෙකක් ඇති බෙල්ලා | මට්ටියා
bivalved=ද්විකපාට
bivalvular=ද්විකපාට
bivariate=ද්විවිචල | ද්විවිචලය
bivouac=එළිමහන් නවාතැන | එළිමහනේ නවාතැන් ගන්නා තැන
biweekly=අර්ධමාසිකය | දෙසතියකට වරක් පළ වන සඟරාව | පාක්ෂික
bixin=බික්සින්
bizarre=අරුම පුදුම | අශෝභන | කැත | පුදුම | විශ්මයාවහ | විස්මයාකාර
bize=බයිස් සුළං
blab=නොසැලකිල්ලේ කතා කරනවා | රහස් එළි කරනවා | වාචාල දොඩවනවා
blabber=රහස් එළි කරන්නා
black=අසිත | ඉතා කිළුටු | කළු | කළු ජාතිකයා | කළුජාතික | කළුපාට | කළුවන් | කළුවා | කාලවර්ණය | කාළ | කෘෂ්ණ | දුෂ්ට | නපුරු | රුදුරු | රෞද්‍ර | ශ්‍යාම
black-bird=කවුඩු පනික්කියා
black-comedy=කළු ප්‍රහසනය | නිර්දය ප්‍රහසනය
black-guard=තක්කඩියා | නීචයා
black-lead=මිනිරන්
black-leg=තක්කඩියා | හොරිකඩ | හොරිකඩයා
black-list=අපලේඛණ කරනවා | අපලේඛණය
black-listed=අපලිඛිත
black-mail=අපකීර්තිය පතුරුවනවා | රහෝතර්ජනය
black-market=කළු කඩය | හොර කඩය
black-out=අඳුර | අඳුරු කරනවා | අඳුරු කිරීම | අඳුරු වීම
black-pigments=කළු වර්ණක
black-smith=කම්මල් කාරයා
blackberry=කළු දං | කළුදන් | රට ඇඹිල්ල | රටඇඹිල්ල
blackboard=කළු ලෑල්ල
blacken=කළු කරනවා
blackening=කළුවීම
blackguard=තක්කඩියා | නිගා කරනවා | නින්දිතයා | බනිනවා
blacking=කළු කිරීම | කළු කුඩු | කළු ගෑම
blacklead=කළු ඊයම්
blackleg=අනිෂ්ට වැඩකරුවන් | හොරිකඩයා
blacklisted=අපලේඛනගත
blackmail=අවමාන තර්ජනය
blackmarketeer=කළුකඩකාරයා | හොරකඩකාරයා
blackout=මුර්ඡා වීම
blacksmith=කම්මල්කරුවා | කම්මල්කාරයා | කඹුරා | කඹුරු | කර්මාර | ලෝකුරුවා
bladder=ආශය | කොළය | ධරිකාව | පිත්තාශය | මුත්‍රාශය | මූත්‍රාශය
blade=කොළය | තලය
blaes=ගිනි මැටි
blain=ගඩුව | තුවාලය | බිබිල | බිබිළ | වණය
blame=අපවාදය | චෝදනා කරනවා | චෝදනාව | දොස් කියනවා | දොස් තබනවා | දොස්කියනවා | දොස්පවරනවා | දෝෂාරෝපණය | දෝෂාරෝපණය කරනවා | නින්දාව | පරිවාදය | රොස් පරොස් | වරද | වරද තබනවා
blameless=අනවද්‍යු | අනින්දිත | නිදොස් | නිරවද්‍යු | නිර්දෝෂ | නිවැරදි | නිෂ්කලංක | විමල
blameworthy=දොස් තැබිය හැකි | දොස් ලැබිය යුතු | පරිවාද්‍ය | සාවද්‍ය
blanch=සායම් අරිනවා | සායම් යනවා | සුදු කරනවා | සුදු මැලි වෙනවා | සුදුමැලි වෙනවා
blancmange=කිරෙන් සැදූ පුඩිමක්
bland=කාරුණික | ප්‍රියවාදී | මෘදු | මොළොක් | සෞම්‍ය
blandish=ඉච්චා කරනවා | චාටු කරනවා
blandishment=කයිවාරුව | චාටුව | පුරාජේරුව | සුරතල
blank=ගෙඩිය | නුපුන් | නොලියන ලද | පුස්ස | පුහු | පුහුව | රික්ත | ව්‍යාකුල | ශූන්‍ය | ශූන්‍යය | හිස් | හිස් කඩදාසිය | හිස් තැන | හිස්කම
blank-verse=එළිවැට නැති පද්‍යය
blanket=කම්බිලිය | කම්බිලියකින් වසනවා | කම්බිළිය | පොරවනය | පොරවනවා | පොරෝනාව | බ්ලැන්කේට්ටුව | බැලැන්කේට්ටුව | ලොම් සහිත ඇතිරිල්ල
blanketeers=කම්බිලියෝ
blare=බෙරිහන් දෙනවා | මහ හඬ දෙනවා
blarney=ඉච්චා කතාව | චාටු කරනවා | චාටු සහගත කතාව | චාටුකථාව
blase=විනෝදයෙන් ඇති වූ | විනෝදයෙන් තිත්ත වූ
blaspheme=අවමන් කරනවා | නුසුදුසු සේ දොඩවනවා | බොරු දිවුරනවා | බොරුවට දිවුරනවා | ශාප කරනවා
blasphemer=පාෂණ්ඩයා | පාෂාණ්ඩයා
blasphemous=අවමන් කරන
blasphemously=අවමන් ලෙස
blasphemy=අවමන් කිරීම | දේවාපහාසනය | දේවාපහාසය | පාෂාණ්ඩනය
blast=කොළපාළුව | තද සුලඟෙහි වේගය | ධාරාව | නළාශබ්දය | පාළු කරනවා | පිපිරීම | පිපිරීමෙහි වේගය | පුපුරුවා හරිනවා | වනසනවා | වායු ධාරාව | වායුධාරාව | විනාශය | ශාප කරනවා | සුළං පහර | හුළං පහර | හුළංපහර | හෙන ගහපි
blast-furnace=ගිනි උදුන
blastea=බ්ලාස්ටියාව
blastean=බ්ලාස්ටීය
blasted=පාළු කළ | පිපිරවූ | විනාශ වූ | ශාපලත් | හෙනහුරු
blasting=පාළුව | පිපිරවීම | පිපිරැවීම | පිපිරීම | පුපුරවන | විනාශ කරන
blastopore=බ්ලාස්ටඡීද්‍රය
blastula=බ්ලාස්ටුලාව
blatant=අලජ් | අශෝභන | තැන්පත්කමක් නැති | නිහීන | නොසැඟවුණු | පවිටු | ප්‍රකටවම වැරදි | මොරගහන
blatant-homosexual=නිහීන සමලිංගිකයා
blather=අඥානව කථා කරනවා | මෝඩ ලෙස කථා කරනවා
blayon=පතළ කරනවා | විදහා පානවා | විදහාපෑම
blaze=අග්නිජාලාව | ඇවිලීගත් කෝපය | කෝපයෙන් ඇවිලෙනවා | ගින්නෙන් ඇවිලෙනවා | ගිනි ගන්නවා | ගිනි මැටි | ගිනිජාලාව | ගිනිදලුව | ගිනිමැලය | දැල්වෙනවා | පතළ කරනවා | ප්‍රකට කරනවා | බැබළීම | මහත් දීප්තිය | මහත් ප්‍රසිද්ධියට පමුණුවනවා | මහත් සේ බැබලෙනවා
blazer=ක්‍රීඩකයන් ගේ කබායක්
blazes=අපාය | නරකාදිය
blazon=අලංකාරයෙන් සරසනවා | වංශවිහ්නය | විදහා පානවා | විදහාපෑම
blazonry=වංශ සලකුණු විස්තර කිරීමේ ශාස්ත්‍රය
bleach=සුදු කරනවා | සුදු වෙනවා
bleaching=විරංජන | විරංජනය | සුදු කිරීම
bleahed=සුදු කළ
bleak=ආවරණයක් නැති | නීරස | මුඩු | ශීත සුළං ඇති | ශීතල | සතුට නූපදවන | සතුටු නූපදවන
blear=අඳුරු වූ | දීප්තියක් නැති | නිෂ්ප්‍රභ
blear-eyed=ඉදිමුණු ඇස් ඇති
bleary=දීප්තියක් නැති
bleat=බැටළුවන්ගේ හඬ | බෑ ගෑනවා | හඬ දෙනවා
bleb=බිබිල | බුබුල
blechnoid=බ්ලෙක්නුම් වැනි
bleed=ලේ අරිනවා | ලේ ගලනවා | වායුව පිට කරනවා
bleeder=අයුතු ලාබ ගන්නා | ලේ උරා බොන්නා
bleeding=දියර ගැලීම | නිර්යාසය | පිටමං කිරිම | ලේ ඇරීම | ලේ ගලන | ලේ ගැලීම | ලේ යාම | වායු පිටමං කිරීම | විස්‍රාවණය
blemish=කැලල | කැලල් කරනවා | කැලැල් කරනවා | කැළල | දෝෂය | දෝසය | පලුද්ද | පලුදු කරනවා
blench=පැන ගන්නවා | පිළිකුලෙන් හැකිළෙනවා | භයින් හැකිළෙනවා
blend=කලවම | කලවම් කරනවා | කලවම් වෙනවා | මිශ්‍ර කරනවා | මිශ්‍ර වෙනවා | මිශ්‍රණය | මුහුවම | මුහුවම් කරනවා | සංයෝගය | හනනවා
blende=සින්ක් සල්යිඩ්
blended=මිශ්‍ර කරන ලද
blender=මිශ්‍රණ යන්ත්‍රය | සම්මිශ්‍රකය
blending=මුහුවම් කිරීම | සංයුතුවීම | සම්මිශ්‍රණය | සම්මිශ්‍රණය කරනවා | සීහීම
blends=සින්ක් බ්ලෙන්ඩ්
blenny=කුඩා මුහුදු මාළුවෙක්
blent=මිශ්‍ර කරන ලද
blepharoplast=බ්ලෙපරොප්ලාස්ටය
bless=අශිංසනය කරනවා | ආ වඩනවා | ආශිංසනය කරනවා | ආශීර්වාද කරනවා | ප්‍රශංසා කරනවා | සුඛිත කරනවා | සෙත් කරනවා
blessed=අශීර්වාදලත් | ආශීර්වාද ලත් | ආශීර්වාද ලද | භගවත් | භාග්‍යවත් | භාග්‍යවන්ත | සිරිමත් | සුඛිත
blessedness=අකලංක සැපත
blessing=ආශිංසනය | ආශීර්වාදය | ආසිරි | ශාන්තිය | සාන්තිය | සෙත | සෙත්
blest=ආශීර්වාදිත
blew=හැමුවා
blight=අංග මාරය | අංගමාරය | කොළ රෝගය | දිලීර රෝගය | දිලීර හැදෙනවා | දිලීරය | පාළු කරනවා | විනාශ කරනවා | විනාශය | හානිය
blighter=තැනැත්තා | දිලීරකාරකය | නුරුස්නා පුද්ගලයා | හාදයා | හිඟන්නා
blimey=විස්මය
blimp=කුඩා අහස් නැව
blind=අඥ | අන්ධ | අන්ධ කරනවා | අන්ධ වෙනවා | අන්ධයා | අඳ | එළියක් නැති | කණ | කාණ | තිරය | තේරුමක් නැති | පොට්ට | මෝඩයා | රවටනවා | රැවටිල්ල | ව්‍යාජ | වැස්ම
blinder=අන්ධකාරකය | ඇඳිරකුරුව
blindfold=ඇස් බඳිනවා | ඇස් වසා බඳිනවා
blinding=අඳකරය
blindness=අන්ධ භාවය | අන්ධභාවය | මෝඩකම
blink=ඇසිපිය ගහනවා | ඇසිපිය හෙළනවා | ඇසිපිය හෙළීම | ඉවත බලනවා | ක්ෂණික ආලෝකය | නිමේෂය | යන්තමින් බබලනවා | වේගයෙන් ඇසිපිය ගහනවා
blinkered=ඇස් වැසුම දැමූ
blinkers=අශ්වයාගේ ඇස් වැසුම
blinking=නිමේෂය | මූසල
blip=රාඩාර් තිරයේ දිස්වන කුඩා තිත
blips=බ්ලිප්
bliss=අතිශය ප්‍රීතිය | දිව්‍ය සැපත | ප්‍රමෝදය | ප්‍රීතිය
blissful=අතිශය ප්‍රීතිමත් | ප්‍රමෝදමත් | ප්‍රීතිමත්
blister=ගඩුව | දියබිබිල | දියබුබුල | දොඩවනවා | බැන වදිනවා | බිබිල | බිබිලි දමනවා | බිබිලි නගිනවා | බිබිළ | බුබුළ | විසප්පුව | විසර්පය
blistered=බිබිලි සහිත
blistering=උග්‍ර | තියුණු | තීව්‍ර | බිබිලි දමන
blisters=බිබිලි | බිබිළ
blithe=ප්‍රමුදිත | සතුටින් පිනාගිය
blitz=ක්ෂණික ප්‍රහාරය | හදිසියෙන් පහර දෙනවා
blitzkrieg=කඩිනම් ජයග්‍රහණයක් ලබා ගැනීමට යොදන වැඩ පිළිවෙළ
blizzard=හිම කුණාටුව
bllty=ක්ෂණිකව පහර දෙනවා
bloat=ඉදිමෙනවා | දුම් ගසා මඳක් තම්බනවා
bloated=අධික ලෙස ස්ථූල | ඉදිමුණු
bloater=දුම් ගසා මඳක් තැම්බූ මාළු
blob=පොද | බින්දුව | බිඳ
bloc=පක්ෂ කාණ්ඩය | රටවල් කාණ්ඩය
block=අච්චුව | අඩය | අල්ලුව | අවහිර කරනවා | අවහිර කිරීම | අවහිරය | කට්ටය | කට්ටිය | කඳ | කාණ්ඩය | කැබැල්ල | කුට්ටිය | කොටස | කොටස් කරනවා | ගල් කොටය | ගුටකය | බ්ලොක් එක | බාධා කරනවා | රූ කැටය | රූපතහඩුව | ලී කොටය | වාරකය | සිර කරනවා | හවුරනවා
block-buster=අධික බලැති බෝම්බය
block-in-course=ගල් වරිය
block-printing=බ්ලොක් මුද්‍රණය
blockade=අවරෝධය | අවහිර යෙදීම | අවහිර යොදනවා | වැටලීම
blockhouse=කොන්ක්‍රීට්වලින් නිම කළ ආවරණය
blocking=අඩ | අවරෝධනය | අවහිර කිරීම | කට්ටි කිරීම
blockwork=කැට වැඩ
blockyard=වාත්තු පිටිය
blod=රිහිරි
bloke=හාදයා
blond=ගෞරී | තඹවන් | තඹවන් තැනැත්තී
blonde=ගෞරී | බ්ලොන්ඩ්
blondin=රැහැන් මඟ
blondism=ගෞරීභාවය | බ්ලොන්ඩ්තාව
blood=කෝපය | රක්ත | රක්තවර්ණ යුෂ | රත | රීරි | රුධිර | රුධිරය | රුහිර | රුහිරු | ලෙය | ලෙහෙ | ලේ | ලෝහිත | සීරි | හීරි | හුරිරු
blood-bath=මහා මනුෂ්‍යඝාතනය
blood-coloured=ලෙවන්
blood-relation=සහලේ | සහලේ නෑයා
blood-sinus=රුධිරාශය
bloodhound=දැඩි ඉවක් ඇති දඩයම් බල්ලා
bloodless=ලේ වැගිරීමක් නොමැති | සුදුමැලි | හිංසාවක් නැති
bloodshed=ලේ වැගිරීම
bloodstained=ලේ තැවරුණු
bloodsucker=කූඩැල්ලාට නමක් | සිත්පිත් නැති තැනැත්තා
bloodthirsty=ක්‍රූර | ධමනිය | ලේ නහරය | ලේ පිපාසිත
bloody=අවලන් | ක්‍රූර | පර | රතු | රෞද්‍ර | ලේ තැවරුණු | ලේ තැවැරුණු
bloom=අවිශද | අළු | උඩු මණ්ඩි | කුසුමය | තරුණ වයස | ප්‍රසන්න වර්ණය | පුබුදිනවා | මල | මල් දරනවා | මල් පිපීම | මල් හට ගන්නවා | මල් හටගැනීම | මුල් අවධිය | යකැටිය | සමෘද්ධ වෙනවා | සශ්‍රීක කාලය | සිනිඳුකම | හොඳ සනීපෙන් සිටිනවා
bloomer=අත්වැරැද්ද
bloomers=ස්ත්‍රීන් දණ දක්වා අඳින ලිහිල් කලිසම
bloomery=යකැටි ඌෂ්මකය
blooming=කබල් | පිපීම | මල් දරන | වස | සශ්‍රීක
blossom=දියුණු වෙනවා | පිපීම | පිපෙනවා | පුබුදිනවා | පුෂ්පය | පූදිනවා | පොබයනවා | මල | මල්හටගන්නවා | මුකුලය
blossomed=පිපි | පුල් | මිණිමුතු | විකශිත | විකසිත | සුපුල්
blossoming=මල් දරන
blot=අපකීර්තිය | අපකීර්තිය ගෙන දෙනවා | කටුගානවා | කැලල | කැලැල් කරනවා | කැළල | කැළල් කරනවා | නින්දාව | නොපෙනී යන්නට සලසනවා | පැල්ලම | මකා දමනවා | ලපය
blotch=පැල්ලම | පැල්ලම් ඇති වෙනවා | පැල්ලම් කරනවා | හම මත ඇති වන පැල්ලම
blotched=පැල්ලම් සහිත | පුල්ලි සහිත
blotchy=පැල්ලම් සහිත
blotter=තීන්ත පොවනය
blotting-paper=තෙත් කඩදාසිය
blotto=සුරාවෙන් මත් වූ
blouse=හැට්ටය
blow=ඉහඳ දමනවා | ඝාතය | තප්පුලනවා | පහර | පහර ගැසීම | ප්‍රහාරය | පිටකරනවා | පිපෙනවා | පිඹිනවා | පිඹිල | පිඹීම | පීඩාව | පුරවනවා | පුරසාරම් කියනවා | වැදීම | විනාශය | ශබ්ද කරනවා | සුළං පිඹීම | සුළං වදිනවා | සුළං හමනවා | සුළං හැමීම | සුළඟින් ගෙනයනවා | හති දමනවා | හදිසි අලාභය | හදිසි විපත | හමනවා | හැමීම | හුළඟට යනවා
blow-back=ආපසු ගැස්ම
blow-hole=වාසිදුර
blow-up=විශාලනය
blower=ධමකය | ධමනය | ධමනිකරය | ධමනිත්‍රය | ධමනිය | ධමනීකරය | පුඹුව | හුළංනළය
blowing=ධමනය | පිඹිලීම | පිඹීම | පිලිස්සීමේදී පිපිරී වැටීම | සුළං හැමීම | සුළඟ
blowlamp=ධමනී ලාම්පුව
blown=ධමිත | පිඹි
blowout=වාකඩුලුව
blowy=සුළං ඇති
blowzy=සැර පරුෂ පෙනුමක් ඇති
blubber=ඉකිබිඳිමින් කියනවා | තෙල් තට්ටුව | තෙල්මන්ද | වැලපෙනවා
bludgeon=කසයෙන් තළනවා | කොට | ගදාව | දණ්ඩ | පොල්ලෙන් තළනවා | බර පොල්ල | මුගුර
blue=අසභ්‍ය | අහස | නිල | නිල් | නිල් කරනවා | නිල් පොවනවා | නිල්පාට | නීලවර්ණය | මුදල් නාස්ති කරනවා | විශ්වවිද්‍යාලයක දක්ෂ ක්‍රිඩකයා | ශෝකී
blue-blood=වංශවතා
blue-blooded=වංශවත්
blue-book=නීල ග්‍රන්ථය
blue-collar=කම්කරු
blue-fly=නිලමැස්සා
blue-print=නිශ්වත සැලස්ම
blue-sighted=නීලදෘෂ්ටික
blue-sky=නිලඹර
blue-stocking=උගත්කමින් උඩඟු වූ ස්ත්‍රී
bluegreen=නීලහරිත
bluejacket=නැවියා
blueprint=සැලැස්මක පිටපත
blues=බ්ලූ සංගීතය
bluff=අහිංසක රළු හැසිරීම | උග්‍ර බෑවුම් ඇති | ගං දඹය | ගංදඹය | චාටු | තර්ජනයෙන් රවටනවා | පුරසාරම | පුරසාරම් | පුරසාරම් දොඩනවා | බෑවුම් සහිත කන්ද | රැවටිලි | රැවටිලි කථා කියනවා | රැවටීම | ව්‍යාජ තර්ජනය | හැඟීම් අවංකව කියන
bluish=නිලට හුරු | නිල්වන්
blunder=අත වරදිනවා | අනුවණකමින් වන වරද | දෝෂය | පමා දොස | ප්‍රමාදය | වරද | වරද්දා ගන්නවා
blunderbuss=පුරාණ කොට අත් තුවක්කුව
blunderhead=මෝඩයා
blunt=අවංක හා සෘජු | උපායශීලි නොවන | බාල කරනවා | මුවාත නැති | මොට | මොටවෙනවා | මොට්ට | මොට්ට කරනවා
bluntly=නොසැලකිල්ලෙන්
blur=අදුරු දෙය | අඳුරු පැල්ලම | අඳුරු බව | අඳුරු වෙනවා | අවිශද | අවිශද කරනවා | අවිශදතාව | කලංකය | නොපැහැදිලි බව | පැල්ලම | පැල්ලම් ඇති වෙනවා | පැල්ලම් කරනවා
blurb=ප්‍රකාශකගේ ග්‍රන්ථ විස්තරය | ප්‍රචාර පාඨය | හිවිය | හුවා දැක්වීම
blurred=අඳුරු | අවිශද | නොපැහැදිලි
blurt=අපරීක්ෂාවෙන් කථා කරනවා | අවිචාරයෙන් කථා කරනවා | කියනවා | දොඩවනවා
blush=අවිශද | ආරුණ්‍යය මුහුණ රතුවීම | ක්ෂණික දර්ශනය | මඳ රක්තවර්ණය | මුහුණ රතු වනවා | මුහුණ රතු වීම | මුහුණ රතු වෙනවා | මුහුණ රතුවීම | මුහුණ රතුවෙනවා | ලජ්ජා වීම | ලජ්ජා වෙනවා
blushing=ආරුණ්‍යය මුහුණ රතුවීම | ලජ්ජාශීල | ලජ්ජාශීලි
bluster=කුණාටු හජ | කුණාටු හමනවා | ගර්ජනා කරනවා | පුරාජේරු කථා දොඩනවා | පුරාජේරු කියනවා | පුරාජේරුව
bo-peep=හැංගි මුත්තන් වැනි කුඩා ළමුන් සමඟ ක්‍රීඩාවක්
bo-tree=බෝ ගස
boa=පිඹුරා වැනි උරගයෙක් | බෙල්ල වටා යොදන ලොම් පොරෝණය | බෙල්ල වටා යොදන ලොම් පොරෝනයක්
boar=ඌරා
board=කෑමබීම | ගොඩ වෙනවා | ඝන කඩදාසිය | ඝනකඩදාසිය | ඝනකවරය | නඟිනවා | නවාතැන් දෙනවා | නැවේ තට්ටුව | පයගහනවා | පුවරුව | පෝරුව | ඵලකය | බලෙන් නගිනවා | මංඩලය | මඩුල්ල | මණ්ඩලය | මේසය | ලෑල්ල | ලෑලි ගහනවා | ලෑලිවලින් වසනවා
boarded=පුවරුමුවා
boarder=නවාතැන්කාරයා | නේවාසික ශිෂ්‍යයා | නේවාසිකයා
boarding=කෑම බීම දීම | ලෑලි ගැසීම
boarding-house=නවාතැන් දෙන තැන | නේවාසිකාගාරය
boardroom=මණ්ඩලශාලාව | සභාශාලාව | සමාගමක අධ්‍යක්ෂ මණ්ඩලය රැස් වන කාමරය
boards=රංග මණ්ඩලය
boart=අවදියමන්ති
boast=ආඩම්බර වශයෙන් කියනවා | ආත්මවර්ණනාව | කට කියවනවා | කට මැත | කටපුච්චම් | කයිය | දළ හැඩගැන්වීම | පහන්කම් කීම | පාරට්ටුකරන තැනැත්තා | පාරට්ටුව | පුප්පනවා | හපන්කම් කියනවා
boaster=ගල් නියන | දළ හැඩගන්වනය | පුරසාරම් දොඩන්නා | වට්ටඩියා | හපන්කම් කියා ගන්නා
boastful=ඔල්වාරම් | ගර්විත | පුරසාරම් කියන | පුරසාරම් දොඩන | පූච්චම්කාර
boasting=කටපුච්චම් | කයිවාරු | පම්පෝරිය | පාරට්ටුව | පුරසාරම | පුරසාරම් | පුරසාරම් දෙම | වට්ටඩි
boat=අඟුල | ඔරුව | ද්‍රෝණිය | බෝට්ටු පදිනවා | බෝට්ටුව
boathouse=බෝට්ටු මඩුව
boatman=ඔරුකාරයා | බෝට්ටුකරුවා
boatsman=තොටියා
boatswain=ඔරු ආදිය බාර තැනැත්තා | නැවේ රුවල්
bob=උඩ පහළ යනවා | කොටට කැපූ කෙස් කළඹ | කොණ්ඩය කොට කරනවා | ගැස්සෙනවා | පැත්තට වැනෙන ලඹය | බට්ටා | ලඹ කැටය | සිලිම
bob-sleigh=ලී වලින් තැනූ මෙවලම | ලෝහ වලින් තැනූ මෙවලම
bob-tail=කපනලද කොට වලිගය
bobbin=ඉද්ද | තරළුව | දික්නූල් කූර | බීරලුව | බීරළු | බීරළුව | බොබිම
bobbinpillow=බීරළු කොට්ටය
bobble=ආභරණයක් ලෙස පළඳින වූල් බෝලයක්
bobby=පොලිස් භටයා
boche=ජර්මානු සොල්දාදුවා
bod=පුද්ගලයා | මිනිහා | හාදයා
bode=අනාගතය හැඟෙනවා | නිමිති කියනවා | පෙර නිමිති දක්වනවා
bodega=වයින් සාප්පුව
bodegon=මහනස දර්ශනය | රසවතිකාව
bodhi-ghara=බෝධිඝරය
bodhisatta=බුදුකුරු | බෝසත් | මහබෝසත් | මහා පුරිස | මහා පුරුෂ | මහාසත්ව
bodice=කංචුකය | කඤ්චුකය | චෝලිය | රබුක්ක | හැට්ටය
bodiless=අශරීර | කඳෙන් වෙන් වූ
bodily=කායික | මුළුමනින් | මුළුමනින්ම | ශරීරය පිටින් | ශාරීරික | ශාරීරිකව
boding=නිමිති කියන
bodkin=ඇලිස්කටුව | ගෝනි කටුව | දිග කූර | පොත් බඳින කටුව
body=අංගය | ඇඟ | ඇතුළත | උකුව | කඳ | කය | කාය | කායය | කූඩුව | ගත | ගාත්‍රය | තනු | තැනැත්තා | තිදොර | තුන්දොර | තුනු | ද්‍රව්‍යය | දේහය | පදම් මැට්ට | ප්‍රධාන කොටස | ප්‍රධානාංගය | පෙළ | බඳ | බොඩිය | භූතකාය | මණ්ඩලය | රූපය | වස්තුව | වෙර | ශරීර කූඩුව | ශරීරය | සංවිධානය | සත්කාය | සමාගම | සමූහනය | සමූහය | ස්කන්ධ | සිරුර | සූව සංලේඛ විස්තරය
body-centrode=වස්තු කේන්ද්‍ර පථය
body-guard=ආරක්ෂක පිරිස
body-snatcher=මිනී සොරා ගෙන විකුණන්නා
body-work=වාහනයක බාහිර ව්‍යහය
boedelhouderschap=බූදලය පවත්වා ගෙන යෑම
boer=බෝයර් ජාතිකයා
boffin=විද්‍යාත්මක පර්යේෂණවල යෙදෙන්නා
bog=පැකිළෙනවා | මඩවගුර | මඩෙහි එරෙනවා | වගුර | වගුරෙහි එරෙනවා | හැල | හෙල | හෙලෙහි ගිලෙනවා | හෙලෙහි දමනවා
bogeyman=භය ඇති කරන්නා
boggle=අවුලට පැමිණෙනවා | පසුබට වෙනවා | භයින් ගැස්සෙනවා | සැකයට පැමිණෙනවා | සැකයෙන් නවතිනවා
boggler=චකිතයට පැමිණි තැනැත්තා
boggy=ගොහොරු | වගුරු | හෙල් සහිත
bogie=අවතාරය | කරදරය | පඹයා | බොගිය | බෝගිය
bographical=චරිතකථාමය
bogus=අසත්‍ය | බොරු | රැවටිලි සහිත | ව්‍යාජ
bogy=පඹයා | බිල්ලා
bogyman=බිල්ලා
bohemian=නිදැල්ලේ හැසිරන | බොහීමියානු | බොහීමියාවේ වැසියා | සැහැල්ලු තැනැත්තා | සුසිරිතෙන් තොර
boil=උණූ කරනවා | උතුරනවා | උතුරවනවා | ඔඩුව | කකාරනවා | කකියනවා | කෝප කරනවා | කෝප වෙනවා | ගඩ | ගඩපොළ | ගඩුව | ගණ්ඩය | ගෙඩිය | තම්බනවා | තැම්බෙනවා | නටනවා | නටවනවා | පැසවනවා | පැසෙනවා | පැහෙනවා | පිඹිල | පෙන දමනවා | පෙන නගිනවා | පොක්කලම | බිබිල | බුද්බුද | මස් ගඩුව | රක්තවිද්‍රධිය | ලේගඩුව | වියල | විසප්පුව | වේගයෙන් ඉපිලෙනවා | සිඳිනවා
boiler=කටාරම | කටාරම් | කටාහය | බොයිලේරුව
boiling=ඉතිරීම | උතුරන | කකාරන | තැම්බීම | තැම්බුම | නටන | නැටැවීම | නැටීම
boiling-point=තාපාංකය
boisterous=ඝෝෂා කරන | චණ්ඩ | සැර
bola=බෝලායුධය | බෝලාව
bolas=බෝලායුධය | බෝලාව
bold=අවිනීත | එඩිතර | තට්ට | තද | ධෛර්ය්‍ය සම්පන්න | නිර්භීත | ප්‍රගල්භ | පැහැදිලි | පැහැදිලි සේ පෙනෙන | වීර | ශූර | සහසි | සහසික | සාහසික
bold-faced=ගරු සරු නැති | බිය සැක නැති
boldness=නිර්භීතකම
bole=කඳ | ගසේ කඳ | ගසේ බඳ | බඳ | මහ කඳ | විවරය
bolero=ස්පාඤ්ඤ නැටුම් විශේෂයක්
boletol=බොලෙටොල්
bolivar=බොලිවාරය
boliviano=බොලිවියානෝව
boll=කපු ගෙඩිය | කපුවලින් කළ කලසක් | පොත්ත
bollard=මුණ්ඩම | රථවාහන පාලනයට මහා මාර්ගයේ ඇති කෙටි කුලුණ
bolling=අතුබෑම
bollot=කුසපත
bolometer=බොලෝමීටරය | බෝලෝමීටරය
boloney=අපභ්‍රංශ | විකාරය | විගඩම
bolshevik=රුසියාවේ සමාජවාදී පක්ෂයේ සාමාජිකයා
bolshie=අදක්ෂ | ඉක්මනට කිපෙන | දඩබ්බර | දරදඬු | සහයෝගයක් නොදක්වන
bolsone=බොල්සොන්
bolster=ආරක්ෂා කරනවා | උපකාරී වෙනවා | උපධානය | කොට්ටයක් දමා උස්සනවා | දිග කොට්ටය | දිග බෝල කොට්ටය | බලකරය | බිම්බෝහනය | රුකුල් දෙනවා | සහාය වෙනවා
bolt=අකුණ | අගුල | අගුල් දමනවා | අගුලු ලනවා | අගුළ | අඟුළු දමනවා | ඊය | දිවත | නොවිකා ඉක්මනින් කනවා | පැන යනවා | පිටු නැම්ම | පොට ඇණය | බදැණය | යතුරු ඇණය | හෙණය
bolus=ගුළිය
bom=නිපන්
bomantague=පිරැවිය
bomb=ගිනි දණ්ඩය | පුපුරණ වෙඩිල්ල | බෝම්බ දමනවා | බෝම්බ හෙළනවා | බෝම්බය
bombard=කාලතුවක්කුවලින් පහර දෙනවා | බැට දෙනවා | බෝම්බ හෙළනවා | බෝම්බවලින් පහර දෙනවා | විවර්ෂණය කරනවා
bombardier=කාලතුවක්කු හමුදාවේ මුලාදෑනියෙක්
bombardment=කාලතුවක්කුවලින් වෙඩි තැබීම | බැට දීම | බෝම්බ හෙළීම | විවර්ෂණය
bombast=පුරසාරම | පූච්චම
bombastic=අහංකාර කියුම් ඇති | දුරවබෝධ | පුරසාරම් | පුරසාරම් දොඩන | පූච්චම් | සමාස බහුල | සාටෝප | සාඩම්බර
bombazine=ලෝම රෙදි විශේෂයක්
bomber=බෝම්බ හෙලන ගුවන් යානය | බෝම්බ හෙළන ගුවන් නැව
bombshell=හෙණගෙඩිය
bon-bon=රතිඤ්ඤ වර්ගයක් | රසකැවිලි විශේෂයක්
bon-fire=දවාග්නිය | දාවාග්නිය
bona-fide=අවංක | අවංකව | හොඳ හිතින්
bona-fides=අවංක අදහස් | අවංකකම
bonanza=ගජවාසිය | සරු ලෝපස්
bond=අලවනවා | අවහිරය | ඇප වෙනවා | ඇපකරය | ඇපය | ඇපයට තබනවා | ඔප්පුව | ගඩොල් ඇල්ලීමේ ක්‍රමය | ගබඩාවක තැන්පත් කරනවා | පරාධීන | පාහනවා | පිළිණ පත | පිළිණපත | පිළිනපත | පොරොන්දු පත්‍රය | බන්දනය | බන්ධනය | බැඳීම | බැඳුම | බැඳුම්කරය | බැඳුම්කරයා | බැම්ම | වහල් | සුරැකුම
bond-man=දාසයා
bond-woman=දාසිය
bondage=දාසභාවය | පරාධීනත්වය | බන්ධනය | බැඳීම | වහල් බව
bonded=ඇපයට බැඳුණු | ඇලවුණු | සවි වුණු
bondieuserie=දේවදාස කලාව
bonding=උගස් කිරීම | පටි ලෑම | බන්ධනය කිරීම | බැඳීම
bondmaid=දාසී
bondman=ඇපකාරයා | දාසයා
bonds=පිළිණ පත් | පිළිණපත් | සුරැකුම්පත්
bone=අස්ථිය | ඇට කැබෙල්ල | ඇටකටු | ඇටය | කටු | කටු ගලවනවා | කටු ගළවනවා | කටු හරිනවා | කටුව
bone-meal=ගෙරි ඇට පෝර
bone-pointing=අස්ථිය දිගු කිරීම
boner=ගොන්නම
bonfire=උත්සවාග්නිය | කුණු පුළුස්සන ගිනිගොඩ | ගින්න | ගිනි ගොඩ | ගිනිමැලය
bongo=බෙර විශේෂයක්
bonhomie=කරුණාව | යහපත්කම
bonitary=භුක්ත
bonnet=උවසුන | කුඩා තොප්පිය | නිකට ආවරණය | යන්ත්‍ර ආවරණය
bonny=රූමත් | ලස්සණ | සුන්දර | සුරුපී
bonsai=කුරු පඳුර | කුරුගස | ජපන් කලාවක්
bonus=ප්‍රසාද දීමනාව | ප්‍රසාද මුදල | ප්‍රසාදිතය | ප්‍රාසාදික | පාරිතෝෂිකය | බෝනසය | බෝනස්
bony=ඇට සහිත | කටු සහිත | කෙට්ටු
bonze=චීන බෞද්ධ භික්ෂුව | ජපන් බෞද්ධ භික්ෂුව
boo=නින්දා කරනවා | හූ කියනවා | හූ කීම | හූව
boob=අමනයා | තකතීරු වැඩක් | මෝඩකම
booby=නෝංජලයා | මෝඩ තැනැත්තා | මෝඩයා
booby-trap=හබකය
bood=පොත
boodle=අසාධාරණයෙන් උපයන ලද ධනය
boogie=අසභ්‍ය සංගීතය
booing=හූ කීම
book=කලින් වෙන් කරනවා | කෘතිය | ගත | ග්‍රන්ථය | ප්‍රකරණය | පුස්තක | පොත | පොතනවා | පොත්ගත කරනවා | වෙන් කරනවා | සටහන් කරනවා
book-case=පොත් අල්මාරිය
book-debt=පොත් ණය
book-keeper=පොත් තබන්නා
book-keeping=පොත් තැබීම | පොත්තැබීම
book-louse=පොත්කාවා
book-maker=ඔට්ටු තබා ගන්නා
book-making=ඔට්ටු බාර ගැනීම
book-plate=පොත් අයිතිකාරයාගේ නම දැක්වෙන ලේබලය
book-value=පොත්ගත අගය
bookbinder=පොත් බඳින්නා | පොත් බැඳුම්කරු
bookbinding=පොත් බැඳුම
bookcase=පොත් පිටකවරය | පොත් රාක්කය
booked=තීන්දු කළ | නියම කර ගත්
booker=සටහන් කූර
bookfair=පොත් සල්පිල
bookholder=ග්‍රන්ථ ධාරකය
booking=කලින් ලියාපදිංචිකිරීම | පුස්තාංකනය | පෙතීම | පොත් ගත කිරීම | පොත්ගත කිරීම | වෙන්කරවා ගැනීම | සටහන් කිරීම
bookish=අකාර්යක්ෂම | පොතටම ඇලුණු
booklet=ග්‍රන්ථකය | පුස්තිකාව | පොත් පිංච | පොත්පිංච
bookmaker=උගතා
bookmaking=ඔට්ටු ඇල්ලීම
bookmark=පොත් යොමුව
bookmobile=ජංගම පුස්තකාල රථය
bookrack=පොත් රාක්කය
bookseller=පොත් වෙළෙන්දා
bookshop=පොත් හල | පොත්හල
bookstall=කුඩාපොත්හල | පොත් විකුණන තැන
bookstore=පොත් ගබඩාව | පොත් සාප්පුව
bookworm=පොත් ගුල්ලා | පොත්ගුල්ලා
boole=බූල්
boolean=වීජ ගණිතයේ අංශයක් හා සම්බන්ධ
boom=අත්පාතය | උත්පාතය | උද්දණ්ඩ | ගම්භීර නාදය | දෝංකාරය | දෝංකාරය නගනවා | බූමය | බූමරැංගුව | රුවල් අදින කුඹය | සමෘද්ධිමත් සමය | සරු කාලය | හදිසියෙන් උසස් වෙනවා | හදිසියෙන් ධනවත් වෙනවා | හදිසියෙන් ලැබෙන ප්‍රසිද්ධිය
boomarang=පාරාවලල්ල | බූමරංගුව
boomerang=තමා වෙතට ආපසු එනවා | බූමරංගය | බූමරැංගුව
booming=ප්‍රධෝවනය
boon=ප්‍රසාදය | මහත් ප්‍රයෝජනය | මහත් ලාභය | වරප්‍රසාදය | වරය | වාසි සහගත | වාසිය | සිත්ගන්නා | හිතකර
boon-work=අතිරේක මෙහෙකම්
boor=අවිනීතයා | ගොවියා | දරදඩු පුද්ගලයා | පිටිසරයා
boorish=ක්‍රෑර | දරදඬු නොහික්මුණු
boost=අභිවෘද්ධිය | උසස් කොට දක්වනවා | ප්‍රසිද්ධිය දෙනවා | ප්‍රසිද්ධියට පමුණුවනවා | වැඩිවීම | හිපීම | හිවීම | හුවනව | හුවනවා
booster=හුවනය
boot=අඩිය | උස් සපත්තුව | පයින් ගසනවා | පයින් ගහනවා | ප්‍රයෝජන වෙනවා | පා පහර දෙනවා | සපත්තුව
boot-tree=සපත්තු ලොකු කිරීමට යොදන උපකරණයක්
booted=සපත්තු පැළඳි
bootee=ළදරු මේස් | ළදරුවකුගේ පා වැස්ම
bootes=තුරුවැල | බූට්ස්
booth=කූඩාරම | කූඩුව | ගේ පැල | තාවකාලික කඩය | පොළ | මඩුව
booties=පැහැර ගත් දේ | සොරකම් කළ දේ | ළදරු මේස්
bootleg=නීතිවිරෝධීව විකුණන | නීතිවිරෝධීව සෑදූ | හොර මත්පැන් විකුණනවා | හොරට මත් පැන් විකුණනවා | හොරට විකුණන | හොරට විකුණනවා | හොරට සෑදූ
bootlegger=හොර මත්පැන් වෙළෙන්දා
bootleglegger=හොර මත්පැන් වෙළෙන්ඳා
bootless=නිෂ්ඵල | ලාභයක් නැති | ව්‍යර්ථ
boots=හෝටලයක පදිංවකාරයන්ගේ සපත්තු මදින මෙහෙකරුවා
booty=කොල්ල කෑ දේ | කොල්ලය | පැහැර ගත් දෙය | පැහැර ගත් වස්තුව | ලුංටිතය
booze=මත්පැන් | වෙරි වන තුරු බොනවා
booze-up=බොන වෙලාව
bora=බෝරා සුළඟ
boracite=බොරසයිට්
borage=සලාදවලට ගන්නා ශාකයක්
borah=බෝරාකාරයා
borax=පුස්කර | බොරැක්ස් | බෝරැක්ස් | බෝරික් කුඩු | රෝචක
bord=හරස් දෝනාව
bordar=බෝදරයා
bordeaux=ප්‍රංශයේ සාදන සුදු හා රතු වයින්
bordem=කාංසිය
border=අද්දර | අයින | අසබඩ | ඉම | ඉවුර | කඩඉම | කලාත | ගැටිය | තීරය | දාරය | පර්යන්තය | ප්‍රාන්තය | බෝඩරය | මල් පාත්තිය | මායිම | යාව පිහිටා තිබෙනවා | ලියවැල | වාටිය | වාටියක් දමනවා
borderer=රටක මායිම අසල පදිංචිකාරයා
bordering=පිරිවැම
borderland=දේශසීමාවට සමීප පෙදෙස | මායිම් දිස්ත්‍රික්කය
borderline=අනුමානය | ආසන්න | යාන්තමින් පිළිගත හැකි | වාටි රේඛාව | සීමාසන්න | සීමාස්ථ
borders=බෝඩර් තිර | රැළි තිර
bore=ඉසිලුවා | කණිනවා | කරච්චලය | කරච්චල් කරනවා | කරදර කරනවා | කරදරකාරයා | කුහරය | තද වඩදිය රැළ | තව් | තව් ලොකු කරනවා | තව් විදිනවා | තව් විෂ්කම්භය | තව්ව | තව්වක් විදිනවා | තවු විදිනවා | තුවක්කු කඳේ සිදුර | දැරුවා | දිය ගොබය | පසා කරනවා | පසාරු කරනවා | බෝර විෂ්කම්භය | බෝරය | වළක් හාරනවා | වාචාලයා | විදින ලද තව්ව | විදින ලද සිදුර | විදිනවා | සිදුර | සිදුරක විෂ්කම්භය | සිදුරු කරනවා | සිදුරු විෂ්කම්භය | හාරන ලද සිදුර | හිරිහැර කරනවා
boreal=උත්තර | උතුරු | උතුරුදිග
boreas=උත්තර වායුව | උතුරු සුළඟ
bored=විදි
boredom=ආයාසය | කරදරකාරී ස්වභාවය | ග්ලානිය | පීඩාව | වෙහෙස
borehole=මිහිවිදමන
boreholes=මිහිවිදමන්
borer=අලිස්කටුව | ගුල්ලා | තව්කටුව | තවු කටුව | බෝරකටුව | මිහිවිදිනය | යවකාරය | සංද්‍රකය
boric=ඖෂධ වර්ගයක්
boride=බෝරයිඩ්
boring=එපා වුණු | එපාවීම | කටුවෙන් විදීම | ග්ලානකාරී | තව විදීම | තව් ලොකු කිරීම | තව් විදින | තව් විදීම | නීරස | බෝර දැමිම | මිහි විදීම | විදමන | විදින | විදීම | වෙහෙස ඇති කරන | සෑරීම | හාරන | හෑරීම | හෑරූ හිල
borings=විදියර
born=ඉපදුණු | උත්පන්න | උපන් | ජනිත | ජාත | දුන් | පහළ | භවික | භූත | රුහ | සඤ්ජාත | සම්භූත
borne=ඉසිලූ | ඉහිලුවා | උසුලනු ලබන | දැරුවා
bornhardt=බෝන්හට්
bornite=බෝනයිට්
borobudur=බෝරෝබුදුර්
boron=බෝරොන් | බෝරෝන් | මූලද්‍රව්‍යයක්
borough=කොට්ඨාසය | පේරුව
borrow=ඉන | ඉල්ලා ගන්නවා | ණය ගන්නවා | ණය ගැනීම | ණයගන්නවා | ණයට ගන්නවා | තාවකාලික පාවිච්වයට ගන්නවා
borrower=ණය ගන්නා | ණය ගනුවා | ණයකරුවා | ණයගැතියා | ණයගැනුම්කරුවා | ණයට ගන්නා | ණයට ගන්නා තැනැත්තා | පාඨක | බාහිර පාඨකයා
borrowersticket=පාඨක බලපත්‍රය
borrowing=අත මාරුව | ණය | ණය ගැනීම | ණය ගැනුම | ණයගැනීම | ණයගැනුම | ණයට ගත් දෙය | පොත් ලබා ගැනීම
borstal=බාලාපරාධකාරයන් හික්මවන ආයතනය
borstals=බෝස්ටල් ආයතන
bort=අවදියමන්ති | බෝට්
borzoi=කුඩා හිසක් ඇති සුනඛ විශේෂයක්
bose=බෝස්
bose-eyed=කණ
bosh=පච | පචය | බුසුව | මනස්ගාතය | වැදගැම්මකට නැති කතාව | විකාරය
bosom=අභ්‍යන්තරය | තුරුල්ල | පපු පෙදෙස | පපුව | පයෝධරය | යටිසිත | ළපැත්ත
bosom-friend=ගජ මිතුරා
boson=බොසෝනය
boss=අධිකාරී | ආක්‍රමය | කැටයම් කපනවා | නැබ | ප්‍රධානියා | බාස් | බොසය | බොස්ගෙඩිය | මේස්ත්‍රී | ලොක්කා | ලොකුකම පෙන්වනවා
boss-eyed=වපර
boss-shot=ලොකු වැරදීම
bossing=ඊයම් හැඩ ගැස්සීම
bossy=අධිපති | අහංකාර | ජේත්තු | ලොකුකම පෙන්වන
bostryx=බඹුරුව
bosun=තණ්ඩලේ
botanical=උද්භිද | උද්භිද විද්‍යාව සම්බන්ධ | උද්භිදවිද්‍යා
botanist=උද්භිද විද්‍යාඥයා | උද්භිදවිද්‍යාඥයා | ශාක විද්‍යාඥයා
botanize=උද්භිද හදාරනවා
botanomancy=පත්පේනය
botany=උද්භිද විද්‍යාව | උද්භිදවිද්‍යාව | තෘණ විද්‍යාව | තෘණවිද්‍යාව | ශාකවිද්‍යාව
botch=අසම්පූර්ණ කෘත්‍යය | නරක ලෙස රෙපරේරු කරනවා
both=උභය | තවත් | ද්වි | දෙ | දෙක | දෙකක් එකට | දෙකින්ම | දෙදෙනා | දෙදෙනෙක්
bother=අපහසුව | කරදර කරනවා | කරදරය | කෙළිය | හිරිහැර කරනවා | හිරිහැර වෙනවා | හිරිහැරය
botheration=කරච්චලය | මේ ඉලව්ව | මොන කරදරයක්ද | වදේ
bothered=කරදර | හිරිහැර
bothersome=කරදරකාරී | හිරිහැර පමුණුවන
botrioid=රැසීමාකාර
botryoid=රැසීමාකාර
botryose=රැසීමාකාර
botrys=රැසීමය
botrytic=රැසීමාකාර
bottega=වත්‍රාලය
botting=මැටි ඇබ ගැසීම
bottle=කුප්පිය | පොවන බෝතලය | බෝතලය | බෝතලවල අසුරනවා | බෝතලවල අහුරනවා | මත්පැන්
bottle-neck=අවහිර සහිත කොටස
bottleneck=අවහිරය | පටුකම | පටුදොර | හිර කපොල්ල
bottom=අඩි | අඩිය | අන්තිම | තට්ටම | දියළු තැන්න | පත්ල | පතුල | පතුල් | පදනම | පල්ල | පහළ | පහළ වැටෙනවා | යට | යට පිහිටි | යටි | සර
bottom-yeast=පතුල් යිස්ට් | යටි යිස්ට්
bottoming=පාගල් | පැතිලීම
bottomless=අගාධ | ආගාධ | ඉතා ගැඹුරු
bottomry=නැව් ඇපය
bottoms=දඹුලෝ
bottomtrace=පතුල් ලැකිය
botuliform=ලිංගුස් හැඩ
botulish=විෂබීජ ඇතුල් වී ටින් කළ ආහාර විෂ වීම
botulism=බොතුලිනියාව
boucharde=උල් මිටි
bouche=බුහුව
boucle=ටපටා රෙදි
bougainvillaea=බෝගන්විලා ගස්
bough=අත්ත | ශාඛාව
bought=මිලට ගත්තා
bougie=බූය
bouillon=තුනීව සාදනු ලබන සූපය | මාංසසුපය
boulder=කළු ගල | ගල්පර්වතය | ගල්පව්ව | ලොකු ගල් කුට්ටිය | ලොකු ගල්කුට්ටිය
boulevard=දෙපස ගස් වැවුණු මාවත | මහාමාර්ගය | මාවත
bounce=අගරුව | අතිශයෝක්තිය | ආපසු පනිනවා | ආපසු පැනීම | උඩ ඒම | උඩ පනිනවා | කෝපයෙන් උඩ පනිනවා | පුරසාරම | පුරසාරම් කියනවා | පොළා පැනීම | වේගයෙන් උඩ පනිනවා | වේගයෙන් උඩ පැනීම | වේගයෙන් වැදී ආපසු පනිනවා
bouncing=දඟ සහිත | මනාව වැඩුණු
bound=නියතින් ම කරන | පනිනවා | පර්යන්තය | පැනීම | පිම්ම | බඳිනලද | බල කරනලද | බැන්දා | බැඳී සිටින | බැඳුණු | මායිම් වෙනවා | යන්නට සූදානම් වූ | යමින් මග සිටින | සිර | සීමා කරනවා | සීමා වශයෙන් තබනවා | සීමා වුණු | සීමා වෙනවා | සීමාව
boundary=ඉම | කඩ | කඩඉම | කඩවත | මාඉම | මායිම | සීමා | සීමාව | හිම්
bounded=පර්යන්ත | පර්යන්තගත | මායිම් වූ | සපර්යන්ත
boundedly=පර්යන්ත වශයෙන්
boundedness=සපර්යන්තතාව
bounden=අවශ්‍ය | බැඳුණු
bounder=අශිෂ්ටයා | දඟකාරයා
bounding=පර්යන්ත
boundless=අනන්ත | අප්‍රමාණ | අප්‍රමේය | අසීමිත | පර්යන්ත රහිත | සීමාරහිත
boundlessness=පර්යන්ත රහිත බව
bounteous=උදාර | ගුණවන්ත | ත්‍යාගවන්ත | ත්‍යාගශීලී | නිර්ලෝභී | පරිත්‍යාගශීලී | සමෘද්ධි සම්පන්න
bountiful=ත්‍යාගවන්ත | ත්‍යාගශීලි | ත්‍යාගී
bounty=කරුණාවන්තකම | ත්‍යාගය | ත්‍යාගවන්තකම | ත්‍යාගශීලීභාවය | තෑග්ග | තිලිනය | තිළිණය | දීම | දීමනාව | පරිත්‍යාගය | පාරිතෝෂික මුදල
bouquet=මඤ්ජරිය | මද්‍යසාරයෙහි ඇති සුගන්ධය | මල් කළඹ | මල් පොකුර | මල්පොකුර | මල්මාලය
bourbon=විස්කි විශේෂයක්
bourgeois=ධනේශ්වර | මධ්‍යම පන්තික | මධ්‍යම පන්තිය | මුද්‍රණයෙහි අකුරු විශේෂයක් | සැප පහසුවට කැමැති
bourgeoise=ධනේශ්වර | බූෂුවා පන්තිය
bourgeoisie=ධනේශ්වර පන්තිය | බූෂුවා පන්තිය | මධ්‍යම පංක්තියේ ජනයා
bourgeon=අංකුරය
bourn=කුඩා දිය මඟ
bourne=බෝනය | සවිරාම ගංගාව | සීමාව
bout=ක්‍රියාකාරී කාලය | පොරය | වාරය
boutique=කඩපිළ | කඩය
bouy=ඉපියාව | බෝයාව
bouyancy=ඉල්පීම | උද්‍යෝගය
bouyant=ඉල්පෙන | උද්‍යුෝගී | පාවෙන
bouzouki=මැණ්ඩලීනය බඳු ග්‍රීක සංගීත භාණ්ඩයක්
bovine=ගව | ගව වර්ගයට අයත් | ගවයකු වැනි | තකතිරු | මුග්ධ | මෝඩ
bow=අලුව | ආචාර කරනවා | ඇණිය | චාපය | දුන්න | දුන්නෙන් විදිනවා | දුනු ගානවා | ධනු | නැමෙනවා | නැවෙහි ඉදිරි භාගය | නැවේ ඉදිරි කොටස | ප්‍රණාමය | පීඩා ලබනවා | යටත් වෙනවා | සරසන | සැවු | හිස නමනවා
bow-bow=බිරීම
bow-handle=දුනුමිට
bow-string=තාවරය | දුනුදිය | සවුදිය
bowdlerise=පොතකින් නුසුදුසු කොටසක් ඉවත් කරනවා
bowel=අතුණු | අන්ත්‍රය | බඩ | බඩවැල
bowels=අභ්‍යන්තරය | ගර්භය | බඩවැල්
bower=ඇතුල් කාමරය | තුරුගොමුව | පන්දලම | ලතාගෘහය | ලතාමණ්ඩපය | ලියගොමුව
bower-bird=ඔස්ට්‍රේලියානු කුරුල්ලෙක්
bowie=දඩයම් පිහිය
bowis=කෙනෙස්ස | කෝප්පය
bowk=බාල් දිය
bowl=කුසලාන | කුහරය | තලිය | පන්දුව | පන්දුව යවනවා | පය | පා | පාත්‍රය | බඳුන | භාජනය
bowlegged=බකල
bowler=තොප්පි ජාතියක් | පන්දු යවන්නා | පන්දුව යවන්නා | වටකුරු උස් තොප්පිය
bowline=පිරිමි ගැටයා | රුවල බඳින කඹය
bowling=පෙරළීම | බෝල යැවීම
bowls=පන්දු ක්‍රීඩාවක් | පන්දු යවනවා | බෝලය වීසි කරනවා
bowman=ඇණිකරුවා | ධනුර්ධයා | ධනුර්ධරයා
bows=දුනු කවකටුව
bowser=බව්සරය
bowsprit=නැව් බඳේ සිට ඉදිරියට දික් වූ රිට
bowstring=දුනු ලණුව | දුනුදිය
box=අතුල් පහර | අල්ලෙන් ගහනවා | කොටුව | ගස් වර්ගයක් | ගුස්ති අල්ලනවා | තෑග්ග | පෙට්ටිය | පෙට්ටියක දමනවා | පෙළාව | පේළාව | මඤ්ජුසාව | මැදිරි අසුන | මිටින් ගහනවා | රියැදුරාගේ ආසනය | විශේෂ ආසනය | හෙප්පුව
box-office=ප්‍රවේශපත්‍ර කාර්යාලය
box-plan=ආසන සැලැස්ම
box-spanner=පෙට්ටියතුර
boxboard=පෙට්ටි කඩදාසිය
boxer=මුෂ්ටි ප්‍රහාරකයා
boxing=අහුරුව | ගුස්ති | බාහුයුද්ධය | බොක්සිං ක්‍රීඩාව | මල්ලව | මල්ලව පොර | මුෂ්ටි ප්‍රහාරය | මුෂ්ටිප්‍රහාරය
boxing-day=නත්තල් දිනට පසු දින
boy=ආවතේව කාරයා | කුමාරයා | කොල්ලා | කොලුවා | ගැටයා | පිරිමි ලමයා | බාලයා | මානවකයා | වැඩ කරුවා | ළමයා
boycott=පිටුදැකීම | වර්ජනය | වර්ජනය කරනවා | වර්ජනය කිරීම | විරමණය | සත්‍යග්‍රහය
boyhood=බාල කාලය | බාලකාලය | ළමාවිය
boyish=ලමා වියෙහි පිහිටි | ලාමක | සෙල්ලමට කැමැති
boyscout=බාලදක්ෂයා
bozzetto=ආදර්ශය
bra=තනපට
brace=ඉලය | කුට්ටම | ජෝඩුව | තද කොට බඳිනවා | තොරපනය | පටි යොදනවා | පටිය | පාන බලය | පානබලය | බන්ධනය | බුරුමය | රුවල් කඹය | සවි කරනවා
bracebit=බුරුම කටුව | බුරුමතලය
bracelet=බාලකය | බාහුදණ්ඩි | වලය | වළයාභරණය | වළල්ල | වළලු | හර
braces=කලිසම සමග පළඳින උරහිසේ සිට වැටෙන පටි දෙක
brachial=බාහුමය | භූය
brachialis=භුජකය | භූජපේශිය
brachicephalic=පෘථුකපාල
brachioradialis=භූජ අරීයකය
brachistochrone=ලූ කැලිය | ලූකැලි වක්‍රය
brachybiostemonous=මන්ද්‍රයුරේණුක
brachycephaly=වෘහත්කපාලකතාව
brachycladous=ලඝුස්කන්ධිය
brachydactyly=අර්ධාංගුලිකතාව | ලඝු අංගුලිකතාව
brachymeiosis=ලඝුනනය
brachymeiotic=ලඝුනන
brachyphyllous=ලඝු පත්‍රික
brachypodous=ලඝු පාදීය
brachystylous=ලඝුකීල
bracing=ඉල ලෑම | ශක්තිමත් කරනවා | ශක්තිවර්ධක | සනීපදායක
bracken=කැකිල්ල | කැකිල්ල වැනි වර්ගයක්
bracket=අර්ධ චන්ද්‍ර රේඛාව | අල්ලුව | එක සේ සලකනවා | එකට ගළපනවා | එකට නම් කරනවා | කරවර | කරවරය | කරුව | කුඩා රාක්කය | කුරුපාව | ධරය | බ්‍රැකෙට්ටුව | වරහන | වරහන් | වරහන් අතරේ යොදනවා | වරහන් යොදනවා | වරහන් ලකුණ | සවි කරනවා | සවි කිරීම
brackets=කරවර | වරහන්
brackish=කිවුල්
brackishness=කිවුල් රස
bract=නිපත්‍රය | මලේ උපමණි පත්‍රය
bracteal=නිපත්‍රාකාර
bracteate=නිපත්‍ර සහිත | නිපත්‍රී
bracteiferous=නිපත්‍රධර
bracteody=නිපත්‍රභනය
bracteolate=නිපත්‍රික
bracteole=නිපත්‍රිකාව
bractlet=නිපත්‍රිකාව
brad=පැතිසැණය | හිස රහිත ඇණය
bradawl=අලිස්කටුව | බුරුමය | විදින කටුව
bradyarthria=මන්ද පර්වනය
bradycardia=ලැසිකන්තුව | හදලැසිය
bradylalia=මන්ද ලපනය
bradylogia=මන්ද භාෂ්‍යය
bradytelic=මන්ද්‍රන්තික
brae=කඳු බෑවුම | කඳුපල්ලම | ප්‍රපාතය
brag=පාරට්ටු කරගන්නවා | පුරසාරම් දොඩනවා
braggadocio=පාරට්ටු කරගන්නා | හිස් පාරට්ටුව
braggart=පුරසාරම් කියන්නා | පුරසාරම්කාරයා | පුරාජේරුකාරයා
bragging=පුරසාරම් දෙඩවීම | පුරසාරම් දොඩන
brahma=ප්‍රජාපති | බඹා | බ්‍රහ්මයා | මහා බ්‍රහ්මයා | හින්දු දර්ශනයේ එන මැවුම් කරුවා
brahman=බ්‍රාහ්මණයා
brahman-lizard=හිකනලා
brahmanism=බමුණු දහම | බ්‍රාහ්මණ ධර්මය
brahmin=ගුරුහාමි | දද | ද්විජ | දිජ | බමුණා | බඹ | බ්‍රාහ්මණ | බ්‍රාහ්මණයා
braid=ගෙත්තම් පටිය | ගෙත්තම් මැහුම | ගෙතූ කෙස්වැටිය | ගොතනවා | ගොතා බඳිනවා | පටි අල්ලා මහනවා | බ්‍රේල් අකුරු | බීඩින් ඇල්ලීම | වැටියෙන් සරසනවා | වෙණිය | හැඩපටි | හැඩපටිය
braiding=ගෙතීම | ගෙතුම | හැඩපලු වැටීම
braille=බ්‍රෙිල් | බ්‍රේල් | බ්‍රේල් අකුරු | මතු කළ තිත් යෙදූ ලිපික්‍රමය
brain=ඉස්මොළ | නුවණ | බුද්ධිය | මස්තිෂ්කය | මොලය | මොලය පොඩි කරනවා | මොළය
brain-fag=වැඩ වැඩිකමින් මොලේ ඇතිවන වෙහෙස
brain-pan=හිස්කබල
brain-storm=අධික වන්ත සන්තාපය
brain-teaser=උග්‍ර ප්‍රශ්නය | ගැටලුව
brain-wash=පැරණි අදහස් හැර දමා අලුත් අදහස් භාර ගැනීමට සල
brain-wave=නව අදහස | හදිසියෙන් මතු වන වැදගත් අදහසක් | හදිසියේ මතු වන අදහස
brainchild=අදහස | නිපයුම
braindrain=බුද්ධිමතුන් රටයෑම
brainfever=මොළය ඉදිමීම
brainstorm=මොළය අවුල්වීම
brainstorming=සාමූහිකව ගැටලු විසදීම
brainstrust=බුද්ධි මණ්ඩලය
brainwashing=බුද්ධිශෝධනය
brainy=දක්ෂ | නුවණැති | මොලය ඇති
braise=උයනවා | තම්බනවා
braize=තම්බනවා
brake=අකුල | කැකිල්ල | කැකිල්ල අකුල | ගුල්මය | තළා පොඩි කරනවා | තිරිංග දමනවා | තිරිංග යොදනවා | තිරිංගය | තිරිංගලය | නවතනවා | නවතිනවා | පඳුරු ගොන්න | පඳුරුගොන්න | පල්ලම් පොල්ල | බල්ලා | බල්ලා අදිනවා | රෝධක | රෝධකය | රෝධනය කරනවා | වනලැහැබ | වේගය අඩු කරනවා
braking=කැම | රෝධන කිරීම | රෝධනය
brakish=කිවුල්
braklash=අවර ගැස්ම
bramble=කටුඇඹිල්ල වැනි ගසක් | දහයියා | ධාන්‍යවල පිට සිවිය | පොත්ත
bran=කුරුට්ට | කුරුටු | දහයියා | නිවුඩ්ඩ | නිවුඩු | පරළු
bran-like=නිවුඩු වැනි
branch=අංගය | අත්ත | අතු බෙදී යනවා | අතු විහිදනවා | කොටස | කොටස්වලට බෙදනවා | බෙදෙනවා | විටපය | වෙළෙප | ශාඛා | ශාඛාව | සා | සාඛා
branchia=කරමලය | චක්‍රය | ජලක්ලෝමය
branching=අතු බෙදී යාම | අතු බෙදීම | අතු බෙදීයාම | ශාඛනය | ශාඛා බෙදී යාම | ශාඛාන්‍යාසය
branchlet=රිකිල්ල | ශාඛිකාව
branchy=අතු සහිත
brand=අංකනය | කඩුව | කැලල | කැලැල් කරනවා | ගිනි පෙනෙල්ල | ගිනිපෙනෙල්ල | ද්‍රහය | වර්ගය | වහ්නය | සන්නම | හංවඩු ගහනවා | හංවඩුව | හන | හන තියනවා
brand-mark=අඩායාළම
brand-new=ඉතාම අලුත්
branded=කැලල් සහිත | සන්නම් තැබූ | හංවඩු ගසන ලද | හංවඩු ගැසූ
branding=හංවඩු ගැසීම | හන්නිවරණය
brandish=කඩු කරකවනවා | ලෙළවනවා | විහිදවනවා
brandspore=ද්‍රහ බීජාණුව | යුරිඩොබීජාණුව
brandy=පලතුරු යුසින් පෙරූ මත්පැන් | බ්‍රැන්ඩි
brash=ඉවසුම් නැති | කලබල සහිත | දඩබ්බර | හැඩි දැඩි
brasilin=බ්‍රැසිලින්
brasque=රස්ක
brass=ඉහළ පෙළේ මුලාදෑනි | ගරුසරු නැති බව | පිත්තල | පිත්තල බඩු | බක්කෝ | වට්ටලෝහ
brassage=ටංකන ගාස්තු
brasserie=තනපට
brasses=බෙයාරිම් පළු
brassica=අබ
brassiere=තනපට
brassware=පිත්තල බඩු | පිත්තලබඩු
brassy=උජාරුවට කැමති
brat=කොල්ලා | පැංචා
brattice=බෙදමන් රෙදි
braunite=බ්‍රෝනයිට්
bravado=බොරු චණ්ඩිකම | බොරු චණ්ඩියා | බොරු චන්ඩිකම | ව්‍යාජ තර්ජනය | ව්‍යාජ නිර්භීතකම
brave=අලංකාර සම්පන්න | එඩිතර | කුලියට ගත් චණ්ඩියා | කුලියා | ධෛර්යෙන් ඉවසනවා | නිර්භීත | නිර්භීත තැනැත්තා | ලඝුකොට සිතනවා | වික්‍රමාන්විත | විරුද්ධව ඉදිරිපත් වෙනවා | වීර | සාටෝප
bravely=නිර්භීතව
bravery=ධෛර්යය | නිර්භීතකම | නිර්භීතභාවය | වීර්ය | වීරිය
bravo=අගෙයි | කදිමයි | චණ්ඩිකම් කරන්නා | මිනීමරුවා | සාදු | හුරේ
bravura=වාදන කෞශල්‍යය
brawl=අලකලංවය | කලහ කරනවා | කලහය | කෝලාහලය | සණ්ඩුව
brawler=කලහ කිරීම
brawls=අඬදබර
brawn=මස්ගොබය | ශක්තිය | ශරීර ශක්තිය
brawny=ශක්තිමත්
bray=කන්දොස්කිරියාව | කාහල නාදය | කාහලනාදය | කොටළු හඬ නඟනවා | කොටළු හඩ | කොටළුවාගේ නාදය | බෙරිහන් දීම | බෙරිහන් දෙනවා | වංගෙඩියේ කෙටීම | වනේ දමා කොටනවා
brayer=බ්‍රොයරය
braze=පාගනවා | පිත්තල පොඩියෙන් පාස්සනවා | පිත්තලෙන් පාස්සනවා | බරසනවා | බ්‍රෙස් කරනවා
brazen=කැත | පිත්තලෙන් තැනූ | මුරණ්ඩු ලෙස හැසිරෙනවා | ලජ්ජා නැතිව හැසිරෙනවා | ලෝමුවා | ලෝහමය | විළිලජ්ජා නැති
brazen-faced=අලජ්
brazier=අඟුරු කබල | ගිනිඅඟුරු බඳුන | පිත්තල කම්මල්කාරයා | ලෝකුරුවා
brazing=පෑස්සීම | පිත්තල ගෑම | පිත්තල පොඩියෙන් පෑස්සීම | පිත්තලනය | පිත්තලෙන් පෑස්සීම | බ්‍රෙස් කිරිම
breach=උල්ලංඝනය | උල්ලංඝනය කිරීම | කටු කොහොල් | කඩ කරනවා | කඩ කිරීම | කඩකිරීම | කඩුල්ල | කපල්ල | කපොල්ල | කැඩුම | බිඳ දමනවා | බිඳීම | බිඳුම | බිඳුම්කඩ | භංගය | භේදය | විඩව්ව | විඩවු | විවරය | සිදුරු කරනවා
breached=කැඩුණු | බිඳුණු
bread=ආහාරය | දෙල් | පාන් | රොටි | විකාව
bread-board=පාන් කපන ලෑල්ල
bread-fruit=රටදෙල්
bread-winner=පවුලේ දිවි පෙවෙත රකින්නා
breadbasket=බඩ
breadfruit=දෙල් | රටදෙල්
breadline=හිඟන පෝලිම
breadth=ආයාමය | පළල | පෘථුල බව
breadth-wise=පළල් අතට
breadwinner=උපයන්නා | දිවි පෙවෙත රකින්නා | හම්බ කරන්නා
break=අසනීප වීම | උදා වෙනවා | කඩ කරනවා | කඩනවා | කඩා ගන්නවා | කඩාලනවා | කපොල්ල | කැඩෙනවා | කැම | නැවතීම | බාල කරනවා | බිඳිම | බිඳීම | බිඳුම | භේද කරනවා | භේද වෙනවා | භේදය | මැඩපවත්වනවා | විනාශ කරනවා | විනාශය | විවේකය | වේගය අඩු කරනවා | සිඳ ලනවා | සිඳලීම | හීලෑ කරනවා
break-before-make-contact=සැදුමට පෙර බිඳුම් ස්පර්ශය
break-circuit=පරිපථයක් කඩනවා
break-even=සමායනය | සමායනය කරනවා
break-in=කඩාවැදීම
break-up=කඩා කප්පල් කරනවා | විසුරුවා හරිනවා
break-water=දියකඩනය | රළපණාව | රළපාණ | රළවේග වැටිය
breakable=කැඩිය හැකි | පහසුවෙන් කැඩෙන
breakage=කැඩුණු දේ | කැම | බිඳීම | බිඳුම | හානිය
breakaway=අපසරණය | හැර යනවා
breakdown=අනුඛණ්ඩනය | ආපදාව | ඇද වැටෙනවා | ක්‍රියා විරහිතවීම | ප්‍රභේදනය | බිඳ වැටීම | බිඳ වැටුම | බිඳ වැටෙනවා | බිඳ හෙලනවා | බිඳවැටීම | භංජනය
breaker=කඩනය | කඩන්නා | විශාල මූදු රළ
breakfast=අලුමුසුව | උදේ කැම වළඳනවා | උදේ කෑම | උදේකෑම | ප්‍රාතරාශය | හීල
breaking=ඛණ්ඩනය | භේදනය | ලේ කඩ
breakout=නොසරුප් ලෙස හැසිරෙනවා
breaks=විකාර
breakthrough=කඩා බිඳගෙන යනවා | පාරවේධනය
breakwater=දියකඩනය | වාරිබන්ධය
breakwind=හුළං වැටිය
bream=කහපාට මත්ස්‍ය වර්ගයක් | කුඩා මත්ස්‍යයෙක්
breast=උර | ඔර | තනය | තුනුපල | තන | නැග්ම | පපුව | පපුව පානවා | පයෝධර | පයෝධරය | පියයුරු | පියවුරු | හිත | හෘදය | ළපැත්ත | ළය
breast-bone=පපුඇටය
breast-high=තන මත්තක් උස
breast-milk=මව්කිරි
breast-plate=කවචය
breast-stroke=උර පහර
breast-work=මිටි පවුර
breastwork=මිටි පවුර
breath=ආශ්වාස ප්‍රශ්වාසය | ආශ්වාසය | ප්‍රශ්වාසය | ප්‍රාණය | ප්‍රාණවාතය | මඳ පවන | ශ්වාස | ස්වාස | සුස්ම | සුසුම් | හුස්ම
breath-taking=හුස්ම ගැනීම
breathalyser=ප්‍රශ්වාස වාතයේ ඇති මද්‍යුසාර ප්‍රමාණය මනින උපකරණය
breathe=ආශ්වාස ප්‍රශ්වාස කරනවා | වත් වෙනවා | හමනවා
breathed=අඝෝෂ
breather=ශ්වාසකය | සුළු විවේකය | හ්වාසකය
breathing=ආශ්වාස | ප්‍රශ්වාස කිරීම | ශ්වසනය | සවස | හුස්ම ගැනීම | හුසුම හෙළීම
breathing-space=විරාමය | ශ්වසන අවකාශය | සුළු විවේකය
breathless=නිශ්වාස | සුළං නැති විස්මිත | හති දමන | හුස්ම ගැනීමට අමාරු
breccia=බ්‍රෙෂියා
bred=ඇති කළ | උපන් | පුහුණු කරනලද | හැදූ
breech=කටී ප්‍රදේශය | තට්ටම | තුවක්කු කඳ | තුවක්කුවේ පස්සා කොටස
breeches=සරුවාලය
breed=අභිජනක කිරීම | අභිජනනය | අභිජාතිය | උපද්දනවා | ජාතිය | ප්‍රජාව | පැටව් ගහනවා | බෝ කරනවා | බෝකිරීම | වංශය | වර්ගය
breeder=උපජනකය | සත්වපාලකයා | සතුන් ඇති කරන්නා
breeding=අභිජනනය | ආචාරය | උත්පාදනය | උපජනනය | බෝ කිරීම | බෝවීම | ශික්ෂණය
breeding-ground=අභිජනන භූමිය | බෝවන තැන
breeze=අරගලය | ගල්අඟුරු කැබිලිති | දැවිසුනු | පවන | මඳ සුළඟ | සුළඟ | හමනවා
breeze-block=සැහැල්ලු ගඩොල් ජාතියක්
breezeway=නිවාස අතරේ දෙවට
breezy=මඳ පවන් ඇති | විහිළු තහළු ඇති
bregma=බ්‍රාහ්මය
bren=මැෂින් තුවක්කුව
brent=කුඩා වර්ගයේ පාත්තයෙක්
brer=සහෝදරයා
bressummer=බාපත
brethren=නෑයෝ | සහෝදරයෝ
breton=බ්‍රිතාන්‍යයයේ වැසියා
breve=සංගීතයෙහි අතිදීර්ඝ ස්වරය
breviary=ජපමාලාව | පූජා පොත | පූජාපොත | යාච්ඤා පොත | විධිස්තෝත්‍ර සංග්‍රහය | ස්තෝත්‍ර සංග්‍රහය
brevier=පොයින්ට් | මුද්‍රණ අකුරු
brevity=කෙටි බව | ලුහුඩුකම | සංක්ෂිප්තභාවය | සංක්ෂේපය
brew=කකාරවනවා | කෂාය | කැකෑරෙනවා | පැසවනවා | පැසෙනවා | පෙරනවා
brewer=බීර පෙරන්නා
brewery=ආසවනාගාරය | මත්පැන් පෙරන ස්ථානය | මද්‍යාගාරය | මද්‍යු පෙරන සථානය
briar=ගොකටු | ගෝක්ෂුර | වල් රෝස | වලෝස
bribe=අත්ලස | අල්ලස | අල්ලස් ගන්නවා | අල්ලස් දෙනවා | ජරාව | පගාව
bribee=අල්ලස් ලබන්නා
bribery=අල්ලස | අල්ලස් ගැනීම | අල්ලස් දීම
bric-a-brac=අරුමෝසම් බඩු | පොඩි ආභරණ | පොඩි පොඩි ආභරණ
brick=ආදරයෙන් සලකන කෙනෙක් | උළු | උළු කැටය | ගඩොල | ගඩොල් | ගඩොල් අල්ලනවා | ගඩොල් කැටය | ගඩොලින් බඳිනවා | ගඩොළ | හුළු
brick-bat=ගඩොල් කැබැල්ල | ගල් කැටය
brick-kiln=ගඩොල් පෝරණුව
brick-layer=ගඩොලින් ගෙවල් බඳින්නා
brickbat=අපහාසය | ගඩොල් කැබැල්ල
brickfielder=බ්‍රික්පීල්ඩර සුළඟ
bricklayer=උළුවඩුවා | ගෙවල් බඳින්නා
bricklaying=ගඩොල් ඇල්ලීම
bricks=ගඩොල් | ගඩොළු
brickwork=ගඩොල් බැම්ම
brickyard=ගඩොල් පෝරණුව
bridal=මංගල | මනමාලි පිළිබඳ | මනමාලිය පිළිබඳ වූ
bride=ඇම | මනමාලි | මනමාලිය
bride-groom=මනමාලයා
bridegroom=මනමාලයා
brides-maid=දෙවන මනමාලිය
bridesmaid=මනමාලියගේ යෙහෙළිය
bridge=අත් ඇන්ද | ඒදණ්ඩ | ඒ‍ය | කඩදාසි ක්‍රීඩාවක් | පාලම | පාලමක් තනනවා | පාලම් දමනවා | සේ | සේතුව | හෙ | හෙය
bridge-arch=පාලම් ආරුක්කුව
bridge-building=භේද වූවන් අතර සාමය ඇති කිරීම
bridge-girder=පාලම් තට්ටුව
bridged=සංක්ෂිප්ත | සේතු ලූ
bridgement=කෙටි කිරීම | සංක්ෂිප්තය | සාරය
bridging=සේතු ලෑම | හේයම
bridle=කටකලියා දමනවා | කටකලියාව | කටකලියාව දමනවා | කඩියාලම | කලියාව | තෝන් ලනුව | මැඩපවත්වනවා | රශ්මිය | වේගය මැඩපැවැත්වීමේ උපක්‍රමය
bridle-path=අස්මඟ | පටු පාර
bridle-road=පටු පාර
bridle-way=පටු පාර
brie=කේජු විශේෂයක්
brief=අචීර | උපදෙස් දෙනවා | ක්ෂණික | කෙටි | කොට | නඩු කොපිය | නඩු ගොනුව | නඩුපිටපත | ලිපි සටහන | ලුහුජු | ලුහුජු සටහන | විස්තර සපයනවා | සංක්ෂිප්ත | සංක්ෂේපය | සකෙවු | සාරාංශය | සැකෙව්
briefcase=ලිපි කොපුව | ලිපිකොපුව | ලිපිපෙට්ටිය
briefly=සැකෙවින්
brier=ගොකටු | වල් රෝස
brig=දෙකුඹ නැව | දෙකුඹු නැව
brigade=භට කණ්ඩායම | වාහිනිය | සේනාංකය | සේවක සමූහය | හමුදාංකය
brigadier=විහිනීපති | සේනාංකපති | සේනාධිපතියා | හේවා කණ්ඩායමක අධිපතියා
brigadier-general=සේනාධිපතියා | හේවා කණ්ඩායමක අධිපතියා
brigand=පල්හොරා | මංකොල්ලකාරයා | මංපහරන්නා | හොරා
brigandage=කොල්ලකෑම
brigantine=දෙකුඹු නැව
bright=උදුල | චතුර | දක්ෂ | දිමුතු තෙල්ල | දීප්ත | දීප්තිමත් | නිමල | ප්‍රජ්වලිත | ප්‍රභාවත් | ප්‍රභාසම්පන්න | ප්‍රීතිසහගත | පැහැපත් | බබලන
brighten=ආලෝක කරනවා | ඔප දමනවා | බබලවනවා | බබළනවා
brightness=කැලුම | තර | දීප්තිය | ප්‍රභාව | ප්‍රසාද ගුණය | බැබළීම
brill=පැතලි මාළුවෙක් | පැතැලි සුදු පුල්ලි සහිත මූදු මාලුවෙක්
brilliance=උද්දීප්තිය | කාන්තිය | දීප්තිය | ප්‍රජ්වලනය | ප්‍රභාව | බැබළීම | බෙරලියන්තු
brilliant=අතිදක්ෂ | උද්දීප්තිය | කාන්තිමත් | ජෝතිමත් | දීප්ත | පැහැසර | බබළන | බෙරලියන්තු | භ්‍රාජමාන
brilliantine=කේශාලේපය
brilliantly=කාන්තිමත් ලෙස | දීප්තිමත්ව
brim=ඉවුරු කට | කට | කට දක්වා පිරෙනවා | ගැට්ට | ගැටිය | ගැටිය දක්වා පිරෙනවා | ගැටිය දක්වා පුරවනවා | තීරය | පිරෙනවා | මුවවිට | මෝවිට | වාටිය | සම්පූර්ණයෙන්ම පුරවනවා
brim-stone=ගෙන්දගම්
brimful=කට දක්වා පිරුණු | ගැටිය දක්වා පිරුණු | පෙත්තට පිරුණු
brimfull=නොපොවන
brimmed=ගැටිය දක්වා පිරුණු | පෙත්තට පිරුණු
brimming=ගැටිය දක්වා පිරුණු | පෙත්තට පිරුණු
brimstone=ගෙන්දගම් | ගෙන්දගම් ගල් | බ්‍රිම්ස්ටෝන්
brindled=ඉරි වැටුණු | ලප සහිත | වයිරම් වැටුණු | ශබල
brine=අතික්ෂාර | කඳුලු | කරදිය | කරිජ්ජ | මුහුද | ලුණු සහිත | ලුණුදිය
bring=ඇන්න එනවා | උපදවනවා | කැටුව එනවා | කැඳවාගෙන එනවා | ගෙනෙනවා | පමුණුවනවා
bringback=සිහි කරනවා | සිහි වෙනවා
brinjal=වම්බටු
brinjals=වම්බොටු
brink=අද්දර | අයින | ආසන්නය | ඉවුර | ජලතීරය | ප්‍රපාතගැට්ට
brinkmanship=අවදානම් සීමාවට යෑම
briny=ලවණ සහිත | ලවණමය
brio=ප්‍රාණවත්කම | ශක්තිය
briquette=ගඩොලිත්ත | සම්පීඩනයෙන් කුට්ටි කරගත් ගල් අඟුරු
brisance=ස්ඵෝටන වේගය
brisk=ඉක්මන් | උනන්දු | කඩිසර | දක්ෂ | ප්‍රාණවත් | යුහුසුලු | ශීඝ්‍ර
brisket=ඉළ ඇට සමීපයේ ඇති මස් | ඉළඇට සමීපයෙහි ඇති මස් | වක්ෂය
brisling=හාල් මැස්සා
bristle=කිපෙනවා | කූර | කෙන්ද | දළ ලෝම | දැඩිකෙන්ද | පොල් කෙඳි | රළු කෙන්ද | රළු ලෝම
bristling=කෙඳි සහිත
bristly=කෙඳි සහිත | රළු කෙදි සහිත
britain=බ්‍රිතාඤ්ඤය | බ්‍රිතාන්‍යය
britannic=බ්‍රිතාන්‍ය | මහා බ්‍රිතාන්‍යයට අයත්
british=බ්‍රිතාන්‍ය | බ්‍රිතාන්‍යය
britisher=බ්‍රිතාන්‍ය වැසියා
briton=බ්‍රිතාන්‍යයා | බ්‍රිතාන්‍යයේ වැසියා
brittle=පහසුවෙන් කැඩෙන | බඳෙනසුලු | බිඳෙනසුලු | භංගුර
brittle-star=මුහුදු බළලා
brittleness=බිඳෙනසුලු බව | භංගුරතාව
brive=ජඤ්චය
broach=අරිනවා | උල | කටුව | කීලය | කූර | පීප්පයක් විදිනවා | විදය | විදිනවා | හිල් කරනවා
broaching=විදයීම
broad=ග්‍රාම්‍ය | පහැදිලි | පළල් | පැතුරුණු | පෘථුල | මහත් | විශාල
broad-minded=ඉවසනසුලු | පුළුල් හදවතක් ඇති
broad-sheet=පැත්තක් මුද්‍රිත කඩදාසිය
broad-side=නැවේ පැත්ත | මහා ප්‍රහාරය | වාක්ප්‍රහාරය
broad-stuff=පට රෙදි | සේද රෙදි
broadast=හියාරනවා
broadcast=ඉහිනවා | ගුවන් ප්‍රචාරය | ගුවන් විදුලි ප්‍රචාරය | ගුවන් විදුලි ප්‍රචාරය කරනවා | ගුවන්විදුලි ප්‍රචාරය | පතුරුවනවා | ප්‍රචාරණ | ප්‍රචාරය | පැතුරුම | වපුරනවා | වැපිරීම | විකාශනය | විකාශනය කරනවා | විසුරුවනවා | විසුරුවා හරිනවා
broadcaster=ප්‍රචාරකයා | වපුරන්නා
broadcasting=ගුවන්විදුලි ප්‍රචාරය | ප්‍රචාර | පැතිරවීම | වැපිරීම
broadcloth=නිමි රෙද්ද
broaden=පළල් කරනවා
broadly=පුළුල් වශයෙන්
broadness=පළල | පුළුල් බව | විශාලත්වය
broadsheet=පැත්තක් මුද්‍රිත පත්‍රය
broadside=නැවේ පැත්ත
broadsword=පළල් කඩුව
broadway=පළල් පාර | මහවත
broadways=පළල් අතට | හරහට
brob=කණ ඇණය
brocade=පලු වැඩ | පලුවැඩ | විසිතුරු ගෙත්තම් කළ පට රෙද්ද | විසිතුරු ගෙත්තම් කළ පටරෙද්ද
brocaded=සියුම්ව ගෙත්තම් කළ
broccoli=ගෝවා වර්ගයක්
broche=විදය
brochure=කුඩා පොත | පොත් පිංච | රංග පත්‍රිකාව
brockram=බ්‍රෝක්‍රම
brocoli=රතු මල්ගෝවා ගෙඩිය
broderie=සුදු ලිනන් රෙද්දෙහි කරන එම්බ්‍රොයිඩරි වැඩ
broggerite=බ්‍රොගරයිට්
brogue=අපභ්‍රෂ්ට උච්චාරණය | අයිරිෂ් ස්වරය | ඝන අඩි සපත්තුව
broil=අරගලය | උණු අඟුරෙහි පුලුස්නවා | කලහ කරනවා | කලහය | කෝපයෙන් දැවෙනවා | දබරය | පලහනවා | බදිනවා | බැදෙනවා | සණ්ඩුව
broiler=ඉක්මනින් වැඩුණු කුකුල් පැටියා | කුකුළු මස්
brokage=තැරැව් ගාස්තුව | තැරැව්ව
broke=කැඩුවා | තුට්ටුව නැති | නිලෙන් පහ කළ | බංකොලොත්
broken=කැඩුණු | ඛණ්ඩ | ඡින්න | පරිච්ජීන්න | බුන් | භංග | භින්න | ලූප්ත | සභංග
broken-hearted=අධෛර්ය වූ | බලාපොරෙත්තු සුන් වූ | බලාපොරොත්තු සුන් වූ | මහත් දුකින් පෙළෙන
broker=කපුවා | තැරැව්කරු | තැරැව්කාරයා | තැරැව්කාරයා | තැරුව්කරු | බ්‍රෝකර | බ්‍රෝකර් | මඟුල් කපුවා
brokerage=කපු ගාස්තුව | තැරැව් කුළී | තැරැව් ගාස්තු | තැරැව් ගාස්තුව | තැරැව් ගාස්තුව | තැරැව්ව | බ්‍රෝකර් ගාස්තු | බ්‍රෝකර් ගාස්තුව | බ්‍රෝකර්ගේ ගාස්තුව
brolly=කුඩය
bromate=බ්‍රෝමේට්
bromated=බ්‍රෝමීකෘත
bromation=බ්‍රෝමීකරණය
bromatology=භෝජ්‍ය විද්‍යාව
bromelin=බ්‍රෝමෙලින්
bromethol=බ්‍රොමිතෝල්
bromide=බ්‍රොමයිඩ් | බ්‍රෝමයිඩ් | රසායන සංයෝගයක්
bromination=බ්‍රෝමිනීකරණය
bromine=බ්‍රෝමීන්
bromism=බ්‍රෝමියාව
bromometry=බ්‍රෝමොමිතිය
bronchial=ක්ලෝම | ශ්වාසනාල පිළිබඳ
bronchicle=ශ්වාසනාල ශාඛාව
bronchiectasis=ක්ලෝමමායාමය | බ්‍රොන්කියෙක් ටැසීස්
bronchioles=අනුක්ලෝම
bronchitic=ක්ලෝමප්‍රදාහමය
bronchitis=ක්ලෝම ප්‍රදාහය | ක්ලෝමදාහය | ක්ලෝමප්‍රදාහය | බ්‍රොන්කයිට්ස් | ශ්වසනාලිකා ප්‍රදාහය
bronchogram=ක්ලෝම රේඛය | ක්ලෝමරේඛය
bronchograph=ක්ලෝම රේඛකය | ක්ලෝමරේඛකය
bronchography=ක්ලෝම රේඛණය
bronchopneumonia=ක්ලෝමනියුමෝනියාව | බ්‍රොන්කොනියුමෝනියාව
bronchus=අනුශ්වාසනාලිකා | ක්ලෝමය | ශ්වාස නාලිකාව | ශ්වාසනාලය | ශ්වාසනාලිකාව
bronhography=ක්ලෝමරේඛනය
brontosaurus=ආදිකල්පික ශාක භක්ෂකයෙක් | බ්‍රොන්ටෝසෝරස්
bronze=බට්ටලෝහ | ලෝකඩ | ලෝකඩ ගානවා | ලෝකඩ වර්ණය | ලෝකඩින් සැදූ රූපය
bronzing=පිත්තල පාට වීම
brooch=සාරි කටුව | සාරිකටුව | හාරිච්වය | හිරිච්වය
brood=කල්පනා කරනවා | දරු පවුල | පැටව් රොත්ත | බිත්තර රකිනවා | රකින ලද්ද | රකිනවා | රැක බලාගන්නවා | රොත්ත | සමූහය | හැත්ත
brooder=රකින තැන
brooding=කල්පනාවෙහි යෙදුණ
broodmare=රකින වෙළඹ
broody=කල්පනාවෙහි යෙදුණ | බිත්තර රකින
brook=ආර | ඇල | ඉඩ දෙනවා | ඉවසනවා | ඔය | දියත්ත | දියපාර | දොළ | විඳගන්නවා
brookite=බෲකයිට්
brooklet=කුඩා ඔය | දොළ
broom=ඉදල | ඉළපත | කොස්ස | පඳුර | බුන්දලේ | බූන්දලය | මුස්න | මුස්නය | මුසුන | හිදල
brooming=කොහු ගැහීම
broomstick=ඉදල් මිට | ඉදල්මිට | කොහු මිට | කොහුමිට
broth=තැම්බුන් හොද්ද | සූපය | හොද්ද
brothel=ගණිකා මඩම | ගණිකාවාසය | ගණිකාහල | වේශ්‍යාගාරය | වේසා මුඩුක්කුව
brother=එක ආගමේ තැනැත්තා | එක පක්ෂයේ තැනැත්තා | එක සමාගමේ තැනැත්තා | බෑ | බෑයා | භ්‍රාතෘ | භාතු | භාතෘ | සහජ | සහෝදර | සහෝදරයා | සොහායුරු | සොහොයුරා | සෝයුරා
brother-in-law=මස්සිනා | සුහුරුබඩු
brotherhood=භාතෘත්වය | සමාජය | සහෝදර පිරිස | සහෝදරකම | සහෝදරත්වය
brotherliness=ස්නේහවන්තකම
brotherly=සහෝදර | සහෝදරයන් වැනි | ස්නේහවන්ත | සෙනේහවන්ත
brothers=සඟල බානාව
brougham=එක අශ්වයකු යොදන ලද | රෝද සතරක් ඇති රථය
brouhaha=කලබැගෑනිය
brow=කඳු කෙළවර | ගැට්ට | නළල | පෙන්ද | බැම | බෑවුම
brow-beaten=භය කළ
browbeat=අයුතු සේ බලපානවා
brown=තලඑළලු | දුඹුරු | දුඹුරු කරනවා | දුඹුරු පාට | දුඹුරු වර්ණය | දුඹුරු වෙනවා
brown-bread=පරළු පාන්
brown-paper=දුඹුරු කඩදාසිය
brownie=කනිෂ්ඨ බාලදක්ෂයා
browning=දුඹුරු කුඩු
brownish=දුඹුරට හුරු | දුඹුරු
brownstone=දුඹුරුගල
browny=දැඩි මස් පිජු සහිත | ශක්තිමත්
browse=අනියම් කියවීම | උඩින් උඩින් කියවනවා | උලා කනවා | උලා කෑම | පොත් උඩින් උඩින් බලනවා | පොත් පෙරළා බැලීම | ලෑටිගානවා | ලෑටිගෑම | විමසනවා
brrister=බැරිස්ටර
brshama=බ්‍රහ්ම
brucellosis=ගව මහිෂ ආදි සතුන්ට බැක්ටීරියා මගින් සෑදෙන ලෙඩක | බෘසෙලෝසියාව
brucine=බෲසීන්
brue=වනචරයා
bruikleening=පිරිවුළු දීම
bruin=වලහාට නමක්
bruise=අඹරනවා | තළනවා | තැල්ම | තැළීම | තැළුම | තැළෙනවා | පොඩි කරනවා | පොඩි කිරීම | පොඩි වෙනවා | සිවිය තුවාල කරනවා | සීරීම | සීරෙනවා | හම තුවාල කරනවා
bruit=ඝෝෂාව | ජනප්‍රවාදය | පතුරුවනවා | පැතුරුනු ආරංවය
brummagem=කූට | බොරු පෙනුම ඇති
brunch=අතුරු කෑම | හීල හා දවාල අතර කෑම
brunette=තල එළලු ස්ත්‍රිය | තළඑළලු ස්ත්‍රිය | බෲනට්
brunsviga=බ්‍රංස්විගා
brunt=පහර | ප්‍රධාන පීඩාව | ප්‍රහාර පීඩාව
brush=අතුගානවා | අතුල්ලනවා | ඇතිල්ල | ඇතිලි අල්ලුව | ඇතිලි ධාරකය | උලනවා | ඔප දමනවා | කොස්ස | ගැටෙනවා | ඝට්ටනය | තුලිකාව | තූලිකා | තූලිකාව | තෙල්ල | තෙලිකූර | තෙලිතුඩ | නරියාගේ වල්ගය | පින්සල | පිසදමනවා | පිසිනවා | පීරනවා | බඩ වැටිය | බඩවැටිය | බුරුසුව | බූන්දලය | මදිනවා | මුස්නය | යන්තමින් වැදෙනවා | ශුද්ධ කරනවා | සුළු සටන | හැපෙනවා
brush-wood=අකුල | වදුල | වනලැහැබ
brushwood=අකුල | ගැහැටි මිටි | වදුල | වනලැහැබ
brushwork=තෙල්ලම | තෙලිකම | තෙලිතුඩ වැඩ
brusque=ඉක්මන් | ගොරෝසු | දඩබ්බර | පරුෂ | රළු
brusqueness=රළුකම
brutal=අතිශයින් රාගාධික | ක්‍රූර | කුරිරු | කෲර | තිරිසන් ගති ඇති | දරුණු | දාමරික | වනචාරී | සාහසික
brutality=ක්‍රූරත්වය | කෲරභාවය | රෞද්‍රගතිය
brutalization=මෘගයනය
brutalize=ආවේශ වෙනවා | තිරිසනකු බවට පමුණුවනවා | තිරිසනෙක් වෙනවා
brutally=ක්‍රූර ලෙස | සාහසිකව
brute=චණ්ඩ | තිරිසන් | තිරිසන්කම | තිරිසනා | තිරිසනෙක් වැනි තැනැත්තා | දරුණු | මෘග | මෘගයා | මෘගයා තිරිසනා
brutes=අවිචාරීහු
brutish=අතිශයින් රාගාධික | කෲර | තිරිසන් ගති ඇති | දරුණු | මෘග
bryology=බ්‍රයෝ විද්‍යාව
bryonine=බ්‍රයෝනීන්
bryophyta=බ්‍රීයොපීටා
bryophytic=බ්‍රීයෝශාකීය
btitisher=බ්‍රිතාන්‍යයා
bubble=පෙණ නගිනවා | බිබිල | බුබ්බුල | බුබුල | බුබුලු දමනවා | බුබුළ | බුබුළු දමනවා | බුබුළු නගිනවා | බුබුළුව | මායාව | රැවටිල්ල | සිනහවෙන් මිරිකෙනවා
bubbles=බුබුළු
bubbling=බිබිලීම | බුබුලන
bubo=අතේ හෝ ඉකිලියේ ඇති වන ඉදිමුම
bubonic=කුද්දටි ඉදිමීම | කුද්දෙටි ඉදිමීම | කුද්දෙටි ඉදිමීම ඇති
buccaneer=කපටියා | මුහුදු කොල්ලකාරයා | මූදු කොල්ලකාරයා
buchu=බුකුව
buck=එළුවා | ජේත්තු කාරයා | ජේත්තු වෙනවා | ඩොලර් කාසිය | දෝෂය | මුවා | සිලිම | හතර ගාතෙන් පනිනවා | හෙළීම
buck-tooth=උල්දත
buck-wheat=බඩ ඉරිඟු
bucked=උද්දාමයට පත්ව
bucket=පනිට්ටුව | බකට්ටුව | බඳුන | බාල්දිය | බාලිකා | වක්කරනවා | හළනවා
bucket-piston=බඳුන් පිස්ටනය
bucket-shop=ඔට්ටුපළ | බුකිය | හොර ඔට්ටු පොළ
bucketelevator=බඳුන් ඔසොව්ව
bucketful=පුරා බාල්දියක් | බාල්දිය පුරා
bucketshop=හොර සට්ටුපොළ
bucking=බකලය
buckle=කුඩුපය | ගාංචු දමා බඳිනවා | ගාංචුව | ගෑස්පරය | නැමෙනවා | පට්ට බන්ධය | බකලය | වක් වෙනවා
buckler=කුඩා පලිහ
buckling=නොමටකම | නොමට්ටම | බකල ගැසීම | බකල වීම
buckram=බක්‍රම් | මැලියම් ගෑමෙන් ඝන කරන ලද රෙද්ද
buckshee=නොමිලේ
buckshot=ලොකු පතරොම
buckskin=එළු මහ | මුව හම
buckstaves=බිහිතහඩු
buckup=ඉක්මන් කරනවා | කඩිසර වෙනවා
buckwheat=බක්වීට් තිරිඟු | බඩ ඉරිඟු
bucolic=ගම්බද | ගැමි | පිටිසර
bud=අංකුරය | ගොබය | දල්ල | දලු ලනවා | දළුලනවා | දළුව | මල් ලනවා | මුකුල | මොට්ටුව | වැඩෙන්ට පටන් ගන්නවා | ළිදිරනවා
budded=දළු පුරුද්දන ලද | බද්ධ | ළුදුළ | ළොදුළු
buddelia=කහ මල් ඇති ගස් වර්ගයක්
buddha=ජීන | තථාගත | තිලෝගුරු | දශබල | දිනිඳු | දිනිසුරු | දියනා | දියනෙත | බුද්ධ | බුදු | බුදු හිමි | බුදුහාමුදුරුවෝ | මුනි | මුනින්දා | මුනිඳු | මොකැදුරු | රත්නත්‍රය | ලෝකනාථ | ශාක්‍යමුනි | ශාස්තෘ | සමතැස් | සමන්තචක්ඛු | සමන්තභද්‍ර | සම්බුද්ධ | සම්බුදු | සර්වඥ | සවැණි | සෑසී | සුගත | සුගත් | සුගතිඳු
buddhism=ආර්ය ධර්මය | ධර්මය | ප්‍රවචන | පාවචන | බුද්ධ ධර්මය | බුද්ධධර්මය | බුද්ධාගම | බුදුදහම | බුදුසමය | විභජ්ජවාදය | සදම් | සදහම් | සද්ධර්මය | සම්‍යක් දෘෂ්ටිය | සාසනය
buddhist=බුදුනු | බොදු | බෞද්ධ | බෞද්ධයා | ශාසනය | සම්දිටු
budding=අංකුර බද්ධය | අංකුර වැම | අංකුරනය | දළු පිරිද්දීම | දළු ලෑම | දියුණු වේගන එන | බද්ධ කිරීම | වැඩෙන
buddy=අඹ යහළුවා | අඹයාළුවා | මිතුරා
budge=ටිකක් ඉඩ දෙනවා | මඳක් ඉඩ දෙනවා | මඳක් ඉවත් වෙනවා | මඳක් ඉවත්ව යනවා | සෙලවෙනවා | සොලවනවා
budgerigar=ඔස්ට්‍රේලියානු ගිරව් විශේෂයක්
budget=අය වැය ලේඛණය | අය වැය ලේඛනය | අය වැය වාර්තාව | අයවැය | අයවැය ලේඛණය | අයවැය ලේඛනය | අයවැය වාර්තාව | අයවැය සකසනවා | අයවැයකරය | ප්‍රවෘත්තිය | පෙර ගිණුම | බජටය | ලියුම් මල්ල | ලේඛනය
budgetary=අයවැය පිළිබඳ | අයවැය ලේඛනය පිළිබඳ
budgeting=අයවැය සකස් කිරීම
budgetting=අයවැයකරණය
budgrafting=අංකුර බද්ධය
budlet=කුඩා අංකුරය
buff=අඳුරු කහපාට සම | ඔපකරය දමනවා | තුනී මීහරක් හම | තුනී හමකින් මදිනවා | මඳක් පඳුවන් පැහැය | යුද්ධ භටයන්ගේ හැට්ටය | ලෝපකුරුව | හමුදා ඇඳුම
buffalo=අවරෝධකය | මහිෂ | මිවුවා | මී හරකා | මීහරකා | හාදයා
buffalo-ghee=දුන්තෙල්
buffer=අන්තරාචය | අරෝධකය | අවරෝධකය | ස්වාරක්ෂකය | හාදයා
buffet=කෑම කවුළුව | කෑම තබන මේසය | තට්ටු කරනවා | තමතමන් බෙදා ගත යුතු කෑම | තල්ලු කරනවා | දෛවයෙන් ලැබෙන පහර | පහර | පහර දෙනවා | පිඟන් කෝප්ප රාක්කය | පිඟන් මේසය | රලපහර | රළපහර | සටන් කරනවා
buffet-car=මිරිය මැදිරි ආපනශාලාව
buffiing=ලෝප දැමීම
buffing=ඔපකරය දැමීම
buffoon=කවටයා | බම්මන්නා | බහුබූත | මෝඩයා | විකටයා | විගඩම්කාකරයා | විගඩම්කාරයා
buffoonery=කවටකම | බහුනාටක | විගඩම | විහිළු ලෙස හැසිරීම
bug=දෝෂය | මකුණා | රෝගබීජය
bug-bear=කරදරය | බියපත් වන කාරණය | හිරිහැරය
bugaboo=බොරු බය | හුඹස් බය
bugbear=නිතර ඇතිවන භය | නිතර ඇතිවන හිරිහැරය
bugger=අශික්ෂිතයා | කරදරකාරයා | තරහ පළ කරනවා | මගෝඩිකම් කරනවා | මගෝඩියා
buggery=ගුද මෛථුනය
buggy=බක්කි කරත්තය | බක්කිය | සැහැල්ලු රථය
bugle=කාහලය | නළාව | හොරණෑව
bugler=නළාකාරයා | හොරණෑකාරයා
buhl=කැටයම් කලාවක්
build=අටවනවා | ආකාරය | ඉදි කරනවා | ඉඳිකරනවා | ගොඩ නංවනවා | ගොඩ නඟනවා | ගොඩනගනවා | තතනවා | තනනවා | රූපය | ශරීර ප්‍රමාණය | සාදනවා | හදනවා | හැඩය | හැඩහුරුකම
build-up=නැඟුම
builder=ගොඩනඟන්නා | තනන්නා
building=ගෙවල් තැනීමට ණය මුදල් දෙන සමිතිය | ගොඩනැගිල්ල | ගොඩනැඟිල්ල | තැනිල්ල | නිර්මාණය | හැදිල්ල | හැදිලි
buildup=ක්‍රමයෙන් උසස් කරනවා | වැඩිදියුණු කරනවා
built=ගොඩ නගන ලද
built-in=එකටම සෑදූ | තිළැලි | තිළෑලි | යාකොට සෑදූ
built-in-stabilisers=තිළැලූ ස්ථායීකාරක
built-up=ගොඩනැගිලි පිරුණු | වැඩි දියුණු කළ
bulb=අල | අලය | ගෝලාකාර පහන | බල්බය | බික | බුබුල | බුබුළ
bulbaceous=බල්බ වැනි
bulbiferous=බල්බ සහිත
bulbiform=බුම්බුලාකාර
bulbil=බල්බිලය | බල්බීලය
bulblet=කුඩා බල්බය
bulbose=බල්බ හැඩ
bulbous=ගෝලාකාර | ගෝලාකාර | බුබ්බුලාකාර | වටකුරු | සබල්බ
bulbul=කොවුලා වැනි පක්ෂියෙක්
bulbule=බල්බීලය
buldozer=සමතලා කරන යන්ත්‍රය
bulgarine=බල්ගරින්
bulge=අධිකය | ඉල්පෙනවා | ඉලිප්පීම | ඉලිප්පෙනවා | නෙරනවා | නෙරා යනවා | නෙරා සිටිනවා | නෙරීම
bulgy=ඉලිප්පුණු | නෙරා ඇති | නෙරූ
bulimia=අතික්ෂුධාව
bulk=කැපී පෙනෙනවා | ගොඩ | තොග | තොගය | නිකර | ප්‍රමාණය | මහත් | මහත් වෙනවා | රාශිය | වැඩි පංගුව | වැදගත් වෙනවා | විශාල | සම්හාරය
bulk-head=නැවක කොටස් වෙන් කරන බෙදීම | බඳ හිස
bulkhead=නැවක කොටස් වෙන් කරන බෙදීම | පිරිවුර | බඳහිස
bulkiness=ස්ථුලබව
bulking=ගොඩගැසීම | තොග රැස්කිරීම | පිපීම | වෘද්ධිය
bulky=දළ | මහත් | විශාල | ස්ථූල
bull=අලියා ආදීන්ගේ පිරිමි සතා | උසබා | උසභ | ඔසබ | කථාවෙහි පරස්පරවිරෝධ වාක්‍ය | කථාවේ පරස්පර විරෝධී වාක්‍යය | ගැනුම් ජාවාරම්කාරයා | ගොනා | ජාවාරම්කාරයා | වසබ | වසභ | වැහැප් | වෘෂභ | වෘෂභයා | සුරතල් මසු
bull-finch=කඩු සරඹයෙහි දක්ෂයා
bull-frog=අමෙරිකා ගෙඹි ජාතියෙක් | විශාල ගෙම්බා
bull-headed=මුරණ්ඩු
bulla=බුද්බුද | බුද්බුදය
bullae=බුබ්බුලය
bullate=බුද්බුද
bulldoze=අස් කරනවා | බිය කරනවා | සමතලා කරනවා
bulldozer=බුල්ඩෝසරය
bullet=උණ්ඩය | පතරොම | මූනිස්සම | මූනිස්සම් | වෙඩි උණ්ඩය | වෙඩිගුළිය
bullet-headed=කුඩා හිස සහිත
bullet-proof=වෙඩි නොවදින
bulletin=නිවේදන පත්‍රිකාව | ප්‍රවෘත්ති නිවේදනය | බුලටිනය | බුලටීනය | ලුහුජු ප්‍රකාශය | ලුහුඩු ප්‍රකාශය | විවරණිකාව | සඟරාව
bulletine=විවරණිකාව
bulletproof=වෙඩි නොවදින
bullfight=ගොන්පොරය
bullfinch=ගී ගයන කුරුල්ලෙක්
bullfrog=විශාල ගෙඹි වර්ගයක්
bulliform=බුද්බුද්‍රකාර
bulling=පැලි පිපිරැවීම
bullinus=බුලිනස්
bullion=ගන රන් | ගන රිදී | ගනරන් | ගනරන් පිජ | ගනරිදී පිජ | රජත පිණ්ඩය | රන් ගුළිය | රන් හෝ රිදී ගුලිය | රිදී ගුළිය | සනරන් | ස්වර්ණ
bullionist=ගන රන් වාදියා
bullishness=උසබ තත්ත්වය | ගැනුම්බර තත්වය
bullmarket=මිල ඉහළ නැගීම
bullock=කර ඇඹූ ගොනා | හරකා
bullock-cart=ගොන් කරත්තය
bullshit=විකාරයක්
bullterrier=සුනඛ විශේෂයක්
bully=අයුතු බල පානවා | අයුතු බලපාන්නා | දාමරිකකම් කරනවා | දාමරිකයා | බලය පානවා | හිරිහැර කරන්නා
bully-boy=කුලියට දාමරිකකම් කරන්නා | දාමරිකයා
bullybeef=තම්බා අහුරන ලද ගව මස් | නොම්මර එකේ
bulrush=පන් | පන් වර්ගයක්
bulwark=ආරක්ෂාව | නැවේ තට්ටුවෙන් උඩ කොටස | පවුර | පස් බැම්ම | ප්‍රාකාරය
bum=කටී ප්‍රදේශය | තට්ටම | නිතම්බය | රස්තියාදු වෙනවා | රස්තියාදුකාරයා | වැඩකට නැති | හිඟන්නා | හිඟා කනවා
bumble=චරචර ගානවා
bumble-bee=බඹර මැස්සා | බඹරා
bumboat=නැව්වලට ආහාරපාන ගෙනයන ඔරුව
bumf=කඩදාසිය | ලිපි ද්‍රව්‍ය | ලියකියවිලි
buming=ප්‍රදාහක
bump=ඉදිමුම | උඩ වීසි වෙනවා | උඩවිසිවීම | ගැස්සීම | තඩිස්සිය | තද පහර | දඩාස් හජ | නෙරා ගිය කොටස | නෙරා තිබෙන කොටස | බරව හැපෙනවා | වැදීම | වැදෙනවා | හැපීම | හැපෙනවා
bumper=අති විශාල | අවරෝධක | අවරෝධකය | ඉතා සරු | පිරුණු | හැපීම වළකන ආවරණය
bumph=කඩදාසිය | ලියකියවිලි
bumpiness=ගැස්සුම
bumping=ගැස්සෙමින් නැටීම
bumpkin=පිටිසරයා | මොට්ටයා
bumptious=අහංකාර | ආඩම්බර | උද්ධච්ච
bumpy=සමතලි නොවූ
bumt=කර
bun=කොණ්ඩය | බනිස් ගෙඩිය | බනිස්ගෙඩිය
bun-fight=තේපැන් සංග්‍රහය
bunch=අහුර | ඇඳුම් පිටින් නිඳාගන්නවා | එකතු කරනවා | කලඹ | කැණ | කැන | කැරල්ල | කැරැල්ල | ගුළ | ගුළාව | පොකුර | බුරුතු | මිටි බදිනවා | මිටි බඳිනවා | රැස් කකා සිටිනවා | රැස්කකා සිටිනවා | වල්ල | සමූහය
buncher=පොකුරුකුරුව
bunching=පොකුරු වීම | පොඳි ගැසීම
bunchy=කැටි වූ | පොකුරක් වැනි
bund=කණ්ඩිය | බැම්ම
bundle=කලබ | කලඹ | කලාපය | ගුච්ඡය | නූල් කලඹ | පුඤ්ජය | පුටය | පොට්ටනිය | පොදි කරනවා | පොදි බඳිනවා | පොදිය | මිටි බඳිනවා | මිටිය | මුළ | රොත්ත | වේණි
bung=ඇබය | පියන | පියනවා | පීප්ප ඇබය | මූඩිය | වසනවා
bungalow=එක් බුමු ගේ | තනි තට්ටු නිවස | බංගලාව | සොල්දරයක් නැති ගෙය
bunghole=පීප්පයක ඇබසිදුර
bungle=අදක්ෂ කමින් වරදිනවා | අවුල් කර ගන්නවා | වරදවනවා | වරද්දා ගන්නවා | වරද්දාගන්නවා
bungler=වරදවන්නා | වරද්දා ගත් තැනැත්තා
bungling=වරද්දා ගැනීම | වැරදවීම
bunion=කරගැටය | ජෞලිය | පයේ මාපටැඟිල්ල ඉදිමීම | බනියන
bunk=කටාලය | පච | පචය | පටු ඇඳ | බොරුව
bunker=ඉන්ධන ගබඩාව | ඉන්ධන පුරවනවා | ඉන්ධන සපයනවා | උමං කඳවුර | කටාලය | දඹුසපයනවා | බංකරය
bunkering=ඉන්ධන පිරවීම | ඉන්ධන සැපයුම | දඹුසැපයුම
bunkle=මුළු
bunkum=නිෂ්ඵල කථා | පචය | බේගල් | බොරු කථා | විකාරය
bunny=හා පැටියා
bunt=ඛන්ටය | තිරිඟුවල රෝගයක්
bunting=කුඩා කුරුලු ජාතියක් | කුඩා කුරුළු වර්ගයක් | කොඩි මහන රෙදි | බන්ටිං | රැළි පාලම | වීදි සරසන කොඩිය
bunton=පතල් තලාඳය
buoy=ඉපියා කඳ | උසුලනවා | බෝයාව
buoyance=උත්ප්ලවනය
buoyancy=උත්ප්ලාවකතාව | උද්‍යුෝගීභාවය | සැහැල්ලු බව
buoyant=උද්‍යුෝගී | පාවෙන
bur=එනම් ශබ්දය | තුත්තිරි | සකණ්ටක ඵලය
burberry=වැසි හා ශීත වළකන කබාය
burble=කෙඳිරිගානවා | කොඳුරනවා | පටලවනවා | ව්‍යාකූල කරනවා
burbot=මිරිදිය මත්ස්‍යයෙක්
burden=කරදර කරනවා | කරදරය | කාව්‍යයක මුඛ්‍ය විෂය | බර | බර උසුලනවා | බර පටවනවා | බැර | භාරය | වඩිය | වාහ්‍යය | හාරය | හිරිහැර කරනවා
burdensome=ඉසිලීමට දුෂ්කර | දැරිය නොහැකි
burdock=කටු සහිත මල් ඇති ගසක්
bureau=ආයතනය | කාර්යාංශය | කාර්යාලය | නිලය | පීඨකය | රජයේ මණ්ඩලය | ලාච්චු රාක්කය | ලියන මේසය
bureaucracy=නිල බල ක්‍රමය | නිලතන්ත්‍රය | නිලධාරිවාදය | නිලධාරී පාලනය | නිලධාරීවාදය | නිලබල ක්‍රමය | නිලබලක්‍රමය | නිලවාදය | පීඨකාධිපත්‍යය
bureaucrat=නිලධාරියා | නිලබලධරයා | පරිපාලන නිලධාරියා | පීඨකාධිපතියා | රජයේ නිලධාරියා
bureaucratic=නිලධාරිවාදී | නිලබලධර
bureaucratization=නිලතන්ත්‍රණය
burette=බියුරෙට්ටුව | වීදුරු නළය
burg=පුරය
burgandy=මද්‍ය වර්ගයක්
burgee=බෝට්ටුවල භාවිත කරන ත්‍රිකෝණාකාර කොඩියක්
burgeon=මෝදු වෙනවා | ලියලනවා | වැඩෙනවා | වේගයෙන් වැඩෙනවා | සමෘද්ධ වෙනවා
burgess=නගර වැසියා
burgh=ස්කොට්ලන්තයේ ප්‍රාන්තයක්
burgher=නාගරිකයා | පුරවැසියා | ලන්සිජාතිකයා | ලන්සියා
burglar=ගෙවල් බිඳින හොරා | ගෙවල් බිඳින්නා | සන්ධිච්චෞරයා | සන්ධිභේදකයා
burglar-alarm=ගෙවල් බිඳීම් ඇඟවීම
burglar-proof=ගෙවල් බිඳුම් වළක්වන
burglary=ගෙවල් බිදීම | ගෙවල් බිඳීම | ගෙවල් බිඳුම | සන්ධිච්ඡේදය
burgle=ගෙවල් බිඳිනවා | සන්ධිභේදනය කරනවා
burgomaster=නගරාධිපතියා | සලන්ද නගරාධිපතියා
burial=භූමදානය | භූමදානය කිරීම | වළලෑම | වැළලීම
burial-ground=සොහොන්පිටිය
burin=නියනක් | බුරීනය
burlap=ඝන රෙදි වර්ගයක්
burlesque=අනුකරණයෙන් විහිළු කරනවා | පරිහාසය | බර්ලස්ක් | විගඩම | සිනා පහළ කරවන කාව්‍යය | සිනා පහළ කරවන වත්‍රය
burly=තරබාරු | මහත | ශක්තිමත් | ස්ථූල
burma=බුරුමය
burmese=බුරුම
burn=අවුලුවනවා | ඇවිලෙනවා | ඇවිළෙනවා | කර කනවා | කර කරනවා | ක්‍රෝධයෙන් දැවෙනවා | කුඩා දොළ | දනවා | දවනවා | දැවීම | දැවීමෙන් වූ තුවාලය | දැවෙනවා | දොල | නසනවා | පිච්චෙනවා | පිළිස්සීම | පිළිස්සීමෙන් වූ තුවාලය | පිළිස්සුම | පිළිස්සෙනවා | පුච්චනවා | පුලුස්සනවා | පුළුස්සනවා | විනාශ කිරීම
burner=උඳුන | ගිනිදැල්ල උපදින තැන | ගිනිවැටිය | තිරය | දාහකය | දාහකයා
burning=කර වීම | ඩාහක | දහන | දැල්වීම | දැවි | දැවිල්ල | දැවීම | දැවෙන | දැහැවිල්ල | ප්‍රදාහක | පිළිස්සීම | පුපුරු ගසන | සන්දාහය
burning-ground=සුසානය
burning-on=කඩ වාත්තුවම
burnish=ඔප දමනවා | ඔප දැමීම | ඔප නගනවා | ඔපදමනවා | ඔපනඟනවා | පිරිමදිනවා
burnished=ඔප දමන ලද | ඔපදැමූ | කාන්තිමත්
burnisher=ඔප පීර | ඔපකරය
burnishing=ඔප දැමීම | පිරිමැදීම
burnous=අරාබියේ ඇඳුම් විශේෂයක් | හිස් වැස්ම සහිත අරාබි ඇඳුමක්
burns=පිළිස්සුම්
burnt=දග්ධ | දමු | දැවි | දැවුණා | දැවුණු | ප්ලුෂ්ට | පිළිස්සුණු | පුළුටු | රොස්
burp=රාමතෙල් හරිනවා
burr=එනම් ශබ්දය | කටු කොහොල් | කටුකොහොල් | කටුකොහොල් අරිනවා | තුත්තිරි | බේඳුරු | යන්ත්‍ර ශබ්දය | සකණ්ටක ඵලය | සැස්ම | හඬනඟනවා
burring=කටු කොහොල් ඇරීම | කටුකොහොල් හැරීම
burrow=කුහරය | ගුල් සාදනවා | ගුළ | බිල | බිලය | බෙනය | හාරනවා
bursae=හස්ත්‍රාව
bursar=මුදල් බාර තැනැත්තා | මුදල් භාරකරුවා | ශිෂ්‍යත්වයක් ලබන්නා
bursary=විද්‍යාලයක භාණ්ඩාගාරය | ශිෂ්‍යත්වය | ශිෂ්‍යාධාරය
bursities=හස්ත්‍රාදාහය
burst=නිපාතය | පලනවා | පැල්ම | පැලීම | පැලෙනවා | පැළෙනවා | පිපිරීම | පිපිරුම | පිපිරෙනවා | පුපුරනවා | වේගයෙන් කරනවා | වේගයෙන් සිදුවෙනවා
bursting=පිපිරීම
burton=විනාශය
bury=භූමදාන කරනවා | මිහිදන් කරනවා | යට කරනවා | වළදමනවා | වළලනවා | සඟවනවා | සැඟවෙනවා
bus=බසය | බස්රිය
bus-bar=නියදජුව
bus-shelter=බස්මගී ආවරණය
bus-stop=බස්නැවතුම
busbar=නිය දඩුව
busby=ලෝම තොප්පිය
bush=අකුල | ගුම්බය | ගුල්මය | ගොමුව | පඳුර | බුසිය | බුසුව | බුහුව | බූසුව | ලැහැබ | වදුල
bush-ranger=ඔස්ත්‍රෙලියාවේ වනගත ප්‍රදේශවල සිටින චෞරයා
bush-swamp=පඳුරු වගුර
bush-wood=ලන්ද
bushal=බුසල
bushel=බුසල
bushido=ජපන් රට වංශවතුන් අතර පවත්තා නීති සමූහය
bushiness=ලැහැබ ගතිය
bushing=බුසු ගැසීම
bushland=පඳුරුතලාව
bushman=බුශ්මන් | ලැහැබ වැසියා | වනචාරියා
bushy=ගැට සහිත | ඝන | පඳුරක් වැනි | පඳුරු සහිත
busily=අවිවේකීව | කඩිසරව
business=කටයුත්ත | කර්මාන්තය | කාර්යය | කාරිය | කිස | ජාවාරම | යුතුකම | රාජකාරිය | ව්‍යවහාරය | ව්‍යාපාර | ව්‍යාපාරකරණය | ව්‍යාපාරය | ව්‍යාපාරික | වැඩය | වෘත්තිය | වෙළඳාම | වෙළෙඳාම
business-like=කාර්යයෙහි දක්ෂ
businesslike=ව්‍යාපාරානුරූප
businessman=ජාවාරම්කාරයා | ව්‍යාපාරිකයා
busk=විනෝද කරනවා | විනෝදය සපයනවා
busker=වීදි ගායකයා
buskin=පාවහන් විශේෂයක්
buss=ඉඹිනවා
bust=උඩු කය | උඩුකය | උඩුකය පිළිමය | ඌර්ද්වකාය | ඌර්ධ්වකාය | කම්මුතු වීම | කම්මුතු වෙනවා | ජයට කරන විනෝදය | පියයුරු | පුපුරනවා | විනාශය | සුණු වෙනවා | ළැමද
bustard=කොකා වැනි කුරුල්ලෙක්
buster=මිනිහා
bustle=ඉක්මණින් කටයුතු කරනවා | ඉක්මනින් කටයුතු කරනවා | කඩිනම්ගතිය | කඩිනමින් යනවා | කඩිමුඩිය | කඩිමුඩිය | කඩිමුඩියෙන් කටයුතු කරනවා | කඩිසරව යනවා | කලබල ගතිය | කලබලයෙන් කටයුතු කරනවා | කලබලෙන් යනවා
bustling=කලබල සහිත
busy=අනවකාශ | අවිවේක | අවිවේකී | කටයුත්තෙහි යෙදුණු | කටයුත්තෙහි යෙදෙනවා | කටයුත්තෙහි යොදනවා | කඩිසර | කාර්යබහුල | නියුතු | බොහෝ වැඩ ඇති
busybody=අනුන්ගේ දෙයට අත පොවන්නා
but=එසේ වුවත් | එහෙත් | ඒ නමුත් | නමුත් | නමුදු | නුමුත් | පමණක් | මිස | මිසක් | හැර
butane=බ්‍යුටේන්
butch=ගහක් ගලක් වගේ | පිරිමි පෙනුමක් සහිත | පිරිමියෙක් මෙන් | රුදුරු
butcher=අනුකම්පා නැති තැනැත්තා | කෑමට සතුන් මරන්නා | ගෝඝාතකයා | ඝාතනය කරනවා | පශුඝාතකයා | මස් වෙළෙන්දා | මස්මරන්නා | මස්වර වැද්දා | මිනීමරුවා | වද දී මරනවා | වධකයා | විනාශ කරනවා | සතුන් මරනවා
butchery=දරුණු සත්ව හෝ මනුෂ්‍ය ඝාතනය
butler=ප්‍රධාන මෙහෙකරුවා | පානාගාර සේවකයා | බොටලේරුවා
butobarbitone=බියුටෝ බාර්බිටෝන්
butt=අංවලින් අනිනවා | අංවලින් පහර දෙනවා | අනිනවා | අවහිර කරනවා | ඉලක්කය | උපහාසයට ලක් වූ අය | කොටය | කොණකින් නෙරා සිටිනවා | තට්ටම | තුවක්කු හිස | තුවක්කුව | ලේගරය | විශාල පීප්පය | හිසින් අනිනවා | හිසින් පහර දෙනවා
butte=බියුටය
butter=ඉච්චා බස් | ඉච්චා බස් කියනවා | ගිතෙල් | දුන්තෙල් | බටර් | වෙඬරු | වෙඬරු ආදිය ගානවා | වෙඩරු
butter-cup=කහපාට මල් ඇති පැළෑටි ජාතියක්
butter-finger=අතින් අල්ලන දේ නිතර වට්ටන
butterbean=කහබෝංව
buttercup=කහපාට මල් ඇති පැලෑටි වර්ගයක්
butterfingered=අතින් අල්ලන දේ නිතර වට්ටන
butterfly=සමනලයා | සමනළ | සමනළයා
buttermilk=කිරි මෝරු | මෝරු
butterscotch=වෙඬරු හා සීනි යොදා සාදන පැණිරස ද්‍රව්‍යයක්
buttery=කෑම හා බීම අහුරන ගබඩාව
buttjoint=හේත්තු මූට්ටුව
buttle=තලා කුළ
buttock=කටිය | තට්ටම | නැවේ පසු භාගය | නැවේ පසුභාගය | නිතම්බය
buttocks=රිඹ | වනුව | සට්ටම
button=බොත්තම | බොත්තම් දමනවා | බොත්තම් පියවනවා
buttonhole=බොත්තම් කාසය
buttons=පණිවුඩ ගෙනයන වැඩකාරයා
buttress=අනුබල දෙනවා | ආධාරය | කයියෝරු බඳිනවා | කයියෝරුව | කයිරුව | දරනවා | මුක්කුව | රුකුල | රුකුල් දෙනවා | ලුහු නෙරුම | ලුහුනෙරුම | ශක්තිමත් කරනවා
butyl=බයුටයිල් | බ්‍යටයිල්
butyn=බියුටින්
butyrometer=බියුටිරොමානය
butyrous=බියුටිරීය
buxine=බක්සීන්
buxom=තරබාරු | ප්‍රසන්න | ප්‍රීතියෙන් උදම් වූ | ප්‍රීතියෙන් කුල්මත් | පිරුණු | ශෝභන
buy=අත්ලස් දී ගන්නවා | අමාරුවෙන් ලබාගන්නවා | මිලට ගන්නවා | මිලට ගැනීම
buyer=කිණුම්කරු | ගනුවා | ගැනුම්කරු | ගැනුම්කාරයා | මිලට ගන්නා | මිලට ගන්නා අය
buying=ක්‍රය | මිලට ගන්නා | මිලට ගැනීම
buzz=ගුමනවා | ගුමු දෙනවා | ගුමුගුමු හජ | ගුමුගුමුව | දූසමාන කථා පතුරනවා | දූසමානය | නොපැහැදිලි සංවාදය | මිමිනීම
buzzard=උකුස්සකු වැනි සතෙක් | රාජාලියා
buzzer=ගුමනය | ගුමු සීනුව | ගුමුව | බසරය
buzzword=මෝස්තර කතාව | විෂය කථාව්‍යවහාරය
bwana=අප්‍රිකාවේ මහත්මයා යන ආමන්ත්‍රණය
by=අතුරු | අසල | උප | කරණකොට | නිසා | පමණට | පමණින් | පාසා | බැගින් | මඟින් | ලවා | විසින් | වෙත | වෙතින් | වෙන්ව | සමීපයෙහි | ළඟ | ළඟින්
by-election=අතුරු ඡන්ද විමසීම | අතුරු මැතිවරණය
by-gone=ගියදෙය | ගියදේ | පසුගිය
by-gones=පසුගිය දේ
by-implication=ව්‍යංගත්වයෙන් | ව්‍යංග්‍යත්වයෙන්
by-law=අතුරු නීතිය | අතුරු ව්‍යවස්ථාව | අතුරුනීතිය
by-line=උපවගන්තිය | කර්තෘ නාමය
by-name=අපරනාමය
by-pass=අතුරු කාලය | අතුරු මඟ | අතුරු මඟක් සදනවා | අතුරුමඟ | මගහැර යනවා | මඟහරිනවා | මඟහැර යනවා | විපථය
by-passing=විපථ යැවීම
by-path=අප්‍රසිද්ධ මාර්ගය | උපපථය | කුඩා මාර්ගය
by-play=අතුරු කථාව | අතුරු රැඟුම | අප්‍රධාන සිද්ධිය
by-product=අතුරු නිපයුම | අතුරු නිශ්පාදනය | අතුරු නිෂ්පාදනය | අතුරු නිෂ්පාදිතය | අතුරු ඵලය | උපඵලය
by-products=අතුරු ඵල
by-road=අතුරු පාර | අප්‍රසිද්ධ මාර්ගය | කුඩා මාර්ගය
by-stander=අස සිටියා | ළඟ බලා සිටින්නා
by-way=අතුරු පාර | අප්‍රකට දෙය | අප්‍රසිද්ධ මාර්ගය | කුඩා මාර්ගය
by-word=ආප්ත වචනය | කවුරුත් දන්නා දේ | පර්යාය නාමය | පොදු වචනය
byatt=බයත්තුව
bye=අතුරු | උප | කඩුලුරකින්නාගෙන් ගිලිහෙන පන්දුවකින් ලැබෙන ලකුණ | නික්ම යාමේදී කියන ආයුබෝවන්
bye-election=අතුරු මැතිවරණය
bye-law=අතුරු නීතිය
bynedestin=බයිනෙඩෙස්ටීන්
bynin=බයනින්
bypass=මඟහැරයාම
bypath=අතුපාර
byre=ගවමඩුව
bysmalith=වීභේදාක්‍රාන්තය
byssinosis=දිගු කාලයක් රෙදි රොන් ශරීරගත වීමෙන් සෑදෙන හ
bystander=ළඟ බලා සිටින්නා
byte=ද්වයාංක සංඛ්‍යාව | පරිගණක විද්‍යාවේ යොදන ද්වයාංක සංඛ්‍යාව | බයිටය
