d=සංගීතයේ ස්වරයක්
d=සංගීතයේ ස්වරයක්
d-day=හරිම දිනය
d.a.v.c=පැමැයු ස්වයංක්‍රියා පරිමා පාලකය
d.b.=ඩෙසිබෙල
d.c=සරල ධාරාව
d.o.m=නඩත්තු රහිත සැලසුම් කිරීම
d.p.d.t.s.=දෙදූ දෙවිසි ස්විච්වය
d.p.n.=දියමන්ති පිරමිඩ දෘඩතා අංකය
d.s.c.=දෙ සේද වැසි
d.v.=ද්විත්ව කම්පනය
dab=අතුල්ලනවා | කුඩා මත්ස්‍ය වර්ගයක් | තෙත මාත්තු කරනවා | මෘදු පහර | මොළොක් වූ කැටිය | මොළොක්වූ ද්‍රව්‍ය පිඬ | යන්තම් ගානවා | හෙමින් ගානවා
dabber=තවරනය
dabble=යන්තමින් කරනවා | යමක් අතපත ගානවා
dabbler=නමට කරන්නා | බොරුකාරයා
dabchick=ජලචර පක්ෂියෙක්
dace=මිරිදිය මත්ස්‍යයෙක්
dacha=රුසියාවේ ගම්බද නිවහන
dachshund=බලු
dacoit=මංකොල්ලකාරයා
dacoity=මංකොල්ලකෑම
dacryoideus=පේරහැඩ
dactylinus=ආංගුලික
dactylology=භස්තමුද්‍රා ශාස්ත්‍රය
dactylomancy=අංගුලි පේනය
dad=තාත්තා
dada=ඩාඩා | තාත්තා
dadaism=ඩාඩා වාදය
daddy=තාත්තා
dado=අඩිය | දදුව | දේදුව | ප්‍රතිමාවක පහළ කොටස | බොරදම
dadrk=අන්ධකාර
daffadowndilly=මානෙල් වැනි කහපාට මල් වර්ගයක්
daffodil=මානෙල් වැනි කහපාට මල් වර්ගයක්
daffy=විකාර ගති ඇති
daft=ඔල්මාද ගති ඇති | තකතීරු
dag=ඩැග්
dagaba=දාගැබ
dagger=අධොලිපි ලකුණ | අනින කොට කඩුව | කිරිච්වය | සිරිය
daggger=කිරිච්වය
dago=කාපිරියා
dagoba=දාගැබ
dagoda=දාගැබ
daguerrotype=ඩැගීයෝ වත්‍රය | තහඩුවක නිර්මිත පින්තූරය | රසායනයන් ආලේප කර තහඩුවක නිර්මිත පින්තූරය
dahlia=පුෂ්ප වර්ගයක්
dahline=ඩේලීන්
dahmenite=ඩාමනයිට්
daily=දිනපතා | දිනපතා පත්‍රය | දිනපතා පළ වන පත්‍රය | දෛනික | දෛනිකය | සැමදා
daintiness=මෘදුබව | රසවත් බව | ලාලිත්‍යය
dainty=කදිම | කෝමල | පැහැදවීමට දුෂ්කර | මධුර | රස කෑම බීම | රසවත්
daiquiri=මිශ්‍ර පානයක්
dairy=කිරි පට්ටිය | කිරිපට්ටිය | කිරිහල
dairymaid=ගෝපී
dairyman=කිරිකාරයා
dais=උස් ආසනය | කුඩා වේදිකාව | පෝරුව
daisy=කුඩා මල් වර්ගයක්
dale=දෙණිය | මිටියාවත
dalembertian=ඩැලම්බයානු
dalliance=ප්‍රමාදය | විලාසය | සුරතල
dally=නිකරුණේ කල් යවනවා | සුරතල් කරනවා | සෙල්ලමින් කල් යවනවා
dalmatian=කළු පුල්ලි ඇති සුනඛ විශේෂයක්
daltonism=ඩෝල්ටන් වාදය
dam=අමුණ | අවුණ | ආවරණය | දෙන | නියර | බැම්ම | මෘගධෙනුව | වතුර බඳිනවා | වේල්ල | වේලි බඳිනවා
damage=අලාබය | අලාභ කරනවා | අලාභය | නාශය | පාඩු කරනවා | පාඩුව | වැඩක් දෙනවා | හානි කරනවා | හානිය
damaged=අතිශය රක්තවර්ණ | අබලි | නාස්ති වූ | පලුදු වූ | රතු විල්ලූද
damages=අලාභ | නාශ වන්දි | හානි වන්දි | හානිවන්දි
damaging=අවාසි
damascene=රනින් හා රිදීයෙන් | ලෝහාලංකරණය
damask=අතිශය රක්තවර්ණ | රතු විල්ලූද
dame=ආර්යාව | ගෑනී | ස්ත්‍රී
dame-school=ස්ත්‍රියක් පාලනය කරන පෞද්ගලික පාසල
dammar=ඩැමා
damn=ගර්හා කරනවා | නිරයට පත් කරනවා | ශාප කරනවා | ශාපය
damnable=අතිදුෂ්ට | නින්දනීය | හිරිහැර සහිත
damnation=ගර්හාව | සදාකාලික නිරයට පැමිණවීම | හෙනගහපි
damnatory=නින්දා එළවන
damned=අවලම් | කාලකන්නි | නීච | ශාප ලත්
damnify=නාශය කිරීම
damning=වරද තහවුරු කරන
damp=අඩු කරනවා | අධෛර්ය කරනවා | ආර්ද්‍ර | තෙත | තෙතමන | තෙතමනය | තෙත් | තෙත් කරනවා | තෙත් ගතිය | තෙත් වූ | තෙමනවා | තෙමුණු | නිවනවා | සාර්ද්‍ර
dampcourse=තෙතමනය වැළැක්වීමට අත්තිවාරමට යොදන විශේෂ ගල්ලෑල
damped=පරිමන්දිත
dampen=තෙත් කරනවා
damper=පරිමන්දකය
damping=තෙත් කිරීම | පරිමන්දනය | පරිමන්දනය කිරීම | මුල් තැම්බීම
dampish=මඳක් තෙත් වූ
dampness=තෙතමන | තෙත්ගතිය | දියසීරාව | රාවරය | සීරාව
dampproof=තෙතමනය වළක්වන
dams=හරස් පොලු
damsel=තරුණිය | යුවතිය | ලමිස්සී | ළමිස්සී
damson=කුඩා පලතුරු වර්ගයක්
danaite=ඩේනයිට්
danburite=ඩැන්බියුරයිට්
dance=නටනවා | නටවනවා | නර්තනය | නැටවීම | නැටිල්ල | නැටුම | නැයුම | පාලිය | බාල | රංග | රංගය | රඟ | රඟදෙනවා | රඟනවා | රැඟුම
dancer=නර්තකයා | නළඟන | නළුවා | නැට්ටුක්කාරයා | නැට්ටුවා
dancing=නර්තනය | නැටීම | රංගන | සරඟ
dandelion=කහපාට මල් ඇති ගස් වර්ගයක්
dander=කෝපය | තරහ
dandify=ජේත්තු කරනවා
dandle=වඩාගෙන සුරතල් කරනවා
dandrite=අනුශාඛිකාව
dandruff=ඉස්සොරි | ඉස්හොරි
dandy=ඉතා හොඳ දේ | ඉස්තරම් | ජේත්තු | ජේත්තුකාරයා | ජේත්තුව
dandyism=ජැන්ඩිකම
dane=ඩෙන්මාර්ක් රටේ වැසියා
danelite=ඩේනලයිට්
danger=අනතුර | අන්තරායය | ආදීනව | උවදුර | භය | විඝ්න | සංකටය | සැකය
dangerous=අනතුරුදායක | අන්තරාදායක | අන්තරායකර | අන්තරායකාරී | අන්තරායදායක | ත්‍රාසජනක | නපුරු | භයානක | යමර | රුදු | සභිරු
dangle=එල්ලී වැනෙනවා | එල්ලෙනවා
dani=ඩානි
danish=ඩෙන්මාර්කය හා සම්බන්ධ වූ
dank=ගොහොරු | තෙමී මඩ වූ
danseuse=නටන ස්ත්‍රී | නර්තකී
dapheneomancy=විදිපත් පූජාපේනය
daphne=ඩැනි නම් මල් ගස
daphnin=ඩැප්නින්
dapper=කඩිසර | සුරුබුහුටි
dapple=පුල්ලි යොදනවා | පුල්ලි වැටුණු | ලප සහිත
dappled=පුල්ලි වැටුණු | ලප සහිත
dare=අභියෝග කරනවා | තර්ජනය කරනවා | මිග කියනවා
daredevil=කිසිවකුට භය නැති | වගක් තුගක් නැති
daring=ගරුසරු නැති බව | ධෛර්යය | නිර්භීත | නිර්භීතකම | ප්‍රගල්භ | සහසි | සහසික | සාහසික
dariole=කුඩා බඳුනක පිළිගන්වන ප්‍රණීත ආහාරයක්
dark=අන්ධකාරය | අඳුරු | අප්‍රකට | කරුවළ | කළු | කළුවර | කාළ | කෘෂ්ණ | දුෂ්ට | වූ විට | සැකසහිත
dark-coloured=ශ්‍යාමප්‍රභා
dark-rigor=අඳුරු කාඨින්‍යය
darken=අඳුරු කරනවා | අඳුරු වෙනවා
darkening=අඳුරු කිරීම
darkly=අඳුරු ලෙස | අප්‍රකට ලෙස
darkness=අන්ධකාරය | අඳුර | ඇඳිරිය | කළුවර | තම | තමස | තිමිර
darky=කල්ලා
darling=දයාබර | ප්‍රේමවන්ත | වල්ලභයා | සුරතල් | සොඳුර
darn=එළලනවා | එළලූ තැන
darned=කාලකන්නි | මූසල
darnel=වල්පැලෑටිය
darning=එළලීම
darsonvalgalvanometer=ඩාසන්වල් ගැල්වනොමීටරය
dart=ඉක්මණින් ගමන් කරනවා | උල | තුඩ | විදිනවා | වීසි කරනවා | වේගයෙන් හෙළනවා | ශරය
darts=ක්‍රීඩාවක්
darwinian=ඩාවින්ගේ පරිණාමවාදයට අයත් පුද්ගලයා | ඩාවීනියානු
darwininsm=ඩාවින් වාදය
darwinism=ඩාවින් වාදය | ඩාවින්වාදය
dasein=තථ්‍යය
dash=ඉර | එකට හපා කඩනවා | ඩිංග | තෙයි | තේජස | මහත් වේගයෙන් ගසනවා | මහත් වේගයෙන් දුවනවා | මහත් වේගයෙන් වැටෙනවා | මහත් වේගයෙන් වැදෙනවා | මාත්තුව | රේඛාව | වේගයෙන් ගැසීම | වේගයෙන් දිවීම | වේගයෙන් හැපීම | සැහැසිකම | සුන් කරනවා | හැප්පෙනවා | හැපෙනවා
dash-board=උපකරණ පුවරුව
dashed=ඉලවු
dashing=උජාරු | කලබල සහිත | නිර්භීත
dashpot=ගටවිත
dastard=නිවටයා
dastardly=නිවට | නීඡ | බියගුලු
dasycladous=ඝනශාඛ
dasymeter=ඩාසිමීටරය
dasymetric=ඝණත්ව මිතික
dasyphyllous=ඝනපත්‍ර
data=ඉදිරිපත් කළ කරුණු | උපන්‍යාසය | දකු | දත්ත | දත්තය | නිර්දිෂ්ට දේ
database=පරිගණක දත්ත ගබඩාව
datamation=දත්ත සම්පාදනය
date=කාලය | තිථීය | දවහ | දාතම | දින දමනවා | දිනය | දිනය යොදනවා | නියම කරගත් කටයුත්ත | පටන්ගෙන පැවත එනවා | රට ඉඳි | රටඉඳි | හමුවීමට නියම කරගන්නවා
date-shaped=ඉඳි ඇට හැඩ
dated=දාතම දරන
dateless=දිනක් නැති | වරන්තන
dates=රටඉඳි
dating=කාල නිර්ණයනය | කාලනිර්ණය | දින නිර්ණායනය | දිනයනය | දිනැයුම
datiscin=ඩැටිසින්
dative=දත්ත | සම්ප්‍රදාන | සම්ප්‍රදාන විභක්තිය
datum=ආරම්භය | දකු | දත්ත | දත්තය | දතුව
daturine=ඩැටියුරින්
daub=ආලේප කරනවා | ආලේපය | ඉච්චා බස් | කල්කය | තවරනවා | තැවරුම | වකනවා
daughter=දුව | දුහිතෘ | දූ | ධීතෘ | පුත්‍රී
daughter-in-law=ලේලි
daughterly=දුවකු වැනි
daunt=කලකිරවනවා | පසුබට කරනවා | භය ගන්වනවා
dauntless=අප්‍රතිහත | නිර්භීත
dauphin=ප්‍රංශ රජුගේ වැඩිමහල් පුත්‍රයා
dauphiness=ප්‍රංශ රජුගේ වැඩිමහල් දියණිය
daviation=අපගමනය
davit=නැවේ ඔරු උස් පහත් කරන තිරිංකය
dawdle=කම්මැලිකමින් කාලය ගෙවනවා
dawn=අරුණ | අරුණ නැඟෙනවා | අරුණෝදය | අලුයම | උදා වෙනවා | උදාවීම | එළි වෙනවා | එළිදරවු වෙනවා | ක්‍රමයෙන් අවබෝධ වෙනවා | පාන් වෙනවා | පාන්දර | පායනවා
dawning=එළිදරව් කිරීම
day=දවස | දවහ | දවාල | දහවල් | දා | දාවල | දාවල් | දිවා | වකවානුව
day-after-tomrrow=අනිද්දා
day-before-yesterday=පළමුදා | පෙරෙයිදා | පෙරේදා
day-break=අලුයම
day-dreams=දවල් හීන | නිෂ්ඵල ආශාව
day-position=දිවා ඉරියව්ව
day-school=ශිෂ්‍ය නිවාසයක් නැති පාසැල
day-spring=අරුණෝදය
day-time=දිවාකාලය
dayak=ඩයක්
daydream=දවල් සිහිනය | නිස්සාර දේ
daylight=දිවා එළිය
daymare=දිවා බීභත්සය
daytime=දිවා
daze=ඇස් අඳුරු කරනවා | ඇස් අඳුරු වෙනවා | තෝන්තු කරනවා | තෝන්තු වෙනවා | සිහි නැති කරනවා | සිහි නැති වෙනවා
dazzle=ගිනි කණ වැටෙනවා | මුළා කරනවා | මුළා වෙනවා
dazzling=අතිශය දීප්තිමත් | මුළා කරන
db=ඩෙසිබෙල
db.=ඩෙබ | ඩෙසිබලය
de-air=නිවාතනය
de-classe=පන්ති පතිතයා
de-energising=විශක්ත්‍යායන
de-facto=තත්ත්වාකාර
de-humidification=ව්‍යාර්ද්‍රකරණය
de-ionization=ව්‍යයනීකරණය
de-jure=නීතිප්‍රකාර
deacon=උපද්ථායක | පල්ලියේ උපස්ථායකයා | පහත් පංක්තියේ දේවගැතියා
deaconess=උපස්ථායිකාව
deactivate=නිෂ්ක්‍රීය කරනවා
deactivation=වික්‍රිය කිරීම
dead=අජීව | අධිකව | අන්ධකාර අධික කාලය | අපගත | අප්‍රාණික | අලංකාරයක් නැති | ඔපයක් නැති | චුත | දිවංගත | නට | නැසීගිය | නීරස | නොවරදින | ප්‍රීතියක් නැති | මතක | මළ | මුළුමනින් | මෘත | ශීත අධික කාලය | සම්පූර්ණ | සහතික
dead-beat=අතිශයින් මහන්සි ඇති | අතිශ්‍රාන්ත | අධික වෙහෙසට පත්
deaden=අඩු කරනවා
deadline=නියමිත කාලය
deadlock=සම්පූර්ණ අවහිරය
deadly=අධික | භයානක | මරණීය | මාරක | මාරාන්තික
deadrochronclogy=දාරුකාලනිර්ණය
deaerator=නිර්වාතකය
deaf=බිහිරි | බීරි
deafen=බිහිරි කරනවා
deafening=කන් බිහිරි කරන
deafmute=ඒළමූගයා | බිහිරි ගොළුවා
deafness=බධිරතාව | බිහිරි බව
deal=කොටස | ගනුදෙනු කරනවා | ගනුදෙනුව | පංගුව | බෙදා දෙනවා | රාශිය | වෙළ හෙළඳාම් කරනවා | වෙළඳාම | හුඟ
dealcoholizing=ඇල්කොහොල් ඉවත් කිරීම
dealer=ගනුදෙනුකරු | බෙදා දෙන්නා | වෙළෙන්දා
dealing=ආශ්‍රය | ගනුදෙනුව
dealings=ගනුදෙනු
deamidation=ඇමයිඩ්හරණය
deamination=ඇමයින්හරණය
deammonification=ඇමෝනීහරණය
deammonobacteria=ඩිඇමොනොබැක්ටීරීයා
dean=නායක දේවගැතියා | පීඨාධිපති | විනේතෘ | විශ්වවිද්‍යාලයේ පීඨයක ප්‍රධානයා
deanery=නායක දේවගැතියාගේ පදිංවය
deanship=න් පදවිය
deanthropomorphism=මානවත්වාරෝපණ වියෝජනවාදය
deaquation=නිර්ජලකරණය
dear=අධික මිලට | අනේ | අහෝ | ආදරණීය | ඉටු | කදිම | දයාබර | ප්‍රිය | ප්‍රියයා | පින්වත් | මිල වැඩි | ලාභ නොවූ | වත්සල | වල්ලභ | ස්නේහවන්ත | සාදර | සුහද | හිතෛෂී | හුරතල්
dearly=ඉතා අමාරුවෙන් | මහත් ප්‍රේමයෙන් | මහත් මිල දී
dearness=ප්‍රියභාවය | මිල අධික බව | ළැදියාව
deassimiliation=අපවෘත්තිය
death=අභාවය | අස්තය | ඉළවුව | උළව්ව | චුතිය | ප්‍රාණත්‍යාගය | ප්‍රාණාන්තය | මර | මරණ | මරණය | මාර | මැරීම | මෘත්‍ය | යම | යමයා | වධය | වියොව | වියෝගය | හානිය
death-bed=මරණ මංචකය
death-bed-marriage=මරණ මංචක විවාහය
deathless=අමරණීය
deathly=මළාක් වැනි | මිනියක වැනි
deazotobacteria=ඩිඇසොටොබැක්ටීරියා
debacle=අන්ත පරාජය | මහත් විනාශය
debar=අවහිර කරනවා | තහනම් කරනවා | වළක්වනවා
debase=අගය අඩු කරනවා | නිවට බවට පමුණුවනවා | පහත් කරනවා | බාල කරනවා | හීන බවට පමුණුවනවා
debased=නීච | පහත් | බාල | වටීනාකමෙන් අඩු | හීන
debasement=පහත්බව
debatable=අවිනිශ්වත | තර්ක කළ හැකි | විවාදර්හ | විවාදශීලි | විවාදශීලී
debate=තර්ක කරනවා | තර්කය | පොරකනවා | පොරය | වාද | වාද කරනවා | වාදය | විවාදය
debater=වාදයෙහි දක්ෂයා
debating=වාදි | වාදී
debator=වාදක
debauch=දූෂ්‍ය කරනවා | සල්ලාලකම
debauchee=සල්ලාලයා
debauchery=සල්ලාලකම
debenture=ඩිබෙන්චරය | ණය ඔප්පුව | ණයකරය | සෘණකරය
debilitate=දුර්වල කරනවා | බෙලහීන කරනවා
debility=ගිලන්බව | දුර්වලකම
debit=ගෙවිය යුතු ණය | ණයතුරුස් | හර | හර කරනවා | හරකරනවා
debonair=ආචාරශීලී | ප්‍රියංකර | සුප්‍රසන්න
debossing=ඩිබොස් කිරීම
debouch=ගඟක් පටු තැනකින් ගලා බසිනවා
debouchment=නික්ම විහිදීම
debrief=විමසනවා
debris=කැබලි | ර්නාවශේෂ | සුන්බුන්
debt=අවශ්‍ය යුතුකම | ණය | තුරුස් | සෘණය
debtor=ණයකරු | ණයකරුවා | ණයකාරයා | ණයගැතියා | සංගාමීත්වය
debug=මකුණන් ඉවත් කරනවා
debugger=නිදොස්කරුව
debugging=නිදොස් කිරීම
debunk=බොරුව එළිදරවු කරනවා
debut=ආරම්භය | ප්‍රථම දර්ශනය | මංගලාවතරණය
debutante=කෝඩු තරුණිය
decadal=දශ අවුරුදු
decade=දශ අවුරුදු සීමාව | දශකය | දශාබ්දය | දසකය
decadence=දිරා යාම | නටබුන් වීම | පරිහානිය | පහත බැසීම
decadent=දිරූ
decagon=දශකෝණය | දශභුජය | දශාස්‍රය | දශාසුය | දහපට්ටම
decagram=ඩෙකා ග්‍රෑමය | ඩෙකාග්‍රෑම
decagramme=ඩෙකාග්‍රෑම
decagynous=දශඅණ්ඩ
decahydrate=ඩෙකාහයිඩ්‍රේට් | දශසජලය
decal=ඩෙකාල්
decalcification=චූර්ණහරණය
decalcomania=ඩෙකාල් පත
decalescen=තාපචූෂණ
decalescence=තාප චූෂණය
decalitre=ඩෙකා ලීටරය
decalogue=දසපණත
decamerous=දශාංක
decameter=ඩෙකා මීටරය | ඩෙකාමීටරය
decamethonium=ඩිකාමිතෝනියම්
decametre=ඩෙකාමීටරය
decamp=කඳවුර අත්හැර යනවා | පලා යනවා | පැන යනවා
decampment=පලා යෑම
decanal=සරසවියක පීඨාධිපතිට සම්බන්ධ
decandrous=දසරේණුක
decant=බේරා වක්කරනවා | බේරා වත් කරනවා | බේරා වත්කරනවා
decantation=බේරා වත් කිරීම | බේරා වත්කිරීම
decanter=ගුරුලේත්තුව | ඩිකැන්ටරය
decapetalous=දසදල
decaphyllous=දශපත්‍ර
decapitate=හිස ගසා දමනවා
decapitation=අග්‍රඡේදනය | ශිරශ්ඡේදනය
decapod=දශපදිකයා
decarbonisation=කාබන් ඉවත් කිරීම | කාබන්හරණය
decarbonise=කාබන් කඩනවා
decarbonising=කාබන් කැම
decarboxylating=කාබොක්සිල්හරණය
decarboxylation=කාබොක්සිල්හරණය
decarburization=විකාබියුරීකරණය | විකාබියුරීභවනය
decasepalous=දශමණිපත්‍ර
decasualisation=නිරනියම් කිරීම
decathlon=දශ ප්‍රයාමය
decay=ක්ෂය | ක්ෂය වෙනවා | ජරාව | ජරාවට යනවා | ජරාවාසය | දිරණවා | දිරනවා | දිරාපත් වෙනවා | දිරායාම | දිරීම | නටබුන්කම | සය
decayed=අබලන් | ජරාජීර්ණ | ජීර්ණ | දිරච්ච | දිරාපත් | සංකඩ
decease=චුත වෙනවා | චුතවීම | මරණය | මැරෙනවා
deceased=අභාවප්‍රාප්ත
deceit=කපටකම | මායාව | මුළා කිරීම | රැවටිල්ල | වංචාව
deceitful=කපට | කවට | කුහක | කූට | කෛරාටික | කොහොන් | ප්‍රයෝගකාර | වංක | වංචනික | වඤ්චනික | ශඨ | සාඨෙය්‍ය
deceitfulness=කපට බව | කෛරාටිකකම
deceive=කණා පල්ලන් ගහනවා | කනට විදිනවා | කපකම් කරනවා | මුළා කරනවා | රවටනවා | හොර වෙනවා
deceived=විප්‍රලබ්ධ
deceiver=මායාකාරයා | වංචාකාරයා
decelarator=මන්දකය
decelerate=මන්දනය කරනවා | වේගය අඩු කරනවා
deceleration=මන්දනය
december=දෙසැම්බර් මාසය
decembrists=දෙසැම්බරිකයෝ
decemdentate=දශදන්ත
decemfid=දශභින්න
decemfidus=දශභින්න
decemlocularis=දශකෝෂ්ඨය
decemvirate=දශගණය | දසදෙනෙකුගෙන් යුත් මණ්ඩලය
decency=විනීතකම | විනීතතාව | විනීතබව
decennary=දශවන වර්ෂය
decennial=දශවාර්ෂික | දසවාර්ෂික
decennium=දසවර්ෂය
decent=ඔබින | යෝග්‍ය | විනීත | ශිෂ්ට | ශෝභන | සභ්‍ය | සෑහෙන
decentralisation=විකේන්ද්‍රායණය | විකේන්ද්‍රායනය | විමධ්‍යගත කිරීම
decentralise=විකෙන්ද්‍රණය කරනවා | විකේන්ද්‍රණය කරනවා
decentralization=විකේන්ද්‍රණය | විකේන්ද්‍රායනය | විමධ්‍යගත කිරීම | විමධ්‍යගතකරණය
decentralize=විකේන්ද්‍රණය | විමධ්‍යගත කරනවා
decentralized=විකේන්ද්‍රිත
deception=ඇස්බැන්දුම | කපටකම | කපටිකම | මායාව | මුළා කිරීම | රැවටිල්ල | රැවටීම | වංචාව
deceptive=අවිශ්වාස | කූට | චාටු | මායාකාර | රැවටිලි සහිත
decerebrate=මස්තිෂ්කහෘත
decibel=ඩෙබ | ඩෙසිබල් | ඩෙසිබෙල
decibelmeter=ඩෙසිබෙලමානය
decible=ඩෙසිබලය
decicaine=ඩෙසිකේන්
decidability=තීරණීයක්ෂමතාව
decidable=තීරණීයක්ෂම
decide=තීන්දු කරනවා | තීරණය කරනවා | නියම කරනවා | නිශ්චය කරනවා | බේරුම් කරනවා
decided=ඒකාන්ත | නිශ්වත | ස්ථීර
decidedly=ඒකාන්තයෙන්
decideratum=ඉච්ඡිතය
deciduous=පතනශිල | පතනශීල | පාතුක
decigram=ඩෙසි ග්‍රෑමය | ඩෙසිග්‍රෑම
decigramme=ඩෙසිග්‍රෑම
decile=දශමකය
deciliter=ඩෙසිලීටරය
decilitre=ඩෙසි ලීටරය
decimal=දශක | දශම | දශමය | දශාංශය | දශාංශික
decimalisation=දශම කිරීම | දශමකරණය
decimalise=දශම කරනවා
decimalize=දශමස්ථානවලින් දක්වනවා
decimate=දහයෙන් කොටසක් වනසනවා | මහත් විනාශයට පමුණුවනවා | විශාල ගණනක් වනසනවා
decimation=මහත් විනාශය
decimeter=ඩෙසිමීටරය | දශක මීටරය | මීටරයෙන් දහයෙන් පංගුව
decimetre=ඩෙසිමීටරය
decimolar=දශම මවුලික
decinormal=දශම සමක
decipher=කියවා තේරුම් ගන්නවා
deciphering=ව්‍යාඛ්‍යාන කිරීම
decision=අධිෂ්ඨානය | තීන්දුව | තීරකය | තීරණය | නිර්ණය | නිශ්චය | බේරුම | ස්ථීරභාවය
decision-making=තීරණ කාරක
decisive=ඒකාන්ත | තීරණාත්මක | නිරුත්තර | ස්ථීර
decisively=තීරණාත්මක ලෙස
decisiveness=තීරණාත්මක බව
decisory=තීරණදායී
deck=අලංකාර කරනවා | ඇඳ පැළඳ සරසනවා | ඇඳ පැළඳ සැරසෙනවා | කූඩුව | තට්ටුව | නැවේ තට්ටුව | මහල
deckenschotter=ඩෙකන්ස්කොටර්
decker=නැපිය
decking=තට්ටුව
declaim=ඝෝෂා කොට කියනවා
declamation=ශබ්දනගා ව්‍යක්ත ලෙස උච්චාරණය කිරීම
declamatory=ඝෝ
declarant=ප්‍රකාශ කරන්නා | ප්‍රකාශක | ප්‍රකාශකයා
declaration=අත්හිටුවීම | ප්‍රකාශනය | ප්‍රකාශය
declare=උදෙසනවා | කියා පානවා | කියා සිටිනවා | නියම කරනවා | නොවළහා කියනවා | ප්‍රකාශ කරනවා | ප්‍රසිද්ධියේ කියනවා
declension=පිරිහීම | වරනැඟිල්ල | වරනැඟීම
declile=ප්‍රතික්ෂේපණය කරනවා
declinable=වරනැගිය හැකි
declinate=අවනත
declination=අවනතිය | ඇළ වීම | ක්‍රාන්තිය | බැස්ම
decline=අවනතිය | ක්ෂය | ක්‍රමයෙන් පිරිහෙනවා | නැමෙනවා | පරිහානිය | පසු බසිනවා | පහතට ඇළ වෙනවා | ප්‍රතික්ෂේප කරනවා | පිරිහීම | පිරිහෙනවා | වය | වරනගනවා | වරනඟනවා | වැටීම | විතයේ අවසාන භාගය | හීන වීම
declined=අවනත
declining=ඇළවන | පිරිහෙන
declinometer=ක්‍රාන්තිමානය | කාන්තිමානය
declivitous=පල්ලම් සහිත
declivity=පල්ලම | බැස්ම | බෑවුම
declutch=මෝටර් රථයේ ක්ලච් උපකරණය මුදා හරිනවා
declutching=ක්ලච්චය වෙන් කිරීම
decoct=කකාරනවා | කසාය කරනවා
decoction=කසාය | ක්වාථය
decoctum=කසාය
decode=තේරුම් ගන්නවා | විකේත කරනවා | විකේතනය
decoder=විකේතකය | විකේතකරය | විසංකේතකය
decoding=විසංකේතීකරණය
decoherer=ප්‍රතිසංසජ්ජකය
decoke=කාබන් ඉවත් කරනවා
decollete=බෙල්ල හා උරහිස් පෙනෙන
decolorant=විවර්ණකය
decolorate=නිර්වර්ණ කරනවා
decoloration=නිර්වර්ණ වීම | විවර්ණ කරනවා
decoloratus=නිර්වර්ණ
decolorization=විවර්ණ කිරීම | විවර්ණ වීම
decolorizing=විර්ණ කිරීම
decolourise=විවර්ණ කරනවා
decompose=කුණු වෙනවා | නරක් වෙනවා | වියෝජනය කරනවා
decomposed=කුණු වූ | විලීන
decomposition=කුණු වීම | කුණුවීම් | දිරාපත්වීම | ධාතු වෙන් කිරීම | වියෝජනය | විසංයෝජනය
decompress=අසම්පීඩනය කරනවා
decompression=අසම්පීඩනය කිරීම | විසම් පිඩනය
decongestant=රක්තාවරෝධය අඩු කිරීමට දෙන ඖෂධයක්
decontaminate=අපවිත්‍ර තත්ත්වය නැති කරනවා
decontamination=නිර්දූෂණය
decontrol=පාලනයෙන් මුදනවා
decor=අලංකාර ක්‍රමය | රංගභූමි අලංකරණය
decorate=අලංකාර කරනවා | ගවසනවා | වැඩ දමනවා | සකසනවා | සදනවා | සරසනවා | සරහනවා | හදනවා
decorated=සජ්ත | සැරහූ
decorating=සරසන
decoration=අලංකරණය | අලංකාරය | ආභරණය | ආයිත්තම | පදක්කම | ප්‍රසාධනය | භූෂණය | මණ්ඩනය | රූකම් | වැඩ | වෙස් | සැදුම | සැරසිල්ල | සැරසිලි | සැරසිලි මෝස්තර | සැරසිලි වැඩ | සැරසීම
decorative=අරුමෝසම් | අලංකාර සහිත | අලංකාරක | ප්‍රසාධක | විවචූර්ණ | විවත්‍ර | සාලංකාර | සැරසිලි
decorator=අලංකාර කරන්නා
decorboxylizing=කාබොක්සිල්හරණය
decorous=විනීත | ශෝභන | සන්සුන්
decorticated=පට්ට ගැසුණු
decortication=පට්ට ගැසීම | බාහික හරණය
decorum=ඖවත්‍යය | ඖවිත්‍යය | විනීතතාව | ශෝභනත්වය | සදාචාරය | හික්මීම
decoupling=වියෑදීම | වියෑඳීම | වියෑඳුම
decoy=ආමිෂය | උගුලට අසු කරගන්නවා | උපාය | උපායෙන් ඇදගන්නවා | තැරැව්කාරයා | පොළඹවන්නා | රවටා ගන්නවා | රැවටිල්ල | වරදෙහි පොළඹවනවා
decration=මල්කම්
decrease=අඩු කරනවා | අඩු කිරීම | අඩු වෙනවා | අඩුවීම | කුඩා කරනවා | තූරල් කරනවා | පාඩුව | පිරිහෙනවා
decreased=තුරල්
decreasing=අඩු වන
decree=අණසිටුව | තීන්දුප්‍රකාශය | තීන්දුව | නියම කරනවා | නියමය | නියෝග කරනවා | නියෝගය
decreenisi=අස්ථිර නියෝගය | නයිසයි ආඥාව
decrement=අඩු වීම | අපවතය | අලාභය | පාඩුව
decrepit=අතිශයින් මහලු | අබලන් වූ | ජරාර්ණ
decrepitation=පටපටනය | පිපිරීම
decrepitude=ජරාර්ණය
decretal=පාප්තුමාගේ ආඥාව
decrial=හෙලා දකින
decry=ගර්හා කරනවා | හෙලා දකිනවා
deculturation=අපසංස්කෘතිකරණය
decumbent=සර්පි
decument=ලේඛනය
decurrent=අවසාරී
decursive=අවසාරී
decussate=ද්විකාන්තරික
decussation=ද්විකාන්තරණය | ද්විකාන්තරිකභාවය | ව්‍යත්‍යාසය
dedendum=අපකලනය
dedicate=ඔප්පු කරනවා | කැප කරනවා | කැපවෙනවා | පිළිගන්වනවා | වෙන් කරනවා
dedicated=කාර්ය තත්පර | පූජාකළ | සමර්පිත
dedication=ඔප්පු කිරීම | කැප කිරීම | කැපවීම | පිළිගැන්වීම | පූජා කිරීම | සමර්පණය
dedicatory=ඔපුපු කරන | කැප කරන
dedoublement=ද්විගුණනය
deduce=අපෝහනය කරනවා | නිගමනය කරනවා
deduced=නිගමනය කළ
deducible=අනුමේය | අපෝහනීය | නිගමනය කළ හැකි
deduct=අඩු කරනවා
deduction=අඩු කිරීම | අඩුකිරීම | අනුමිතිය | අපෝහනය | උද්ධාරය | නිගමනය
deductive=අපෝහන | අපෝහනීය | නිගමනාත්මක | නිගාමී
deductivelogic=නිගමන විද්‍යාව
deduplication=ද්විගුණනය
deed=ඔප්පව | ඔප්පුව | කර්මය | ක්‍රියාව | කාර්යය | කෘතිය | වාර්ෂික ගාස්තුවලින් බදු අඩු කිරීම
deem=අනූහනය කරනවා | කල්පනා කරනවා | සලකනවා | සිතනවා
deep=අගාධ | අගාධය | අත්‍යන්ත | අධිකව | උච්ච | කපටි | ගම්භීර | ගහන වූ | ගැඹුරු | ගැඹුරු ලෙස | ගිල්ම | ගොරොක් | ජඹුර | දක්වා | දුර්බෝධ | පාතාලය | බලවත් | බහනවා | මුහුද | යටට | සියුම් නුවණැති | හෘදයංගම
deep-rooted=නිදන්ගත
deepen=ගැඹුරු කරනවා | ඝන කරනවා | ඝන වෙනවා | හාරනවා | හෑරෙනවා
deeply=අතිශයින්
deepness=ගැඹුර
deer=මිග | මුව | මුව වර්ගයේ සතා | මුවා | මෘග | මෘගයා | ශාරංග
deface=අවලක්ෂණ කරනවා | මකාදමනවා | විකෘති කරනවා | විරූපී කරනවා
defacement=මකා දැමීම | විකෘති කිරීම | විරූපී කිරීම
defaecation=මලපහ කිරීම | මලෝත්සර්ගය
defalcate=මුදල් වංචා කරනවා | ව්‍යපහරණය කරනවා
defalcation=මුදල් වංචා කිරීම | ව්‍යපහරණය
defamation=අපකීර්තනය | අපකීර්තිකරය | අපහාසය | කෙලෙසීම | නිග්‍රහ කිරීම
defamatory=අපකීර්තිකර | නිග්‍රහ
defame=අපකීර්තනය කරනවා | අපකීර්තියට පමුණුවනවා | කෙලෙසනවා | නිග්‍රහ කරනවා
default=කළයුත්ත නොකොට සිටිනවා | ණය නොගෙවීම | පැහැර හරිනවා | පැහැර හැරීම | පැහැරහැරීම
defaulted=කඩ කළ
defaulter=නීතිය කඩ කරන්නා | පැහැර හරින්නා | යුතුකම් ඉටු නොකරන්නා | වරදකරුවා
defeasance=බූදල් ලොප්කරය | ලොප්කරය
defeasible=දුබල | ලෝපනීය | හිස්කර
defeat=එට්ටුව | පරදනවා | පරාජය | පරාජය කරනවා | පරාදය | පරාභවය | පාරාජීකාව | ව්‍යර්ථ කරනවා | ව්‍යර්ථ වීම
defeated=භ්‍රෂ්ට
defeatism=ආත්මහීලනය
defeatist=පරාජය වන පුද්ගලයා
defecate=පහරනවා | පාරනවා | මල පහ කරනවා
defecation=මල පහකිරීම
defect=අඩුපාඩුව | කඩතොලු | කැරලි ගැසීම | ඡිද්‍ර | ඡිද්‍රය | දොස | දෝෂය | පරහ | පලා යාම | පලුද්ද | යුතුකම් පැහැර හැරීම | වර්ජනය | වැරැද්ද | විකලතාව
defection=ප්‍රහරණය | හැර දැමීම
defective=අගුණ | අසම්පූර්ණ | දෝෂ සහිත | පළුලු සහිත | සදොස් | සදෝෂී | සාවද්‍යු
defectives=මුග්ධබාලයෝ
defects=අඩු පාඩු | අඩුපාඩු | ඇද කුද | ඇද පළුඳු | දොස්
defence=ආරක්ෂක | ආරක්ෂක උපක්‍රමය | ආරක්ෂාව | නිදහසට කියන කරුණු | රාජ්‍යාරක්ෂාව | විත්ති | විත්ති වාචකය | විත්තිය | විත්තිවචය | විත්තිවාචකය
defenceless=අරක්ෂාවක් නැති | අසරණ
defences=ආරක්ෂක විධි
defend=ආරක්ෂා කරනවා | රැකබලා ගන්නවා | විත්තිය වෙනුවෙන් පෙනීසිටිනවා | විත්තියට පෙනී සිටිනවා | විත්තිවාචනය කරනවා
defendant=විත්තිකරු | විත්තිකාරයා
defendant-appellant=විත්තිකාර අපැල්කරු
defendant-intervenient=මැදිහත් වූ විත්තිකරු
defendent=පරතන්ත්‍ර
defender=ආරක්ෂකයා
defensible=ආරක්ෂා කළ හැකි
defensive=ආරක්ෂක | ආරක්ෂාව පිණිස කරන ප්‍රයත්නය | ආරක්ෂාව පිණිස කරන සටන
defer=අතපසු කරනවා | කල් දමනවා | කල්දමනවා | විලම්බනය කරනවා
deference=අනුවර්තනය | ගරුකිරීම | සමාදරය
deferential=ගරු සරු ඇති
deferment=කල් තබන ලද | කල් දැමීම
deferred=ප්‍රමාද වූ | විලම්බීත
defervescence=බුබුළු නැවතීම
defference=අන්තරය
defiance=නොසැලකිල්ල | බලවත් විරෝධය | මහත් අකීකරුකම
defiant=නොසැලකිල්ල දක්වන | විරෝධය දක්වන
defiate=අවධමනය කරනවා
deficiency=අඩුපාඩුව | අඩුලුහුඩුකම | අඩුව | ඌණතාව | ඌනතාව | මදිකම | මදිපාඩුව | වාඩුව | හිඟ
deficient=අඩු | අඩුලුහුඩු | අසම්පූර්ණ | ඌන
deficit=අඩුව | ඌනය | හිඟ ගණන | හිඟය
defiected=උත්ක්‍රම වුණු
defile=අපවිත්‍ර කරනවා | කපොල්ල | කෙලෙසනවා | කෙළෙසනවා | දූෂ්‍ය කරනවා | පර්වතාන්තරය | පෙළ ගැසීයනවා
defilement=ආසව | ආස්‍රව | ක්ලේෂය | කිල්ල | කෙලෙසීම | කෙළසීම | දූෂණය
define=අර්ථ දක්වනවා | අර්ථය නියම කරනවා | තේරුම් කරනවා | නියම කරනවා | නිර්වචනය කරනවා | පහයනවා | පැහැදිලි කරනවා | මායිම නියම කරනවා
defined=අර්ථ දැක්වූ | නිශ්චිත | විශද
definiendum=නිර්වචනීය
definiens=නිර්වචන
definite=ඒකාන්ත | තිරසර | නියත | නියමිත | නිරනුමාන | නිශ්වත | නිශ්වතය | පැහැදිලි | සරල
definitely=ඉඳුරා | එක හෙළා | ඒකාන්තයෙන් | සිකුරට | සිකුරටම | හුදෙක්
definition=අර්ථ දැක්වීම | අර්ථ විග්‍රහය | තේරුම් කරදීම | නිර්වචනය | ලක්ෂණ දැක්වීම | විග්‍රහය | විශදතාව | විස්තර විභාග දැක්වීම
definitive=අවසාන | නියත | ස්ථිර
deflagration=ගිනි ගැනීම | දැල්වීම
deflate=අවධමනය කරනවා | හුළං අරිනවා | හුළං බහිනවා
deflation=අපහරණය | අවධමනය | මිල පහත හෙලීම | විධ්මානය
deflator=අවධමකය
deflect=අහකට හරවනවා | ඇද කරනවා | නමනවා | පැත්තකට හරවනවා | හැරෙනවා
deflection=අපක්‍රමණය | අපමිංජනය | උත්ක්‍රමය | උත්ත්‍රමය | නැම්ම | වික්ෂේපය | වෙන අතකට හැරවීම
deflectometer=උත්ක්‍රමමානය
deflector=උත්ක්‍රමකය
deflexion=උත්ක්‍රමය | නැම්ම | වික්ෂේපය | වෙන අතකට හැරවීම
deflexted=උත්ක්‍රම වුණු
deflocculate=විපිණ්ඩනය කරනවා
deflocculation=විපිණ්ඩනය
defloratie=විමලන නඩුකරය
defloration=අවව්ඡන්දනය | කුමරියාව නැසුම | කෞමාරි භංගය | විමලනය
deflower=මල් කඩා දමනවා | විනාශ කරනවා
defocusing=විනාභ්‍යායන
defoliate=කොළ හැලෙනවා
defoliation=කොළ සිදීම | පත්‍ර පතනය
defomation=විරූපණය
deforest=කැලෑ වඳ කරනවා
deforestation=වන නාශනය | වනනාශනය
deform=අවලක්ෂණ කරනවා | විරූප වෙනවා
deformability=විරූප්‍යතාව
deformation=විරූපකරණය | විරූපණය | විරූපය | විරූපවීම | විරූපීභාවය
deformed=අංග විකල | විකල | විරූප | විරූපී
deformeter=විරුපණමානය
deformity=අංගවිකෘතිය | විකලය | විකලාංගතාව | විකාර රූපය | විරූපතාව | විරූපය | විෂමරූපතාව | වෛකල්‍යය
defraud=අයුක්තියෙන් පැහැර ගන්නවා | උදුරා ගන්නවා | ප්‍රයෝගයෙන් අත්කර ගන්නවා | වංචා කරනවා | වංචාකරනවා | වංචාවෙන් පැහැර ගන්නවා
defrauded= වංචිත
defray=වියදම් උසුලනවා | වියදම් ගෙවනවා
defrother=පෙණවරකය
deft=දක්ෂ | නිපුණ | වැඩට හුරු
deftness=නිපුණතාව
defunct=අපවත් වූ | අභාවප්‍රාප්ත | අභාවයට ගිය
defuse=නිෂ්ක්‍රියකරනවා | පුහුකරනවා
defusion=නිර්විලයනය | නිර්විලායනය | ව්‍යාප්තිය
defy=අකීකරු වෙනවා | තර්ජනය කරනවා | මහත් දුෂ්කරතා පානවා | සටනට කැඳවනවා
defycomparison=අනුපමේයව පවතිනවා
degassing=නිර්වායු කිරීම
degaussing=ඩිගවුස් කිරීම | විගවුස් කිරීම
degeneracy=ආචාර හායනය | පහත වැටීම | පිරිහීම | පිරිහුම
degenerate=ගුණයෙන් පිරිහුණු | පරිහාණීය | පිරිහුණු | පිරිහුණු තැනැත්තා | පිරිහෙනවා | භ්‍රෂ්ට | භ්‍රෂ්ටයා | වැහැරීම | වැහැරෙන | ස්වභාවයෙන් පිරිහුණු
degeneration=අවඡනනය | පරිහානිය | පහත වැටීම | පිරිහීම | හායනය
degenerative=පිරිහෙන
deglutition=නිගරණය
degradation=අවක්‍රමණය | අවමානය | නින්දාව | පහත වැටීම | හායනය
degrade=අවමන් කරනවා | තත්ත්වයෙන් පහත වැටෙනවා | තත්ත්වයෙන් පහත හෙළනවා
degraded=අධම | පහත වැටුණු
degrading=ආත්මගෞරවය කෙලෙසන | නොහොබනා
degreaser=තෛලහාරකය
degree=අංකය | අංශකය | අංශය | උපාධිය | කක්ෂය | කලාව | තත්ත්වය | තරාතිරම | පදවිය | ප්‍රමාණය | පිළිවෙළ | භාගය | මට්ටම | මාත්‍රය
degsification=නිර්වායුකරණය | වායුහරණය
dehisce=පැළෙනවා
dehiscence=පැල්ම | පැළීම
dehiscent=පැළෙන
dehiscing=පැළෙන
dehumidification=ව්‍යාර්ද්‍රකරණය
dehybrid=නුමුහුම්
dehydrant=විජලකය
dehydrase=ඩිහයිඩ්‍රේස්
dehydrate=විජල කරනවා | විජලනය වනවා | වියළනවා | වේලෙනවා
dehydration=නිර්ජල වීම | විජල කිරීම | විජලනය
dehydrator=විජලකාරකය
dehydrite=ඩිහයිඩ්‍රයිට්
dehydrogenase=ඩිහයිඩ්‍රජනේස්
dehydrogenation=හයිඩ්‍රජන් ඉවත් කිරීම | හයිඩ්‍රජන්හරණය
dehydrohalogenation=හයිඩ්‍රොහැලජන්හරණය
dehydrolysis=විජලවිච්ඡේදනය
deice=අයිස් ඉවත් කරනවා
deification=දේවත්වරෝපණය | දේවත්වාරෝපණය
deiform=දේවාකාර | නොතරම්කමක් කරනවා
deify=දෙවිකෙනකු මෙන් සලකනවා | දේවත්වයට පමුණුවනවා | දේවත්වාරෝපණය කරනවා
deign=නොතරම්කමක් කරනවා
deionisation=ව්‍යයනීකරණය
deism=දේවදෘෂ්ටිය | දේවවාදය
deist=දේවත්වය | දේවතාවා
deistic=දේවතා
deity=දෙයියා | දෙවියා | දේවතාව | දේවතාවා | මුරු | සුර
deject=අධෛර්ය්‍ය කරනවා
dejected=අධෛර්ය්‍යයට පැමිණි | දුර්මුඛ | විෂණ්ණ
dejection=අධෛර්ය කිරීම
dekko=බලන්න
del=කර්තෘ නාමය | ඩෙල් | නැබ්ලා
delay=අත ගානවා | අත පත ගානවා | අතපසු කරනවා | අතපසු වෙනවා | තෝංචය | පමා කරනවා | පමාකුරුව | පමාව | පරක්කුව | පසුකරනවා | ප්‍රපඤ්චය | ප්‍රමාද කරනවා | ප්‍රමාද වෙනවා | ප්‍රමාදය | පොරොත්තුව | ලස | වාර වෙනවා | විලම්බය | සුනංගුව
delayed=ප්‍රමාදිත | මිඩංගු | විලම්බිත
delaying=ප්‍රමාදකාරී | සම්බාධ
deleberative=විචාරණ
delectable=මනෝහර
delectation=ආනන්දය | මහත් ප්‍රීතිය
delegate=අභිනියෝජනය කරනවා | අභිනියෝජිතයා | නියෝජිතයා | පවරා දෙනවා | ප්‍රතිනිධි
delegated=අභිනියෝජනය කළ | අභිනියෝජිත | අභිනියෝජිතයා
delegation=අභිනියෝජනය | නියෝජිත මණ්ඩලය | පැවරීම | බලය පැවරීම
delete=මකා දමනවා | ලොප් කරන්න | ලොප් කිරීම | විනාශ කරනවා
deleterious=අන්තරායදායක | අහිත | හානිකර
deletion=මකා දැමීම
delft=ඔපවත් මැටි බඳුන
deliberate=ආවර්ත | කලබල නැති | විචාරවත් | විපරම් සහිත | ඕනෑකමින් | සම්ප්‍රජන්‍ය | සාකච්ඡා කරනවා | හිතාමතා කරනලද
deliberateness=පරීක්ෂාකාරීත්වය
deliberation=ආවර්ජනය | පරීක්ෂාකාරිත්වය | ප්‍රකල්පනය | විචාරණය | විචාරය | විවාරණය
deliberative=සාකච්ඡා කිරීම සඳහා වූ
delicacy=ප්‍රණීත ආහාර පානාදිය | මෘදු මොළොක් බව | සියුම්කම | සුකුමාලභාවය
delicate=අති දක්ෂ | කොමල | කොමළ | කෝමල | දුර්වල | පරිස්සමින් මැදහත් වියයුතු | ප්‍රණීත | මොළකැටි | රසවත් | ශිෂ්ට | සියුම් | සිලුටු | සිවුමැලි | සුකුමාර
delicatedness=ප්‍රණීත ආහාර පානාදිය | මෘදු මොළොක් බව | සුකුමාලභාවය
delicatessen=සැකසු ආහාර වෙළඳ සැල
delicious=අති මනෝහර | ඉතා රසවත් | ප්‍රණීත | පිණි | පිණී | මධුර | රසවත් | රුවර
delict=දිල්ක්තය | දිලික්තය | සිවිල් වරද
delictum=දිලික්තය
delight=අතිශයින් සතුටු කරනවා | අතිශයින් සතුටු වෙනවා | අභිනන්දනය | ආහ්ලාදය | කුල්මත් කරනවා | කුල්මත් වෙනවා | තුෂ්ටිය | පහදිනවා | ප්‍රසාදය | ප්‍රීතිය | මහත් සොම්නස | මුදිතා | විනෝද | සාත | සුඛාස්වාදය
delighted=මහත් ප්‍රීති ඇති
delightful=ආනන්දජනක | ප්‍රීතිමත් | මනරම් | මනෝරම්‍ය | මනෝහර
delighting=අභිරමණය
delignification=ලිග්නීහරණය
delignifying=ලිග්නීහරණ
delimitation=පිරිසිඳීම | සීමා නියම කිරීම | සීමා නිර්ණය | සීමා නිර්ණයනය | සීමා නිර්ණායනය
delimited=පිරිසිඳුණු
delimiter=පරිසීමකය
delin=කර්තෘ නාමය
delineascope=ඩිලිනියස්කෝපය
delineate=නිරූපනය කරනවා | වචනයෙන් ලක්ෂණ දක්වනවා
delineation=නිරූපණය | රූප රේඛනය | රූප සටහනින් දැක්වීම
delineator=සටහනින් හෝ වචනයෙන් විස්තර දක්වන්නා
delinquency=අපචාරය | අපරාධය | යුතුකම් පැහැර හැරීම
delinquent=අපචාරියා | අපරාධකාරයා | අපරාධාත්මක | අවල | අවලමා | අවලයා | යුතුකම් පැහැර හරින්නා
deliquescence=අවද්‍රවණතාව
deliquescent=අවද්‍රාවක | අවද්‍රාවණ
deliriant=උන්මාදකය | විභ්‍රාන්තකය
delirious=උමතු | විකාරයෙන් දොඩවන | සිහිමුළා වූ
delirium=උමතුකම | විකාරය | විභ්‍රමය | විභ්‍රාන්තිය | සමයම | සිහිමුළාව
deliriumtremens=අධික වෙරිමත
deliver=ගළවනවා | නිදහස් කරනවා | පමුණුවනවා | පාවා දෙනවා | බාර දෙනවා | යවනවා
deliverable=බාර දිය හැකි
deliverance=ගැළවීම | නිදහස | ප්‍රකාශය
deliveree=පමුණුවලද්දා | බාරදීම ලද්දා
deliverer=පමුණුකරු | බාරදෙන්නා
delivery=කථා විලාසය | පමුණුව | ප්‍රසූතිය | පාවාදීම | බාර දීම | බාරදීම | භාෂණය | වැදීම | විසර්ජනය
dell=දෙණිය | වනරොද සහිත කුඩා හෙළ
dellmitation=සීමා නියම කොට වෙන් කිරීම
delonsing=ඩිලොන්සිං
delph=සලන්දයේ හි සාදන පිඟන්මැටි භාජන
delta=ග්‍රීකඅකුර | ඩෙල්ටා | ඩෙල්ටාව
delta-leaved=ඩෙල්ටාපත්ර්රීය
deltoid=ඩෙල්ටාකර | ඩෙල්ටාභය
delude=මුළා කරනවා | රවටනවා
deluge=ජලප්‍රවාහය | ජලයෙන් යට කරනවා | ජලයෙන් වසනවා | දෙගොඩතළා යන වතුර | මහා ජලගැල්ම | මහා වර්ෂාව | මහෝඝය | විප්ලවය
delusion=මායාව | මිථ්‍යා විශ්වාසය | මුස | මුළාව | මුළාසිය | මෝහය | රැවටීම
delusive=මුළා කරන | මෝහාත්මක
delusory=මුළා කරන
delution=ව්‍යභිචාර
deluxe=ඉතා අනර්ඝ | සුපිරි
delve=හාරනවා
demagnetisation=විචුම්බක කිරීම | විචුම්බකනය
demagnetiser=විචුම්බකය
demagnetization=විචුම්බකනය
demagnetize=චුම්බකත්වය ඉවත් කරනවා
demagogue=ජනනායකයා | ජනාන්දෝලකාය | විප්ලවකාරියා
demagogy=කුටිල ජනනායකත්වය
demal=ඩෙමැලය
demand=අභියෝගය | අවශ්‍යතාව | ඉල්ලනවා | ඉල්ලීම | ඉල්ලුම | නියම කරනවා | නියමය | ප්‍රශ්න කරනවා | ප්‍රශ්නය | බලෙන් ඉල්ලා සිටිනවා | වුවමනා කරනවා | වුවමනාව | වේගයෙන් ඉල්ලා සිටිනවා | වේගවත් ඉල්ලීම
demanding=අවධානග්‍රාහි
demarcate=ඉම් ලකුණු කරනවා | මායිම් නියම කරනවා | මායිම් නියම කිරීම | සීමාංකනය කරනවා
demarcation=අංකිත සීමාව | ඉම් ලකුණු කිරීම | ඉම් ලකුණුකිරීම | ලකුණු කළ ඉම | සීමාංකනය
demarche=ප්‍රතිපත්තිය
dematioid=ඩෙමටියාකාර
demean=අවමන් කරනවා | පහත හෙළනවා
demeanor=චරිතය | හැසිරීම
demeanour=ආචරණය | චරිතය | ලීලාව | හැසිරීම | හැසිරීම් ලීලාව
demented=පිස්සු | වියරු වැටුණු
dementia=පිස්සුව | වත්ත වික්ෂේපය
demerara=උක්දඬු
demerit=අකුශලය | අකුසලය | අවගුණය | පව් | පාපධර්මය | පාපය
demersal=උපනිතල
demesne=මුත්තේට්ටුව | වලව්ව | වලව්වට අයිති ඉඩකඩම්
demi=අඩ
demi-rep=සැක කරන ලද පතිවත ඇති ස්ත්‍රී
demigod=උපදේවතාවා
demijohn=බරණිය | වේවැලින් ආරක්ෂිත බෝතලය
demilitarize=තැනෙකින් යුද්ධ සේනාංක ඉවත් කරගන්නවා
demimondaine=වේශ්‍යා ස්ත්‍රී
demimonde=අභිචාරික ස්ත්‍රී ගණයා | වේශ්‍යා ස්ත්‍රී සමූහයා
demise=අභාවප්‍රාප්තිය | පවරා දීම | මරණය
demised=දමිසන ලද
demisemiquaver=සංගීතයේ ස්වරයක්
demission=අයිතිය අත් හැරීම
demit=අයිතිය අත්හරිනවා
demiurge=විශ්ව ශිල්පියා
demob=යුද්ධයෙන් පසු සේනා විසුරුවා හරිනවා
demobilization=සේනා විමුදනය | සේනා වියෝජනය | හමුදා සේවයෙන් මිදවීම
demobilize=හමුදා සේවයෙන් මුදවනවා
democracy=ප්‍රජාතන්ත්‍රය | ප්‍රජාතන්ත්‍රවාදය
democrat=ප්‍රජාතන්ත්‍රවාදියා
democratic=ප්‍රජාතන්ත්‍රවාදී | ප්‍රජාතන්ත්‍රවාදී ප්‍රජාතාන්ත්‍රික | ප්‍රජාතාන්ත්‍රික
demodulation=ග්‍රාහක තරංග පද්ධතියකින් අවශ්‍ය තරංග ආයාමය උකහා ග | විමූර්ඡනය
demodulator=අනනුකුලකය | අනනුකූලකය | විමූර්ඡකය
demographer=ජනවිකාස විද්‍යාඥයා
demography=ජන විකාශ විද්‍යාව | ජන විකාශනය | ජන විකාස විද්‍යාව | ජනගහන විද්‍යාව | ජනරේඛනය | ජනවිකසනය | ජනවිකාශ විද්‍යාව | ජනවිකාශනය | ජනවිකාස විද්‍යාව | ජනවිකාසය
demolish=කඩා දමනවා | තුතුරනවා | නටබුන් කරනවා | බිඳ හෙළනවා | බිඳහෙළනවා
demolition=තිතිරීම | බිඳ හෙලීම | බිඳ හෙළීම
demolization=අනුභේදනය
demon=අමනුෂ්‍යයා | පිශාචයා | භූතයා | යක්ෂයා | යකා | රකුසා | රාක්ෂයා | රාක්ෂස
demoneitsation=විමූල්‍යයනය
demonetisation=මුදල් අවලංගු කිරීම | ව්‍යවහාර මුදල් අවලංගු කිරීම | විමුල්‍යයනය
demonetise=විමූල්‍යනය කරනවා
demonetize=භාවිතයේ පවත්නා මුදල් අවලංගු කරනවා
demoniac=යක්ෂාවේශ වූ තැනැත්තා
demoniacal=බිහිසුණු
demonic=බිහිසුණු
demonolatry=භූත වන්දනය
demonology=භූත විද්‍යාව | භූතවේදය | රාක්ෂසවේදය
demonomania=භූතෝන්මාදය
demonstrable=ඔප්පු කළහැකි | දැක්විය හැකි | දෘශ්‍ය | සුවිදර්ශනීය
demonstrably=ප්‍රත්‍යක්ෂවම
demonstrate=ආදර්ශනය කරනවා | ආර්ශනය කරනවා | ඔප්පු කරනවා | පැහැදිලි කරනවා | පෙන්නුම් කරනවා
demonstration=ආදර්ශනය | උපපාදනය | ඔප්පු කිරීම | නිරූපණය | පක්ෂ බව දැක්වීම | ප්‍රතිපාදනය | ප්‍රදර්ශනය | පෙළපාලිය | සාධනය | සුවිදර්ශනය
demonstrative=අවිනීත | උපපාදක | නිදර්ශක | සාධක වශයෙන් පවත්නා
demonstrator=ආචාර්ය්‍යවරයාගේ අතවැසියා | උපපාදනාචාර්ය | ප්‍රදර්ශක | පෙළපාලිකරුවා | සුවිදර්ශක
demonym=ගුප්තනාමය
demophobia=පොක්කර භීතිකාව
demoralization=අධෘතිකරණය | දූෂණයවීම
demoralize=අධෛර්ය කරනවා | චරිතය දූෂිත කරනවා | සිත කෙලෙසනවා
demoralized=අධෘතිකෘත | උද්යෝග විහීන | දිරිසුන්
demote=තනතුරින් පහත දමනවා | පටි කඩනවා | පාත දමනවා
demotic=ජනතාවගේ | ජනප්‍රිය
demotivation=අනභිප්‍රේරණය
demulcent=ස්නිග්ධකය
demur=ආන්දෝලනය | දිමුරනවා | නොකැමැත්ත | විරුද්ධ වෙනවා | සැක ප්‍රකාශ කරනවා
demure=ඇකිළෙන | බොරු ලජ්ජා අඟවන | ලජ්ජාශීලී
demureness=ලජ්ජාශීලීබව
demurrage=ඩෙමරේජ් ගාස්තුව | දිමරුව | නැව් පමා කුලිය | පමා කුලිය | පමා මිල | ප්‍රමාද ගාස්තුව
demurrer=විරුද්ධ පක්ෂයේ නීතිමය තර්කයට විරෝධය පෑම
demy=ඩිමයි | මුදුණ කඩදාසි මිම්මක්
den=ගුහාව | බිළය | ලෙණ
denarius=දිනාරකය | පුරාණ රෝම රිදී කාසියක්
denationalization=විජනසතු කිරීම | විජනසන්තක කිරීම | විජාතියකරණය
denationalize=ජනසතු ව්‍යාපාරයක් පුද්ගලික අංශයට පවරනවා
denationalized=ජාතිභ්‍රෂ්ට
denaturation=විස්ස්වාභාවීකරණය
denature=ස්වාභාවික ලක්ෂණ වෙනස් කරනවා
denatured=විස්ස්වාභාවීකෘත
denaturing=ගුණහානිය
denaturise=විස්වභාව කරනවා
dendrad=ඵලාරාම ශාකය
dendriform=රුක්වන් | වෘක්ෂාකාර
dendrite=අනුශාඛිකාව | දූමකය
dendritic=සුශාඛ
dendrium=ඵලරාම ග්‍රාමය
dendrocolous=රුක්වැසි | වෘක්ෂවාසි
dendrograph=ඩෙන්ඩොග්‍රාපය
dendroid=රුක්වන් | වෘක්ෂාකාර
dendrologist=වෘක්ෂ විද්‍යාඥයා
dendrology=වෘක්ෂ විද්‍යාව | වෘක්ෂවිද්‍යාව
dendron=දූමය
dendrophilus=ඵලාරාමරුහ
dendrophyte=ඵලාරාම ශාකය
dendropithecus=දෙන්ද්‍රොපිතෙකුස් | වන වානරයා
dene=ඝන කැලෑ සහිත මිටියාවත
dengue=ඩෙංගු උණ | සන්ධිසංජ්වරය
denial=අපලාපනය | ප්‍රතික්ෂේප කිරීම | ප්‍රතිෂේධනය
denier=ඩෙනියරය
denigrate=අපකීර්තියට පත් වෙනවා | අවමන් ලබනවා
denim=ඩෙනිම් රෙද්ද
denitration=නයිට්‍රෝහරණය
denitrification=නයිට්‍රීහරණය
denitrifying=නයිට්‍රීහාරී
denitrobacteria=ඩිනයිට්‍රොබැක්ටීරීයා
denizen=පදිංවකාරයා | රටවැසියාව ලද්දා | වැසියා
denominate=නම් කරනවා | නාමනය කරනවා
denomination=අභිධානය | නාමධෙය | නාමධේය | නාමය | නාමිකය | නිකාය | පංතිය | වර්ගය | සංඥාව | සම අගය
denominational=යම්කිසි නිකායකට අයත්
denominations=අභිධාන
denominative=නාමධාතුක ක්‍රියා පදය | විශේෂක | සංඥාපක | හඳුන්වන
denominator=පොදු සාධකය | භාගකය | හරය
denotation=අභිධානය | අභිධානාර්ථය | උපලක්ෂණය | මුඛ්‍යාර්ථය | වස්තු අර්ථය
denotative=අභිධාන සුචක | අභිධානසූවක
denote=අඟවනවා | අභිධාන කරනවා | දක්වනවා
denouement=නිර්වහණය | පරිසමාප්තිය
denoument=කථාවසානය | කථාවෙහි පරිසමාප්තිය | නිෂ්ඨාව
denounce=අභිශාප කරනවා | ප්‍රසිද්ධියේ චෝදනා කරනවා | ප්‍රසිද්ධියේ ප්‍රතික්ෂේප කරනවා
dense=අතිමූඩ | ආකීර්ණ | උකු | ගහන | ඝන | දැඩි
densimeter=ද්‍රවමානය
densitometer=ඩෙන්සිටොමීටරය
density=උකුකම | ඝනත්වය | ලූව
densograph=ඩෙන්සොරේඛය
dent=එබුම | කඩතොලු | කත්තුව | පළුදු කරනවා
dental=දත් පිළිබඳ | දන්ත | දන්තජ | දන්තජ අකුර | දන්තජාක්ෂරය | දැතිකුට්ටිය
dentate=දන්තාකාර | දන්තුර | දැති සහිත
dentation=දත් හටගැනීම
dented=ඇතුළට එබුණු | කඩතොලු වූ
denticle=දන්තිකාව
denticulate=දන්තිකාධර
denticulations=දන්තිකා
dentifrice=දත් බෙහෙත
dentil=දන්තිනය
dentin=ඩෙන්ටින් | දන්තිනය
dentine=දන්තිනය
dentist=දත් වෙදා | දන්ත වෛද්‍ය
dentistry=දත් වෙදකම | දන්ත වෛද්‍ය විද්‍යාව
dentoid=දන්තාකාර
denture=බොරු දත් කුට්ටම
denudate=නග්නීකරනවා
denudation=කැලෑ වඳවීම | නගනීකරණය | නග්නීකරණය | පස් සෝදායම
denude=ආවරණය ඉවත් කරනවා | නග්න කරනවා | නිර්වස්ත්‍ර කරනවා
denuded=නග්නීකෘත
denunciation=තරවටුව | ප්‍රකට චෝදනාව
denunciative=චෝදනා සහිත
denunciatory=චෝදනා සහිත
deny=අපලාපනය කරනවා | තහනම් කරනවා | ප්‍රතික්ෂේප කරනවා | ප්‍රතිෂේධනය කරනවා
deodands=දේවභාගය
deodar=දේවදාර
deoder=දේවදාරු
deoderize=දුගඳ ඉවත් කරනවා
deodorant=දුගඳ වනසන ද්‍රව්‍යය | දුර්ගන්ධ නාශකය | විගන්ධකය
deodoriser=දුර්ගන්ධ නාශකය
deodorizer=දුගඳ වනසන ද්‍රව්‍යය
deontological=යුක්තිවේදීය
deontology=යුක්තිවේදය
deoperculate=නිෂ්පිධාන
deoxidation=ඔක්සිජන්හරණය | වියොක්සිකරණය
depart=ඉවත්ව යනවා | කාලක්‍රියා කරනවා | නික්ම යනවා | නික්මෙනවා | පිටත් වෙනවා | වෙනස්ව ක්‍රියා කරනවා
departed=අපගත | අපවත් වූ | නික්මගිය
department=අංශය | ක්‍රියාංශය | දෙපාර්තමේන්තුව | මණ්ඩලය | ශාඛාව
departmental=මණ්ඩලයට අයිති
departmentalization=අංශීකරණය | දෙපාර්තමේන්තු ගතකිරීම | දෙපාර්තමේන්තුගත කිරීම | විභේදනය
departure=අපක්‍රමණය | අපක්‍රමය | අපගමනය | අපගමය | අපයානය | දිගටිය | නික්මයාම
depauperate=වැහැරුණු
depend=එල්ලී සිටිනවා | එල්ලෙනවා | යැපෙනවා | රඳා පවතිනවා
dependable=ගැති | නොවරදින | විශ්වාස කළහැකි
dependancy=උපවී රට | පරායත්තය
dependant=අන්‍යයෙකුගෙන් නඩත්තු වෙන්නා | උපවී | පරවශ | පරාධීන | පරාධීනයා | යැපෙන | යැපෙන්නා | රඳා පවත්නා
dependence=පරාධීනත්වය | පරායත්තතාව | පරායත්තාවය | පාරායත්තතාව | යැපීම | විශ්වාසය
dependency=පරායත්ත රාජ්‍ය | පරායත්තතාව | යටත් ප්‍රදේශය
dependent=අන්‍යයෙකුගෙන් නඩත්තු වෙන්නා | ආධීන | ආයත්ත | උපවියා | ඔලොඹු | පරවශ | පරාධීන | පරාධීනයා | පරායත්ත | පරායත්තයා | යැපෙන්නා | රඳා පවත්නා
depersonalization=අපුද්ගලායනය | විෂ්පෞරුෂායණය
depersonelization=විප්පෞරුෂායනය
deperulation=නිපතනය
dephlegmator=විභාජක ටැඹ
dephlogisticated=ප්ලොස්ටන් මුක්ත
dephosphorization=විපොස්පීකරණය
depict=වචනයෙන් විස්තර දක්වනවා | වත්‍රයෙන් විස්තර දක්වනවා
depiction=වචනයෙන් විස්තර දැක්වීම | සංවර්ණනය
depigmentation=වර්ණකහරණය | විරංගනය
depilating=ලෝමහණරය
depilation=කෙස් ඉඟිලීම | ලොම් ඉවත් කිරීම
depilatory=ලෝමනාශක ද්‍රව්‍යය | ලෝමනාශකය | ලෝමහරණය
deplanate=සමතලා
deplasmolysis=විශුනතාහරණය
deplasmolytic=විශුනතාහරණ
deplete=ප්‍රමාණය අඩු කරනවා | සංඛ්‍යාව අඩු කරනවා | හිස් කරනවා
depletion=ක්ෂය වීම | ප්‍රමාණය අඩු කිරීම | සංඛ්‍යාව අඩු කිරීම | හායනය
deplorable=ඛේදජනක | නින්දිත
deplore=වැළපෙනවා | සංවේගය ප්‍රකාශ කරනවා | හෙලා දකිනවා
deploy=යෙදවීම | යොදවනවා | විහිදනවා
deployment=විහිදීම
depolarisation=විධ්‍රැවණය
depolarise=විඩ්‍රැව කරනවා | විධ්‍රැව වෙනවා
depolariser=නිධ්‍රැවකය | විධ්‍රැවකය
depolarization=විධ්‍රැවණය | විධෘවණය
depolarizer=විධ්‍රැවකය
depoliticization=දේශපාලන ලක්ෂණ හරණය
deponent=අභිසක්ෂ්‍යාකරු | අභිසාක්ෂ්‍යකරු | දිවුරුම් පත් ප්‍රකාශකයා | දිවෘම්පත් ප්‍රකාශකයා | සාක්ෂිකරුවා | සිද්ධි ප්‍රකාශකයා
depopulate=වැසියන් අඩු කරනවා | වැසියන් අඩු වනසනවා
depopulated=ජනශුන්‍ය
depopulation=ජන හානිය | ජනහායනය | වැසියන් වැනසීම
deport=තොට පිටනය කරනවා | නිර්වාස කරනවා | රටින් නෙරපනවා | රටින් පිට කරනවා | හැසිරෙනවා
deportation=තොට පිටනය | නිර්වාසනය | රටින් නෙරපීම | රටින් පිට කිරීම
deportee=නිර්වාසිකයා
deportment=ලීලාව | හැසිරීම
depose=අභිසාක්ෂ්‍ය දෙනවා | තනතුරෙන් පහ කරනවා | දිවුරා සාක්ෂි දෙනවා | දිවුරුම්පත් ප්‍රකාශ කරනවා | ධූරයෙන් පහ කරනවා | රාජ්‍යයෙන් පහ කරනවා | සිද්ධි ප්‍රකාශ කරනවා
deposit=අත්තිකාරම | කාරම | තැන්පත් | තැන්පත් කරනවා | තැන්පත් මුදල | තැන්පතුව | නිධිය | බාර කළ දේ | බාර දෙනවා | සන්ධාපනය | සන්ධාපනය කරනවා | සන්නිධානය
depositary=තැන්පතු ලද්දා | සන්ධාපනලාභියා
deposited=ප්‍රක්ෂිප්ත
deposition=අභිසාක්ෂ්‍යය | අවසාදනය | කටඋත්තරය | තැන්පත් කිරීම | නිධිය | නිධිසාදනය | නිධිසාධනය | නෙරපීම | සාක්ෂිප්‍රකාශය | සිද්ධි ප්‍රකාශය
depositor=තැන්පත් කරන්නා | තැන්පත්කරු | බාර දෙන්නා
depository=ගබඩාව | තැන්පතු දරන්නා | තැන්පතුධාරී | තැන්පතුහල | භණ්ඩාගාරය | සන්ධානධාරියා | සන්ධාපනාලය | සූරක්ෂිතාගාරය
deposits=තැන්පතු
depositum=තැන්පත් කිරීම | සන්ධාපිතය
depot=ගබඩාව | ප්‍රධාන වැඩපොළ | හමුදාවක ප්‍රධාන ස්ථානය
deprave=කෙලෙසනවා | දූෂ්‍යකරනවා
depraveded=දුරාවාර | දූෂිත | පාපිෂ්ට
depravity=ඉතා පවිටු සිතිවිල්ල | ඉතා පවිටු හැසිරීම | බලවත් දුශ්චරිතය
deprecate=ඇවටිලි කරනවා | විරුද්ධත්වය ප්‍රකාශ කරනවා
deprecation=විරුද්ධත්වය ප්‍රකාශ කිරීම
deprecator=විරුද්ධත්වය ප්‍රකාශ කරන්නා
deprecatory=විරුද්ධත්වය ප්‍රකාශ කරන
depreciate=අගය අඩුවෙනවා | අගය ක්ෂය වෙනවා | අගය බහිනවා | අගේ අඩු කරනවා | අගේ අඩු වෙනවා | ගෙවනවා | මිල පහත බසිනවා | වටිනාකම පහත බසිනවා
depreciating=අගය බහින | අගයක්ෂය
depreciation=අගය අඩු වීම | අගය අඩුකිරීම | අගය අඩුවීම | අගය බැස්ම | අගයක්ෂය | ක්ෂය | ක්ෂය ප්‍රමාණය | ක්ෂය වීම | මිල අඩු වීම | මිල අඩුකිරීම | වටිනාකම අඩුකිරීම | වටිනාකම අඩුවීම
depreciatory=වටිනාකමින් අඩු කරන | හෙළා දක්නා
depredation=කොල්ලකෑම | ප්‍රකලනය | පැහැරගැනීම | විනාශය
depredator=කොල්ලකාරයා
depresed=ඔබන ලද | ධෛර්යය අඩු කළ
depress=අවපාත කරනවා | උත්සාහය අඩු කරනවා | ධෛර්ය්‍යය අඩු කරනවා | පහතට ඔබනවා
depressant=අදස්සාරක ප්‍රතිකාරකය | අවපීඩකය
depression=අවනතිය | අවපාතනය | අවපාතය | අවපීඩනය | අවරෝහණය | දොම්නස | නිම්නස්ථානය | පරිහානිය | පහත් කිරීම | පහත් බිම | පහත් වීම | පාතනය | මනෝග්ලානිය | විෂාදය | වෙළඳ පරිහානිය
depressor=අවපාතකය
depressotruncatus=නතාග්‍ර
deprival=දුෂ්කරතාව | වියෝගය | හානිය
deprivation=අහිමි භාවයට පත්කිරීම | දුෂ්කරතාව | වියෝකිරීම | වියෝගය | විහිනතාව | හානිය
deprive=අහිමි කරනවා | ඉවත් කරනවා | නොදී පැහැර ගන්නවා
deprived=තොර කළ
deproblematization=ගණ්ඨිවිජටනය
depth=අධිකත්වය | ගැඹුර | ගැඹුරු තැන | ගැඹුරුකම | ජඹුර | පත්ල | මධ්‍යය | මුහුද
deputation=නියෝජිත පිරිස
depute=නියෝජනය කරනවා
deputise=නියෙදෙනවා | නියෝජනය කරනවා | නියෝජ්‍යනය කරනවා
deputize=වෙනුවෙන් ක්‍රියා කරනවා
deputy=අනුනායක | උප ප්‍රධානයා | නියෙදි | නියෝජ්‍ය | නියෝජ්‍යයා | නියෝජිතයා
derail=පීලි පනිනවා | මිරිය පීලි පැනීමට සලස්වනවා
derange=අවුල් කරනවා | ව්‍යාකුල කරනවා | වික්ෂිප්ත කරනවා
deranged=ව්‍යාකුල | වික්ෂිප්ත
derangement=ව්‍යාකුලත්වය | වික්ෂිප්තය | වික්ෂේපණය | විසංවිධානය
derating=වරිපණමින් මිදීම | විවැගයීම
dereistic=ස්වේච්ඡක වන්තනය
derelict=අත් හළ | අත්‍යක්ත | හැර දමනලද දේ | හැර දමනලද නැව
dereliction=අපත්‍යජනය
derequisition=අනධිග්‍රහණය කරනවා | නිදහස් කරනවා
deride=උපහාස කරනවා | සමච්චල් කරනවා | සරදම් කරනවා
derision=අපහාසය | අවඥාව | පරිහාසය | සමච්චලය
derisive=සරදම් සහිත
derisory=උපහාසාත්මක | කල්පනාවට ගන්න තරම් නොවටිනා
derivant=ව්‍යත්පන්නය
derivation=නිරුක්තිය | ප්‍රභවය | මුල් උත්පත්තිය | ව්‍යත්පත්ති | ව්‍යත්පන්න කිරීම
derivative=තද්භව | තද්භවය | ප්‍රත්‍යර්ථපදය | භින්න | යම් කිසිවකින් උපන් | ව්‍යුත්පන්න | ව්‍යුත්පන්නය
derivatives=ව්‍යුත්පන්න
derive=උත්පත්තිය සොයනවා | උපදිනවා | එසෙයින් ලැබෙනවා | නිරුක්තිය වශයෙන් සලකනවා | මුල සොයනවා | මූලාරම්භය වශයෙන් සලකනවා
derived=තත්භව | භින්න | ව්‍යත්පන්න
dermacentor=ඩර්මාසෙන්ටෝර්
dermal=චර්මීය
dermatinus=චර්මරුහ
dermatitant=චර්මකෝපකය
dermatitis=චර්ම දාහය | චර්ම රෝගයක්
dermatogen=චර්මජනකය
dermatography=චර්මරේඛායනය
dermatology=සම පිළිබඳ විද්‍යාව
dermatome=චර්මඡේදය
dermatophyte=චර්මපරපෝෂිතය
dermatoscope=දෙනෙති අණ්වීක්ෂය
dermatosome=තන්තුදේහය
dermis=ඇතුල් සම | චර්මය
derogate=අගය අඩු කරනවා | ආසූයනය කරනවා | තත්ත්වයට හානි වෙනවා | නමට හානි වෙනවා | බාල්දු කරනවා | මඟ හරිනවා | හීනකරනවා
derogation=අගය අඩුවීම | නමට හානිවීම
derogatory=අවනම්බු සලසන | ආසූයන | නොගැළපෙන | පරිභවාත්මක | බාල්දුකාරි | මඟ හරින | හීන කාරක
deroofing=පියසි වැටීම
derrick=ඩෙරිකය | දොඹකරයක් වැනි යන්ත්‍රයක්
derricking=ඩෙරිකීම
derring-do=චණ්ඩිකම | මහත් නිර්භීතකම
derringer=කුඩා පිස්තෝලය
derris=නිවර්තන කලාපීය ගසක්
derrumbado=ඩෙරුම්මාඩෝ | නාය යෑම
derv=සල්
dervish=ඉස්ලාම් ධර්මයේ සාමාකයෙක් | මුස්ලිම් තාපසයා
desabille=විවස්ත්‍ර
desalinate=කරදියෙන් ලුණු රසය ඉවත් කරනවා
descant=රිද්මය | විස්තර විභාග දක්වා දිගට කථා කරනවා
descend=ඔරනවා | පහත් වෙනවා | පැවත එනවා | බසිනවා | බහිනවා | බැස්ම
descendant=අවරෝහණයා | දරු මුනුබුරු පරම්පරාව | පැවතෙන්නා | වංශයෙන් පැවැතෙන්නා
descended=පරම්පරාවෙන් පැවතෙන
descendents=පැවතෙන්නෝ
descending=අවරෝහණ | බැහීම | සම්පාතය
descent=අවගමනය | අවරෝහණය | පරපුර | පල්ලම | පහත බැසීම | පෙළපත | බැස්ම | වංශයෙන් පැවත ඊම | වංශානුක්‍රමය | හදිසියෙන් පහර දීම
descration=කෙලෙසීම
descreption=වර්ගය
describable=විස්තර සහිත
describe=අඳිනවා | කියා දෙනවා | පෙන්නා දෙනවා | වණනවා | වර්ණනා කරනවා | විස්තර කරනවා | සලකුණු කරනවා
described=ඇඳි | වර්ණිත
description=වර්ණනය | වර්ණනාව | වැණීම | වැණුම | විස්තරය | සටහන
descriptions=වර්ණනය | විස්තර | විස්තරය
descriptive=ව්‍යක්ත | විස්තරාත්මක | සවිස්තර
descriptivism=විස්තරවාදය
descriptor=සූචකය
descry=අමාරුවෙන් දකිනවා | දුරින් යන්තමින් දකිනවා | යන්තමින් දකිනවා
desease=රෝග
desecrate=කෙලෙසනවා
desecration=ශුද්ධ වස්තු කෙළෙසීම
desegregate=වර්ණ භේදය නැති කරනවා
desensitive=විසංවේදී
desensitization=අසංවේදකරණය | විසංවේදීකරණය
desensitizer=විසංවේදීකාරකය
desert=අතරමං කරනවා | අත්හැර දමනවා | කාන්තාරය | ජනශූන්‍ය | ජනශූන්‍ය ප්‍රදේශය | ත්‍යජනය කරනවා | දමා යනවා | නිසරු බිම | පළායනවා | පාළු නිස්සාර | පිටිපානවා | යනවා | සැඟවී යනවා | හුදකලා වූ
deserter=ත්‍යජකයා | දමා යන්නා | යුද්ධ සේවයෙන් පැනයන්නා
desertion=අත් හැර දැමිම | අත්හැර දැමීම | අත්හැර යාම | ත්‍යජනය | දමා යෑම | පලායාම් | පැන යාම
deserts=ලැබිය යුතු ප්‍රතිඵල | ලැබිය යුතු විපාක
deserve=යෝග්‍යව සිටිනවා | සුදුසුව සිටිනවා
deservedly=යෝග්‍ය ලෙස | සුදුසු පරිද්දෙන්
deserving=අර්භ | ප්‍රශංසනීය | යෝග්‍ය | සුදුසු
desicant=ශෝෂකය
desiccate=වේළනවා | ශෝෂණ කරනවා
desiccated=වියළි | ශුෂ්ක
desiccation=වියලීම | වියැළීම | ශෝෂණය
desiccator=ඩෙසිකේටරය
desiderata=අවශ්‍ය කාරණා | අවශ්‍යතා
desiderate=අපේක්ෂා කරනවා
desideratum=අවශ්‍ය කාරණය | ඉච්ඡිතය
design=අභිප්‍රාය | අරමුණ | අරමුණු කරනවා | ක්‍රියාමාර්ගය | නපුරු අදහස | නිර්මාණ සටහන | නිර්මාණය | නිර්මිතිය | පිරිමැවුම | පිරිසැලසුම | මෝස්තරය | රටාව | රූපාංකනයමෝස්තරය | වකීර්ෂාව | සැලසුම් නිර්මාණය | සැලැස්ම | සැලැසුම් නිර්මාණය | සැළසුම් නිර්මාණය
designate=තනතුරට නියම කරනවා | නම නියම කරනවා | නම් කරනවා | නාමෝද්දේශනය කරනවා | නිමිති කරනවා නාමෝද්දේශනය කරනවා | නිලය ලබන | පත් කරනවා
designation=අභිධා | අභිධානය | උපාධිය | තනතුර | නාමය | නාමොද්දිෂ්ටය | නිමිතිකරණය | නියම කිරීම | නිල නාමය | පදවියේ නම
designatum=නාමාභිධානකරණය
designedly=අදහසක් ඇතුවම
designer=පිරිමවන්නා | මෝස්තර රචක | රූපාංකනකයා | සැලසුම් නිර්මාණකරුවා
designing=උගුල් අටවන | නපුරු අදහස් ඇති | මෝස්තර රචනය
desilverisation=රජතීහරණය
desirability=අභිප්‍රෙයතාව | යෝග්‍යතාව | සුදුසුකම
desirable=අභිමත | කමනීය | ප්‍රිය උපදවන
desire=අටිය | අපේක්ෂාව | අභිප්‍රාය | අභිමතය | අභිරුවය | අභිලාෂය | ආශාව | ආසා කරනවා | ආසාව | ඈලියාව | ඉච්චාව | ඉල්ලා සිටිනවා | කලිමල | කාමය | කැමති වෙනවා | කැමැත්ත | තණ්හාව | තුස | තෘෂ්ණාව | දොළ | දොළනවා | පතනවා | පිරිය | පුලනවා | මනදොළ | මනෝරථය | රිසි | රුසි | ලොබ | ලෝභ
desired=අපේක්ෂිත | අභිමත | ඉෂ්ට
desirer=පුලන්නා
desirous=අර්ථි | ආසා කරන | උත්සුක | කැමති | කැමති වන | ලොල් වූ | සොඬ
desk=ලියන මේසය
deskito=ඩෙස්කිටෝ
desmic=පූලක
desmid=ඩෙස්මිඩය
desmidian=ඩෙස්මිය
desmodium=උඳුපියලිය
desmogen=ප්‍රාක්කැම්බියම
desmolase=ඩෙස්මොලේස්
desmotrope=මිතප්‍රයුක්තය
desmotropism=මිතප්‍රයුක්තතාව
desogen=ඩෙසොජන්
desolate=අසරණ | ජනශූන්‍ය | පාළු | පාළු කරනවා | හුදකලා
desolated=පාළු කරන ලද | ශෝකයෙන් පීඩිත
desolation=පාළු බව | බලවත් ශෝකය | වියෝගය
desorption=නිරධිශෝෂණය
desoxycorticosterone=ඩෙස්ඔක්සිකෝටිකෝස්ටිරෝන්
desoxyribose=ඩිසොක්සිරයිබෝස්
despair=නෂ්ටාපේක්ෂාව | බලාපොරොත්තු නැති කරගන්නවා | බලාපොරොත්තු නැතිව සිටිනවා
despairing=බලාපොරාත්තු නැතිව සිටින
despatch=ඇරීම | කඩිසරකම | පටවා යවනවා | පයිංඩය | ප්‍රස්ථාපනය | පිටත් කොට යවනවා | පිටත් කොට යැවීම | පිටත්කර යවනවා | මරාදමනවා | යමක් ඉක්මණින් කරනවා | යැවීම | සන්දේශය
despatched=යවාපු
desperado=මැරවරයා | සාහසිකයා
desperate=ඉතා දුෂ්කර | දරුණු | බලාපොරොත්තු රහිත | බලාපොරොත්තු සුන් වූ
desperation=බලාපොරොත්තු නැති බව
despicable=අධම | තුච්ඡ | නින්දිත
despise=අවමන් කරනවා | ගර්හා කරනවා | නීච කොට සලකනවා | බාල්දු කරනවා
despite=තිබියදීත් | නොසලකා | විරෝධය
despoil=උදුරාගන්නවා | කොල්ලකනවා | පැහැර ගන්නවා | වනසනවා
despoillion=උදුරා ගැනීම | කොල්ල කෑම | පැහැර ගැනීම | වැනසීම
despoilment=උදුරා ගැනීම | කොල්ල කෑම | පැහැර ගැනීම | වැනසීම
despond=අධෛර්ය්‍ය වෙනවා | බලාපොරොත්තු අඩු කරගන්නවා
despondency=අධෛර්ය්‍ය වීම | කනස්සල්ල | කලකිරීම
despondent=අධෛර්ය්‍යයට පත් | කලකිරුණු | දොම්නසට පැමිණි
despot=අනුකම්පා රහිත තැනැත්තා | පරම බලධාරී පාලකයා | සාහසිකයා | ස්වෛරී රජ | හයිකාරයා
despotic=අත්තනෝමතික | ස්වෛරී | හිතුමතයේ ක්‍රියා කරන
despotism=ඒකාධිපත්‍යය | පරම බලධාරිත්වය | බලාත්කාරකම | ස්වෛරී පාලනය | හිතුමතයේ ක්‍රියා කිරීම
desquamation=විශල්කනය
dessert=අතුරුපස | අවුළු | අවුළුපත්
destabilise=විස්ථායී කිරීම
destarched=පිෂ්ටහෘත
destination=කල්තියා නියම කිරීම | ගමනස්ථානය | ගමනාන්තය | නියමිත ස්ථානය
destine=කලින් නියම කරනවා | දෛවයෙන් නියම කරනවා
destined=නියත | නියමිත
destiny=ඉරණම | දෛවය | නියමය
destitute=අනාථ | අපිළිසරණ | අසරණ | දරිද්‍ර | දීන | ධනහීන | නිස්සරණ
destitution=අසරණභාවය | දිළිඳුකම
destortion=විකෘතිය
destory=කඩාකප්පල් කරනවා
destratification=නිස්තරායණය
destroy=කම්මුතු කරනවා | කා දමනවා | කාබාසිනියා කරනවා | තූ තූ කරනවා | තොර කරනවා | නසනවා | නාස්ති කරනවා | නැතිභංග කරනවා | පොඩි පට්ටම්කරනවා | මුලිනුපුටනවා | රටකනවා | වනසනවා | විනාශ කරනවා | සමතලා කරනවා | සාධනවා | සිඳ බිඳ දමනවා | සුනුවිසුණු කරනවා
destroyed=ක්ෂීණ | නට | විනෂ්ට | සුන්
destroyer=නාශකය | විනාශ කරන්නා
destroying=රුප්පන | සමුච්ඡේදක
destructible=විනාශ කළ හැකි
destruction=ක්ෂය | ඝාතය | නස්පැත්තිය | ප්‍රතිඝය | ප්‍රලය | ව්‍යය | වැනසිල්ල | වැනසීම | වැනසුම | විනාශ කිරීම | විනාශය | විනේ | විලෝපය | සංහරණය | හානිය
destructive=ඝාතක | නාශක | නාස්ත්‍යාත්මක | නාස්තිය | වනසන | ව්‍යාල | විනාශකාරී | සංහාරක
destructor=කසළ දවන යන්ත්‍රය | වනසුව
desuetude=අභාවිතය
desulphuration=ගෙන්දගම්හරණය
desulphurization=විසල් පරීකරණය
desultorily=අනුක්‍රමිකව | අපිළිවෙළට
desultoriness=පිළිවෙළකට නැතිකම
desultory=අක්‍රමික | අනවස්ථිත | චංචල | පිළිවෙළකට නැති
detach=ගලවනවා | ලිහනවා | වියුක්ත කරනවා | වෙන් කරනවා
detachable=වෙන්කළ හැකි
detached=අබද්ධ | තනි වූ | තැන්පත් | මධ්‍යස්ථ | වියුක්ත | වෙන් වූ
detachment=අපක්ෂපාතකම | අබද්ධ කිරීම | අබද්ධය | මධ්‍යස්ථතාව | වෛරාග්‍යය | සිතෙහි තැන්පත් බව
detail=නියම කරනවා | ව්‍යාස | විතර | විස්තර කරනවා | විස්තර විභාගය | විස්තරය | සවිස්තර සැලසුම | සුළු කාරණය | සුළු කොටස
detailed=සවිස්තර
detailer=විස්තර සැලසුම්කරුවා
details=තොරතුරු | යමකට ඇතුළත් සියල්ල
detain=ප්‍රමාද කරනවා | රඳවනවා | රඳවා තබනවා
detainer=රැඳැවුව
detaining=රඳවා තබන | රළවන
detassel=තසල සිඳීම
detect=අනාවරණය කරනවා | සොයා දැනගන්නවා
detection=අනාවරණය | අනාවරණය කිරීම | අබික්සුම | අභික්ෂණය | අභීක්ෂණය | රහස්‍ය අනාවරණය
detective=අබික්සු | අභික්ෂක | අභීක්ෂක | රහස් පරීක්ෂකයා
detector=අනාවරකය | පරීක්ෂක උපකරණය
detente=උණුසුම් හැඟීම් තුනී කරන | සංසිඳියාව
detentio=රඳවා තැබීම | රැඳැවුම
detention=ප්‍රමාද කිරීම | රඳවා ගැනීම | රඳවා තැබීම | හිර අඩස්සියේ තැබීම | හිරබාරයේ තැබීම
detenu=රැඳැවියා
deter=බාධා කරනවා
deterent=නිවාරක | වළක්වන කරුණ
detergency=ක්ෂාලකත්වය
detergent=අපක්පාලකය | ක්ෂාලක | ක්ෂාලකය | කුණු පහකරන ද්‍රව්‍යය
deteriorate=ක්‍රමයෙන් නරක් වෙනවා | දිරාපත් වෙනවා | නරක් වෙනවා | පිරිහෙනවා | වියැකෙනවා
deterioration=අනුහානිය | දිරාපත් වීම | නරක අතට හැරීම | නරක්වීම | පිරිහීම | වියැකීම
determinable=නිර්ණෙය | නිශ්චයනීය | නිශ්චේය
determinancy=නියතතාව
determinant=නිර්ධාරකය | නිශ්චායකය | නීර්ණායකය
determinate=අධිෂඨිතය | ඒකාන්ත | නියමිත | නිර්ණය | නිර්ණිත | නිශ්වත
determination=අධිෂ්ඨානය | අවසන් වීම | ධෛර්ය්‍යය | නිර්ණන | නිර්ණනය | නිර්ණය | නිර්ණය කිරීම | නිර්ණයනය | නිශ්චය | පරිසමාප්තිය | ප්‍රණිධිය | ප්‍රණීධානය | මනහ් ප්‍රණිධානය | මුරණ්ඩුකම
determine=අධිෂ්ඨාන කරගන්නවා | ඉටනවා | තීන්දු කරනවා | තීරණය කරනවා | නියම කරනවා | නිර්ණය කරනවා | නිශ්චය කරනවා | බේරාගන්නවා | සමාපනය කරනවා | සිතින් නිශ්චය කරගන්නවා
determined=අධිෂ්ඨාන සහිත | මුරණ්ඩු | ස්ථිර අදහස් ඇති
determining=නිශ්චයීය
determinism=නියති වාදය | නියතිවාදය
determinist=නියතිවාදියා
deterministic=නිර්ණායන
deterrence=නිවර්තනය
deterrent=නිවර්තකය
detest=අතිශයින් පිළිකුල් කරනවා | අප්‍රිය කරනවා | නුරුස්සනවා
detestable=අශික්ෂිත | නින්දිත
detestation=ද්වේෂය | බලවත් පිළිකුල
dethrone=සිංහාසනයෙන් පහකරනවා
dethronement=සිංහාසනයෙන් පහකිරීම
detonate=ප්‍රස්ඵෝටනය කරනවා | පුපුරවනවා | මහත් හන් පිපිරෙනවා
detonation=ප්‍රස්ඵෝටනය | පිපිරීම
detonator=පතරොම | ප්‍රස්ඵෝටකය | පිපිරවීමේ උපකරණය
detour=වෙන අතකට යාම
detoxication=විෂහරණය
detract=අගුණ කියනවා
detraction=අපකර්ෂණය | හෙළා දැකීම
detractor=අගුණ කියන්නා
detribalization=විග්‍රෝත්‍රිකරණය
detriment=අවාසිය | පාඩුව | හානිය
detrimental=අනර්ථදායක | අලාභ ඇති කරන | අහිත | පාඩු ඇති කරන | විපත්තිකාරී
detritus=කැටකැබිලිති | සුන් පහණ
detune=නිසර කරනවා
detuning=නිසර කිරීම
deuce=යක්ෂයා
deuced=කියන්න බැරි තරම්
deuterate=ඩියුටරේට්
deuterium=ඩ්‍යටීරියම් | ඩියුටීරියම් | ඩියුටීරීයම්
deuternnopia=අපවිදෘෂ්ටිකතාව | ඩ්‍යටරුනෝපියාව
deuteron=ඩියුටරොන් | ඩියුටරෝනය
deutoplasm=සුදු මදය
deutoxylem=ප්‍රතිශෛලම
deutschmark=ඩොයිෂ් මාර්ක්
devale=දෙවොල | දේවාලය
devaluation=අව ඇගයීම | අව ප්‍රමාණ කිරීම | අවප්‍රමාණ කිරීම | අවප්‍රමාණය | අවමූල්‍යයනය | බාල්දු කිරීම
devalue=අවප්‍රමාණ කරනවා | මුදලේ අගය අඩු කරනවා
devastate=කොල්ලකනවා | පාළු කරනවා | වනසනවා
devastation=කොල්ලකෑම | පාළු කිරීම | වැනසීම
devatas=දේවතාවෝ
develop=ක්‍රමයෙන් එළිදරවු වෙනවා | ක්‍රමයෙන් සමෘද්ධියට පැමිණෙනවා | දියුණු වෙනවා | නංවනවා | බෝ වෙනවා | වඩනවා | වඩවනවා | වැඩි දියුණු කරනවා | වැඩෙනවා | විකාස කරනවා | සැදෙනවා
developable=සංවර්ධ්‍ය | සංවර්ධ්‍යය
developed=දියුණු | වැඩුණු | විරූඩ | සංවර්ධිත | සමෘද්ධ
developer=විකාශකය | විකාසකය
developing=වර්ධක
development=උපචය | දියුණුව | ප්‍රවර්ධනය | වර්ධනය | වැඩ | වැම | විකසනය | විකාශනය | විකාශය | සංවර්ධනය | සමෘද්ධිය
deventure=ණයකරය
deviance=අපගමනතාව
deviant=අපගාමිකයා
deviate=අපගතය | අපගමනය කරනවා | අපගමනය වනවා | අපගමනය වෙනවා | උල්ලංඝනය කරනවා | පිට පනිනවා
deviating=අපගාමක
deviation=අනියම් මග ගැනීම | අපගමනය | උල්ලංඝනය | භ්‍රංශය | ව්‍යපගමනය | විචලනය
deviator=අපගාමකය
device=උපකරණය | උපක්‍රමය | උපාය | ප්‍රයෝගය | පියෝ | යෙදීම
devil=අතිදුෂ්ටයා | කුළුබඩු හුඟක් දමා බදිනවා | ගරාදි කබල | මුද්‍රණකරුගේ අතවැසියා | යක්ෂයා | යකා
deviled=මිරිස් යොදා බදින ලද
devilish=අතිශය | ඝෝර | දරුණු | යක්ෂ
devilment=මහත් දඟකාරකම | යකා කිරීම | යකෙකුමෙන් හැසිරීම
devilmentry=මහත් දඟකාරකම | යකා කිරීම | යකෙකුමෙන් හැසිරීම
devious=අනියම් | කුටිල | දුර මාර්ගයෙහි යන | වක්‍ර | වැරදි
devise=අන්තිම කැමැත්තකින් පැවරීම | උපක්‍රමයක් කරනවා | උපායක් යොදනවා | දිවිසනවා | දිවිසිය | මාර්ගයක් සොයා ගන්නවා | රික්ථවරණය | රික්ථවරණය කරනවා | රික්ථවාරණය | රික්ථවාරණය කරනවා
devisee=දිවිසිලද්දා | ප්‍රතිලාභියා | රික්ථාවාරණලාභිය
devitrifaction=විකාචනය
devitrification=විකාචනය
devoid=තොර | රහිත | ශූන්‍ය | හිස් | හීන
devolution=උරුමපථය | පැවරීම | විමධ්‍යගත කිරීම | සාරෝපණය
devolve=පවරනවා | පැවරෙනවා | භාර කරනවා | භාර වෙනවා | සාරෝපණය වෙනවා
devolving=සාරෝපණය වන
devonian=ඩෙවෝනීය
devote=කැප කරනවා | කැප වෙනවා | ව්‍යාවෘත වෙනවා
devoted=අතිශය හිතේසී | ඉතා ළැදි | කැප කළ | තත්පර | භක්තිවන්ත | සද්ධාවන්ත | සැදැහ | ළැදි | ළෙන්ගතු
devotee=උපාසක | උපාසකයා | දෘඩ භක්තිකයා | බැතිමතා | සැදැහැවතා
devotees=බැතිමතුන් | සැදැහැවතුන්
devotion=ආත්ම පරිත්‍යාගය | ඇදහීම | බලවත් ඇල්ම | භක්තිය | ශ්‍රද්ධා | ශ්‍රද්ධාව | සද්ධා | සැදැහ | සැදෑ | ළැදියාව
devotional=ආගමික | ඇදහිල්ල පිළිබඳ | භක්තිය පිළිබඳ
devotly=ඉතා ඕනෑකමින් | මහත් භක්තියෙන්
devour=ඉතා ආශාවෙන් කියවනවා | කාදමනවා | කෑදර ලෙස කනවා | ගිල දමනවා | ගිලිනවා | වනසනවා
devout=අවංක | ධර්මිෂ්ඨ | ධාර්මික | බැතිමත් | භක්තිමත් | සැදැහැති
dew=තුෂර | තුෂාර | පින්න | පිනි
dew-leaves=පිනිපත්
dewatering=දිය ඉවත් කිරීම
dewfalls=පිනි බානවා
dewy=පින්නෙන් තෙත් වූ | පිනි සහිත
dexterity=දක්ෂකම | දක්ෂතාව | සාමර්ථ්‍යය | හුරුකම
dexterous=දක්ෂ | නිපුණ | හපන්
dextrad=දක්ෂිණාවර්ත
dextral=දක්ෂිණ පාර්ශ්වික | දක්ෂිණාවර්ත
dextrality=දකුණත් හුරුව
dextrasinistral=වාමදක්ෂිණාවර්ත
dextrin=ඩෙක්ස්ට්‍රින්
dextrinase=ඩෙක්ට්‍රිනේස්
dextro-compound=දක්ෂිණාවර්ත සංයෝගය
dextroamphetamide=ඩෙක්ස්ට්‍රොඇම්පිටමයිඩ්
dextroposition=දක්ෂීණස්ථාපනය
dextrorotatory=දක්ෂිණ භ්‍රමක | දක්ෂිණාවර්ත
dextrorse=දක්ෂිණාවර්ත | සුරත් වක්‍රය
dextrorsum=සුරත් වක්‍රය
dextrose=ඩෙක්ස්ට්‍රෝස්
dextrous=දක්ෂ | නිපුණ | හපන්
dhal=පරිප්පු
dhall=පරිප්පු
dhamma=රත්නත්‍රය
dharma=ධර්මය | යහපත් හැසිරීම
dhoby=රදවා | රෙදි සෝදන්නා | හේනේ මාමා
dhoti=ඉන්දියාවේ පිරිමින්ගේ ඇඳුමක් | දෝතිය
dhow=ඔරු වර්ගයක් | ගුන්දිරාව | දෝනිය
dhvani=ධ්වනිය
di=ද්වි
diabase=ඩයබේස්
diabetes=දියවැඩියාව | ප්‍රමේහ | මධුමේහය | මේය | මේහය
diabetic=දියවැඩියාව ඇති | මේහ
diabetics=මධුමේහය
diabolic=ඉතා දුෂ්ට | දරුණු | පාපිෂ්ඨ
diabolical=ඉතා දුෂ්ට | දරුණු | පාපිෂ්ඨ
diachronic=පාරකාලික | යමක ඉතිහාසයේ වර්ධනය පිළිබඳ
diaclinal=පාරානතික
diacmic=දෙකුළු
diacolation=පාරශ්‍රාවණය
diacritical=ශබ්ද දක්වන ලකුණු පිළිබඳ
diad=ද්වික | ද්විකය
diadelphous=ද්විකලාපික
diadem=උෂ්ණීෂය | ඔටුන්න | කිරීටය
diadromous=අනුවිකිරණ
diaeresis=බැඳි ස්වර දෙකක් වෙන්ව ශබ්ද කළ යුතු බව අඟවන ලක
diagenesis=ප්‍රතිජනනය
diageotropic=ලම්බගුරුත්වාවර්ති
diageotropism=ලම්බගුරුත්වාවර්තනය
diaglyph=ඉන්ටාලියෝ උත්කීරණය
diagnose=දර්ශනය | නිදානය සෙවීම | නිදානය සොයනවා | රෝග විනිශ්චය | රෝග විනිශ්චය කරනවා | වකිත්සාව
diagnosis=නිදාන ඥානනය | පාරඥෙයය | රෝග විනිශ්චය | වකිත්සාව | විවෘතිය | හේතුනිර්ණය
diagnostic=නිදාන ඥානී | රෝග විනිශ්චය පිළිබඳ | සංජානනාත්මක
diagnostician=සංජානනාත්මක විශේෂඥයා
diagonability=විකර්ණායතාව
diagonal=කර්ණය | කොණින් කොණට යෙදුණු | කෝණක්ෂය | විකර්ණ | විකර්ණය
diagonalisation=විකර්ණායනය
diagonalize=විකර්ණාකාර කරනවා
diagram=දළ රූප සටහන | දළරූප සටහන | ප්‍රස්තාරය | රූප සටහන | රූප සටහන දළරූප සටහන | රූපය | රූපසටහන | රූසටහන | රේඛා වත්‍රය | රේඛා සටහන | රේඛාචිත්‍රය | සටහන
diagramatic=රේඛවත්‍රමය
diagrammatic=රූප සටහන් | රේඛා වත්‍රමය
diagrams=රූප සටහන්
diaheliotropism=ලම්බසෞරාවර්තනය
diakinesis=උපේරණය
dial=අංක මුණත | අංක මුහුණත | අංක මූණත | අංකමූණත | අක්වට | අක්වටනවා | අක්වටය | පෑ තැටිය | මුහුණත කරකවනවා | මුහුණතෙහි දක්වනවා | මූණත | සූර්ය ඝටිකාව
dialect=උපභාෂාව | දේශීය භාෂාව
dialectian=තාර්කිකයා | නෛයායිකයා
dialectic=අපෝහක | අපෝහකය | අපෝහකවාදී | අපෝහවාදී | තර්ක | ද්වන්ද්ව | න්‍යාය | හේතුවිද්‍යාව
dialectical=තර්කාත්මක | තාර්කික
dialectician=අපෝහකයා
dialectics=අපෝහකවාදය
diallelon=නිර්වචනගත චක්‍රකය
dialleus=සාධනගත චක්‍රකය
dialling=අක්වැටුම
dialogism=ද්විධානුමානය
dialogue=දෙබස | සංවාදය | සම්භාෂණය
dialysate=කාන්දු පෙරෙනය
dialysed=කාන්දු පෙරූ
dialyser=කාන්දු පෙරහන
dialysis=කාන්දු පෙරීම
dialytic=ව්‍යාශ්ලේෂ
dialyzate=කාන්දුව
dialyzator=කාන්දු පෙරහන
dialyzer=කාන්දු පෙරහන
diamagnetic=පාරක්ෂේත්‍ර චුම්බක | පාරචුම්බක
diamagnetism=පාරචුම්බකත්වය
diamante=දිලිසෙන කුඩු යොදා අලංකාර කරන ලද
diameter=විෂ්කම්භය
diametral=විෂ්කම්භක
diametrical=අත්‍යන්ත
diametrically=අත්‍යන්තයෙන්
diamidine=ඩයමින්
diamine=ඩයිඇමයින්
diamond=දියමන්ති | දියමන්තිය | රුයිත | රුවත | වජ්‍ර | වජ්‍රය | වදුර | වදුරු | වර | විදුර | විදුරු
diandrae=ඩියන්ඩ්‍රේ
diandreous=ද්විරේණුක
diandria=ඩියන්ඩ්‍රියා
diandrous=ද්විරේණුක
dianoia=සවිචාරිය අවබෝධනය
dianthus=මල් ගසක්
diapason=ස්වරසංවාදය
diapause=උපරමය
diaper=වත්‍ර දුකූලය | සිත් දුහුල
diaphanometer=පාරදෘශ්‍යෙක්ෂය
diaphanoscope=පාරදෘශ්‍යෙක්ෂය
diaphanous=විනිවිද පෙනෙන | විශද | ස්වච්ඡ
diaphoretic=අපෝහකය | ස්වේදකාරකය
diaphototaxis=ලම්බප්‍රභාසාර්වසරණය
diaphototropic=ලම්බප්‍රභාවර්තී
diaphototropism=ලම්බප්‍රභාවර්තනය
diaphragm=තනු පට | තනුපට | ප්‍රාචීරය | මහා ප්‍රාචීර පේශිය
diaphysis=විරුහණය
diapositives=පාරානුච්ඡායා
diarch=දෙකොන්
diarchy=ද්වි රාජ්‍යය | ද්වෛධිතන්ත්‍රය
diarist=දින චර්යා සම්පාදක
diarrhoea=අතීසාරය | ප්‍රවාහිකාව | පාචනය
diarsenate=ඩයිආසනේට්
diarsenide=ඩයිආසනයිඩ්
diarsenite=ඩයිආසනයිට්
diarsine=ඩයිආසීන්
diarthrosis=ආපාර්වය
diary=දින වැඩ ලේඛනය | දිනපොත
diaschisis=අවකෝපත්තාව
diascope=ඩයස්කෝපය
diascoraceae=ඩයස්කොරසියා
diasone=ඩයසෝන්
diaspora=යුදෙව්වන්ගේ විසිර යෑම | විසිරණය
diastase=ඩයස්ටේස් | ඩයස්ටේස් නම් එන්සයිමය
diastema=අතුරුකඩ
diaster=ඩිඅස්ටර්
diastereomer=පාරත්‍රිමාන සමාවයවිකය
diastole=ඩයැස්ටෝල් | වින්‍යස්තය | විස්තාරය | හෘදය ස්ඵුරණය | හෘදවිකාශනය
diastrophic=භූ විරූපණ
diathermancy=පාරතාපකත්වය
diathermanous=පාරතාපක
diathermy=පාරතාපනය | විතාපනය
diathesis=පාරස්ථායිතාව
diathormy=තාරකාපනය
diatom=ඒකසෛලික ජලජශාකය | ඩයටම
diatomaceous=ඩයටමාකාර
diatomic=ද්විපරමාණුක | පරමානු දෙකක් ඇති
diatomine=ඩයටමීන්
diatonic=ශුද්ධ ස්වරග්‍රාමය
diatribe=අප භාෂණය | දීර්ඝ දෝෂ විවේචනය | වේගවත් විවේචනය
diatropic=ලම්බ වර්තී
diatropism=ලම්බාවර්තනය
diazotization=ඩයැසොටීකරණය
dibasic=ද්විභාස්මික
dibble=පත්ත
dibromide=ඩයිබ්‍රෝමයිඩ්
dicarbonate=ඩයිකාබනේට්
dicarpellary=ද්විඅණ්ඩප | ද්විකාපලීය
dicaryocyte=ද්වින්‍යෂ්ටික සෛලය
dicaryon=ද්වින්‍යෂ්ටිකය
dicaryophase=ද්වින්‍යෂ්ටික කලාව
dice=ආදුව | දාදු කැට | දාදු කැටය | පස ඇට
dicephalous=ද්විශිරස්ක
dichasial=ද්විශාඛ
dichlamydeous=ද්විපරිපුෂ්පී
dichloramine=ඩයික්ලෝරැමයින්
dichloride=ඩයික්ලෝරයිඩ්
dicho=ද්විධා
dichogamy=අසමපරිණතිය
dichoglottic=ද්විකරසනක
dichopidial=ද්විගුණපාද
dichopodium=ද්විගුණපාදය
dichorhinic=ද්විකඝ්‍රාණික
dichotic=ද්විශ්‍රෝත්‍රික
dichotomal=දෙබෙදුම්
dichotomize=දෙකට බෙදෙනවා
dichotomous=දෙකට බෙදුණු
dichotomy=ද්විධාකරණය | දෙකට කැපීම | දෙබෙදුම
dichotypic=ද්විදර්ශ
dichotypy=ද්විදර්ශතාව
dichroism=ද්විවර්ණකතාව | ද්විවර්ණතාව
dichromate=ඩයික්‍රෝමේට්
dichromatic=වර්ණ දෙකක් ඇති
dichromatism=ද්විවර්ණතාව | ද්විවර්ණන්ධතාව
dichroscope=ඩයික්‍රොස්කෝපය
dickey=පස්සා බක්කිය
dicky=පස්සා බක්කිය
diclinism=ද්විමංචතාව
diclinous=ද්විමංච
dicliny=ද්විමංචතාව
dicotyledon=ද්විකොටිල ශාකය | ද්විබීජපත්‍රිකය | දෙපියලි පැළය | දෙපියලි ශාකය
dicotyledonous=ද්විකොටිල | ද්විකොටීල | ද්විබීජපත්‍රික | ද්විබීජපත්‍රී | දෙපියලි
dicoumarol=ඩයිකූමරොල්
dicrotic=ද්විඝටිත
dicta=උපදේශ | තීන්දුව | නියම | සිද්ධාන්ත
dictaphone=ඩික්ටපෝනය | පටිගත කරන ලද වචන නැවත ඇසිය හැකි යන්ත්‍රය
dictate=අණ කරනවා | ලියාගැනීම පිණිස කියවනවා
dictation=අනුලේඛනය | කියවන විට ලිවීම | නියෝජනය
dictator=ආඥාදායකයා | එකාධිපතියා | ඒකාධිපතියා
dictatorial=ඒකාධිපති | චණ්ඩ | විරුද්ධවාදීන් නොඉවසන | සර්වාධිකාරී | සාහසික
dictatorship=ආඥාදායක පදවිය | ආඥාදායකත්වය | සර්වාධිකාරිත්වය
dictics=ආහාර විද්‍යාව | භෝජන විද්‍යාව
diction=ලේඛනශෛලිය | ව්‍යවහාරය | වාක් සංදර්හය | වාග්විලාසය
dictionary=අකාරාදිය | ආකාරාදිය | කෝෂග්‍රන්ථය | ශබ්දකෝෂය
dictum=උපදේශය | තීන්දුව | නියමය | ප්‍රෝක්තය | වාවතය | සිද්ධාන්තය
dictyodesmic=ජාලවිකිරණ
dictyostele=ජාලස්ථුණය
dictyostelic=ජාලස්ථුණ
dicyclic=ද්විචක්‍රීය
dicylic=ද්විචක්‍රීය
did=කළා | පිළියෙළ කළා | පීඩාවට පත් කළා | රැවටුවා | සනීපෙන් සිටියා | සෑදුවා | සෑහුණා | හැසිරුණා
didactic=උපදේශාත්මක | ගුරුකම් ඇතුළත්
didactics=ශික්ෂා න්‍යාය
diddle=රවටනවා
didymous=යමක
didynamous=ද්විදීර්ඝක
die=අක්ෂය | අච්චුව | අභාවට යනවා | ඉස්කුරුප්පු කැටය | කාලක්‍රියා කරනවා | කාලයාත්‍රා කරනවා | කැටය | චුතවෙනවා | ජන්මාන්තරගත වෙනවා | දාදු කැටය | නසිනවා | නහිනවා | නැතිවෙනවා | නැසී යනවා | නැසෙනවා | නැහෙනවා | නිධන ප්‍රාප්ත වෙනවා | නිරුද්ධ වෙනවා | පණ නැති වෙනවා | පණ යනවා | පස ඇටය | මැරෙනවා | මිය යනවා | මියනවා | මියයනවා | මියෙනවා | මුද්‍රාව | වළ පල්ලට යනවා | විනාශ වෙනවා | ස්වර්ගස්ථ වෙනවා | හුස්ම යනවා
die-back=ප්‍රතිමාරය
die-hard=හණමිටිකාරයා
diehard=අමාරුකාර
dielectric=පරිවාරක සඳහා සුදුසු | පාරවිද්‍යුත් | පාරවිද්‍යුත් ද්‍රව්‍යය | පාරවිද්‍යුත්ද්‍රව්‍ය ද්‍රව්‍ය
diencephalse=කපාලාන්තරය
diene=ඩයිඊනය
dienophile=ඩයිඊනකාමිය
dierectric=පාරවිද්‍යුත් | පාරවිද්‍යුත් ද්‍රව්‍යය
dieri=ඩිරී
dies=අච්චු | මුද්‍රා
diet=ආහාරය | ඩයට් සභාව | පත්තියම් වෙනවා | පථ්‍ය ආහාරය | පුරුදු පන්තියම | බොජුන | භෝජනය
dietary=ආහාර | ආහාර චක්‍රය | භෝජන
dietectic=ආහාර පිළිබඳ වූ
dietetics=ආහාර විද්‍යාව | භෝජන විද්‍යාව
diettary=ආහාර පිළිබඳ ක්‍රමය | ආහාර පිළිබඳ නියමය | පත්තියම
diference=වෙනස
differ=එකඟ නොවී සිටිනවා | විරුද්ධ වෙනවා | වෙනස් වෙනවා | වෙනස්ව තිබෙනවා
difference=අන්තරය | ප්‍රභේදය | භේදය | මතභේදය | වම්පරස් | විප්‍රකාරය | විභේදය | විරෝධය | වෙනස | වෙනස්කම | වෙසෙස | වෙසෙස් | හිඟය
differencing=අන්තරණය
different=අන්කිසි | අන්‍ය | අනික් | අනෙක් | අප්‍රගල්භ | අසමාන | නානා | නේ | නේක | නොයෙක් | භින්න | විවිධ | වෙන | වෙනත් | වෙනස් | වෛවාරන්න
differentia=අවච්ඡේදනය | ව්‍යවර්තකය | වෙනස්කම
differentiable=අවකල්‍ය
differential=අවකල | අවකලන | අවකලය | අවතල | ආන්තර | ආන්තරය | චලනය | නානා වෙනස්කම් දක්වන | මෝටර් රථයෙහි කොටසක් | විශේෂක
differentials=අවකල
differentiate=අවකලනය කරනවා | විභේදනය කරනවා | විශේෂණය කරනවා | වෙනස් කොට දක්වනවා | වෙන්කොට දක්වනවා | සලකනවා
differentiating=අවකලන කිරීම
differentiation=අවකලනය | අවකලනය කිරීම | නිෂ්පාදිත ප්‍රභේදනය | ප්‍රභේදනය | ප්‍රහේදනය | විභේදනය | විශේෂණය | වෙන්කොට දැක්වීම
differentiator=අවකලකය
difficult=අපහසු | අමාරු | අමාරුව | අසීරු | ආශ්‍රය කිරීමට අමාරු | උගහට | ගාඩ | ගැටලු | තේරුම් ගැනීමට අමාරු | දුරවබෝධ | දුර් | දුෂ් | දුෂ්කර | දුෂ්කරතාව | දුහ් | දූ | බාධාව | බැරි | මරු | යමර | රූක්ෂ
difficulty=ජංජාලය | දුෂ්කරතාව
diffidence=පැකිලීම | බයාදුකම | සැකය
diffident=අප්‍රගල්භ | පැකිලෙන | බයාදු
diffiusivity=විසරණ සංගුණකය
diffluence=විස්‍යන්දනය
diffraction=විවර්තනය
diffusate=විසෘතය
diffuse=පතුරුවනවා | වචන රාශියකින් යුත් | ව්‍යාප්ත | විසරණය වෙනවා | විසාරී | විසිරි | විසුරුණු | විසුරුවනවා | විහිදුවනවා | සංක්ෂිප්ත නො වූ
diffused=විසාරිත | විසෘත
diffuseness=විසරණතාව
diffuser=විසරකය
diffusible=විසරණසුලු
diffusiometer=විසරණමානය
diffusion=අපවිලයනය | ප්‍රවේශය | පැතිරවීම | පැතිරීම | ව්‍යාප්තිය | විසරණය
diffusionism=විසරණවාදය
diffusionist=විසරණ වාදියා
diffusive=පැතිරෙන | ව්‍යාපක
diffusivity=විසාරීව
difilements=කෙලෙස්
dig=අංකය | අනිනවා | කණිනවා | කනිනවා | කොටනවා | සාරනවා | හාරනවා
digamy=දෙවැනි විවාහය
digest=ඉවසනවා | ධාරණය කරගන්නවා | පැසවනවා | රණය වීම | සංග්‍රහය | සංහිතාව | සඟරාව | සාරසංග්‍රහය | සාරාංශ සංග්‍රහය
digestant=ජීර්ණකය
digester=පාචකය | රකය
digestible=දිරවිය හැකි
digestion=ආහාර දිරවීම | ආහාර දිරවීමේ ශක්තිය | කකෑරුම | ජඨරාග්නිය | ජීරණය | දිරවීම | පත්තියම | පාචනය | රණය
digestive=කෑම දිරවන | ජීරක | පාචක | බඩගිනි වඩන | රක | රණ
digger=කැණිය
digging=සෑරීම
diggings=නවාතැන් පොළ | පදිංව ස්ථානය | රත්‍රන් ආකරය
dight=අලංකෘත
digit=අංකය | අංගුලි ප්‍රමාණය | අංගුලිකා | ඇඟිල්ල | ඇඟිල්ලක පළල | ඉලක්කම | සංකේතාංකය | සංඛ්‍යාංකය
digital=අංක | ඇඟිලි පිළිබඳ | කලා | සංඛ්‍යාංක
digitalin=ඩිටලින්
digitalis=ඩිටේලිස් | හෘදයාබාධවලට දෙන ඖෂධයක්
digitate=අංගුල්‍යාකාර | ආංගුලික | ඇඟිලි වැනි
digiting=සංඛ්‍යාංකනය
digitoxin=ඩිටොක්සින්
diglossia=දෙදිව් වහර
diglotic=ද්විරසනක
dignified=අනුභාවසම්පන්න | උත්කර්ෂවත් | උදාර | ගරු | ගෞරවයට පමුණුවන ලද
dignify=උතුම් බවට පමුණුවනවා | උසස් බවට පමුණුවනවා | ගෞරවයට පමුණුවනවා
dignitary=උතුම් පදවියක් දරන්නා | උසස් පදවියක් දරන්නා | උසස් පූජ්‍යපදප්‍රාප්තියා | නිධාරියා
dignity=අහංකාරය | ආනුභාවය | උදාර ලීලාව | උසස් බව | ගරුත්වය | ගෞරවය | ප්‍රතාපය
digonous=ද්විකෝණික
digoxin=ඩිගොක්සින්
digraph=තනි ශබ්දයක් දක්වන අකුරු දෙක | ද්විප්‍රස්තාරය
digress=ප්‍රස්තුත කාරණයෙන් පිටයනවා | මාතෘකාවෙන් පිටයනවා | මාර්ගයෙන් පිට පනිනවා
digression=අතුරුකථාව | අනවශ්‍ය තොරතුරු දැක්වීම
digs=නවාතැන් පොළ | පදිංව ස්ථානය | රත්‍රන් ආකරය
dihedral=ද්විතල
dihybrid=ද්ව්‍යංග දෙමුහුම්
dihydrate=ඩයිහයිඩ්‍රේට් | ද්විසජලය
dihydrol=ඩයිහයිඩ්‍රොල්
dikaryon=ද්වින්‍යෂ්ටිකය
dike=ඩයිකය | පරිඛාව | වේල්ල
diktat=නියෝගය
dilamination=විස්තරණය
dilapidate=ජරාවාස වෙනවා
dilapidated=කබල් | ගරාවැටුණු | ජරාවාස වූ
dilapidation=කටු කොහොල් | ගරාවැටීම | නටබුන් වීම
dilatancy=අභිස්තරණතාව
dilatation=දික් කිරීම | දික් වීම | පළල් කිරීම | පළල් වීම | ප්‍රසාරණය | විස්තරණය | විස්තාරණය
dilate=ඇදෙනවා | පළල් කරනවා | පළල් වෙනවා | මහත් කරනවා | මහත් වෙනවා | විහිදනවා
dilated=විස්තෘත
dilation=දික් කිරීම | දික් වීම | පළල් කිරීම | පළල් වීම | ප්‍රසාරණය | විස්තරණය | විස්තාරණය
dilatometer=විස්තරණමානය
dilatoriness=අතපසු කිරීම | ප්‍රමාද කිරීම
dilatory=අතපසු කරන | ප්‍රමාදකාරී
dilemma=අකරතැබ්බය | උභතෝකෝටික ප්‍රශ්නය | උභතෝකෝටිකය | උභතෝකෝටිය | මහත් සැකය
dilettante=කලා රසිකයා | කලා ලුබ්ධයා
dilettanti=කලා රසිකයෝ
dilettantism=කලාලුබ්ධභාවය
diligence=උද්‍යෝගය | කඩිසරකම | රථ වර්ගයක් | සම්ප්‍රජන්‍යතාව
diligent=අනලස | අනලස් | අප්‍රමාද | උත්සාහවන්ත | කඩිසර | කර්මශීල | කාර්යක්ෂම | කාර්යශීලී | සම්ප්‍රජන්‍ය
dill=දුරු | ශත පුෂ්ප | සුදුදුරු
dilly-dally=නිකරුණේ කාලය ගෙවනවා | වැඩ අතපසු කරනවා
diluent=තනූකාරකය
dilute=ජල මිශ්‍ර කරනවා | ජල මිශ්‍රිත | තනුක | තනූක | තනූක කරනවා | තුනී කරනවා | දිය කරනවා | දියාරු | බාල | බාලකරනවා | සැර අඩු
dilution=තන්වීකරණය | තනුකතාව | තනුකරණය | තනූකතාව | තනූකරණය | දියාරු කිරීම | බාල කිරීම
diluvial=ආදි දියළු | මහාජල ප්‍රවාහය පිළිබඳ වූ
diluvium=ආදි දියළුව
dim=අඳුරු | අඳූරු කරනවා | අඳූරු වෙනවා | දීප්තිය නැති | නොපැහැදිලි | පෙනීම අඩු
dimension=පරිමාණය | මානය | මිනුම | මිම්ම | විශාලත්වය
dimensional=මාන | විස්තෘත
dimensionality=මානත්වය
dimensions=මාන
dimercaptopropanol=ඩයිමර්කැප්ට්‍රොප්‍රොපනොල්
dimetric=චතුස්පාදක
dimidiate=අඩාල
diminish=අඩු කරනවා | අඩු වෙනවා | භ්‍රාසනය කරනවා | හායනය | හීන වෙනවා
diminished=භ්‍රසිත
diminishing=හීන වීම
diminuendo=ස්වරාවරෝහය
diminution=අඩු කිරීම | අඩු වීම | ක්ෂය වීම | භ්‍රාසනය
diminutive=අල්පාර්ථ පදය | ක්ෂුද්‍ර | කුඩා | කුරු | සුළු
dimmer=ඩිමරය
dimming=අඳුරු වීම
dimorphic=ද්විරූපී
dimorphism=ද්විරූපතාව
dimorphous=ද්විරූපී
dimple=කම්මුල නිකට ආදි ස්ථානයන්හි වළ ගැසෙනවා | කම්මුල නිකට ආදි ස්ථානයන්හි වළගැහීම
dimply=කම්මුලේ වළ ගැසෙන
din=ගෝට්ටි කරනවා | ගෝට්ටිය | මහත් ඝෝෂාව
dinar=දිනාරය | මැද පෙරදිග මුදල්
dinaric=ඩිනාරික
dine=කෑම කනවා
diner=කෑම ගන්නා | දුම්රියේ කෑම කාමරය
ding-dong=ඝණ්ටා නාදය
dingey=කුඩා විවෘත ඔරුව
dinghy=කුඩා විවෘත ඹරුව
dingle=කඳුර
dingo=ඔස්ට්‍රේලියාවේ වල් බල්ලා
dingy=අඳුරු | ඔප නැති | කිලුටුපාට ඇති
dining-room=කෑම ශාලාව
dinky=කුඩා | චූටි
dinner=කෑම | දවසෙහි ප්‍රධාන භෝජනය | භෝජන සංග්‍රහය
dinosaur=අදි යෝධ උරග විශේෂයක්
dint=පහර | වෑයම
dinter=යට කපන්නා
diocese=දියෝකීසිය
diode=ඩයෝඩය | දියෝඩ
diodon=ඩයොඩොන්
diodoquin=ඩයොඩොක්වින්
dioeciopolygamous=බහුලිංගද්විගෘහී
dioecious=ද්විගෘහී
dioecism=ද්විගෘහීකතාව
dioicous=ද්විගෘහී
dionysian=ඩයොනීසියානු
diopside=ඩයොප්සයිඩ්
diopter=ඩයොප්ටරය
dioptre=ඩයෝප්ටරය | සන්ධාන වත්‍ර දර්ශකය
dioptric=ආලෝක වර්තන
dioptrics=ආලෝක විවර්තනය | ආලෝකවර්තන විද්‍යාව
diorama=ඩයොරාමා | ඩයොරාමා ක්‍රමය | සන්ධාන වත්‍ර දර්ශකය
diorism=ප්‍රභේදනය
diorite=ඩයෝරයිටය
diotic=ද්විශ්‍රෝත්‍රික
dioxide=ඩයොක්සයිඩ්
dip=අභිනතිය | අවපාතය | කුඩා පන්දම | ගල්වා තබනවා | ගිල්වීම | ගිලුම | ගිලෙනවා | ගිළුම | පහතට ඇල කරනවා | බස්සනවා | බෑවුම
dip-circle=අවපාත චක්‍රය
dip-needle=අවපාත කටුව
dipeptide=ඩයිපෙප්ටයිඩ්
dipetalous=ද්විදල
diphenan=ඩයපීනන්
diphoretic=ස්වේදජනක | ස්වේදනය
diphtheria=ගලපටල රෝගය
diphthong=සංයුක්ත ස්වරය
diplacusis=ද්විත්ව ශ්‍රවණය
diplanetic=ද්වියාත්‍රික
diplanetism=ද්වියාත්‍රිකතාව
diplo=ද්වි | ද්වික
diplobacterium=ද්විකබැක්ටීරියාව
diplobiontic=ද්විකවක
diplochlamydeous=ද්විපරිපුෂ්පී
diplococcus=ඩිප්ලොකොකුසයා | ද්විකකොකුසයා
diplocyte=ද්විගුණ සෛලය
diploe=ද්වෛධය
diplogen=ඩියුටීරියම්
diploid=ද්විගුණ | ද්විගුණකය
diploma=අධිකාර පත්‍රය | ඩිප්ලොමාව
diplomacy=උපයඥානය | උපාය | උපාය කෞශල්‍යය | උපායෙහි දක්ෂකම | රාජ්‍යෙපාය | රාජෝපාය | සාමය
diplomat=රාජදූතයා | රාජ්‍යතාන්ත්‍රිකයා | රාජ්‍යදූතයා
diplomatic=උපාය කෞශල්‍ය | උපායදක්ෂ | උපායශීලී | උපායෙහි දක්ෂ | ජාත්‍යන්තර කටයුතු සම්බන්ධී | තන්වැසි | තානාපති | රාජ්‍යතාන්ත්‍රික | රාජ්‍යදූත
diplomatist=රාජදූතයා
diplont=ද්විකගුණකය
diplophase=ද්විකගුණකය | ද්විසංයෝග කලාව
diplopia=ද්විත්ව දෘෂ්ටිය
diplostemonous=ද්විකරේණුක
diplostemony=ද්විකරේණුකතාව
diplostichous=ද්විපංක්තික
diplotene=චතුෂ්පට | ඩිප්ලොටීන
diploxylic=ද්විකශෛලමීය
diploxylous=ද්විකශෛලමීය
dipole=අවිධ්‍රැව | ද්විධ්‍රැවකය | ද්විධ්‍රැවය | දෙදුව
dipper=ඇඳිරිකරය | ලොකු බොකුටු හැන්ද
dipping=ගිල්වීම
dipsomania=මදිරෝත්මාදය | මදිරෝන්මාදය
dipsomaniac=මදිරෝත්මාදී පුද්ගලයා
diptheria=ඩිප්තීරියාව
dipthong=සංයුක්ත ස්වරය
diptych=ද්විපත්‍රකය
dirac=ඩිරැක්
dire=ඝෝර | දරුණු | භයානක
direct=අණ කරනවා | අණ දෙනවා | අධ්‍යක්ෂණය කරනවා | අනුලෝම | ඇද නැති | උද්දේශනය කරනවා | එකෙලි | එල්ල කරනවා | ක්‍රමය පෙන්වනවා | කියා දෙනවා | කෙලින් පැවති | කෙලින් පිහිටි | කෙළින්ම | නියම කරනවා | නිර්දේශ කරනවා | නොවක් | නොවරදින | පැහැදිලි | මග පෙන්වනවා | මෙහෙයවනවා | යොමනවා | යොමු කරනවා | සන් කරනවා | සන්දෙනවා | සරල | සෘජු | හරවනවා | හසුරවනවා | හසුරුවනවා
directaction=තර්ජනාත්මක ක්‍රියාපටිපාටිය
directed=දිෂ්ට
direction=අත | අධ්‍යක්ෂණය | අහ | ඉසව්ව | උපදේශය | දශාව | දසාව | දිග | දිගන | දිග්භාගය | දිශාව | දිසාව | දෙස | නියමය | නියෝගය | නිර්දේශනය | නිර්දේශය | පංකාඩම | පාලනය | මෙහෙයුම | රංග විධානය | විධානය | සංවිධානය | සරිය
directional=දිශා
directionality=දිශ්‍යතාව
directive=උද්දිෂට | දිශාමය | නියමය | නියෝගය | මග පෙන්වන | මග පෙන්වීම | විධානය | විධිනියම කරන
directly=අප්‍රමාදව | ඉඳුරා | එක එක | එක එල්ලේ | එකෙල්ලේ | කඩිනමින්ම | කෙළින්
directness=අවංකබව | සෘජුභාවය
director=අධ්‍යක්ෂ | අධිකාරී | නියාමය | ප්‍රයෝජක | පාලකයා | මෙහෙයවන්නා | මෙහෙයුවා
director-general=අධ්‍යක්ෂ ජනරාල්
directors=අධ්‍යක්ෂවරු
directory=ඩිරෙක්ටරිය | නාමාවලිය | නිර්දේශක | මෙහෙයු
directress=අධ්‍යක්ෂවරිය
directrix=නියාමක අක්ෂය | නියාමකය
dirge=ශෝක ගීතිකාව | ළතෝනිය
dirham=දිර්හම්
dirhinic=ද්විඝ්‍රාවික
dirigible=පදවාගෙන යන අහස් නැව | පැදවිය හැකි
dirk=කිණිස්ස | කිරිච්වය
dirl=දාරිකාව
dirnk=උගුර තෙමනවා
dirt=අපවිත්‍ර දේ | කලුෂය | කසළ | ක්ධල්ලිකා | කිලි | කුණ | කුණු | කුණුකසල | ජරාව | මල
dirtily=අපිරිසිදු ලෙස | නීච ලෙස
dirtiness=අපිරිසිදුකම | කැතකම | කිලුටුකම
dirty=අපවිත්‍ර | අපිරිසිදු | ක්ලිෂ්ට | කැත | කිලිටි | කිලුටු | කුණු | ගොහොදු | නීච | මිලින | හඩු | හපුටු | හැඩි
dis=අප
dis-economies=නොපිරිමැසුම්
dis-saving=අපශේෂණය
disability=අපොහොසත්කම | අබලතාව | ආබාධිකත්වය | ආබාධිතාව | නුපුළුවන්කම | නුසුදුසුකම | නොහැකියාව | බාධාව | විබල්‍යතාව
disable=අබල කරනවා | ආබාධිතයා | නොහැකියාව | බලය නැති කරනවා | බාධාව | ශක්තිය නැති කරනවා
disabled=අබලන් වූ | ආබාධිත | බලය නැති | ශක්තිය නැති
disablement=බලය නැති කිරීම | බලය නැති වීම
disabling=අබලකාරක
disabuse=වැරදි හැඟීම හරිගස්සනවා
disaccharide=ඩයිසැකරයිඩ්
disadvantage=අනර්ථය | අවාසිය | පාඩුව
disadvantageous=අනිෂ්ට | අවාසි | අවාසිදායක
disaesthesia=දුර්වින්දනය
disaffected=මහත් සේ කලකිරුනු
disaffection=බලවත් කලකිරීම | විරංජය | විරැඳුම
disaffirm=අවශපථනය කරනවා
disafforest=කැලෑ නැති කිරීම
disagree=අසම්මතික වෙනවා | එකඟ නො වෙනවා | එකඟ නොවෙනවා | විරුද්ධ වෙනවා | වෙනස් සේ සිතනවා
disagreeable=අප්‍රසන්න | අප්‍රිය | අමනෝඥ | අසාත
disagreeble=අප්‍රිය | කලහකාරී
disagreement=අසම්මතිය | එකඟ නොවීම
disallow=නොඉඩ දෙනවා | නොඉඩදෙනවා | ප්‍රතික්ෂේප කරනවා | ප්‍රතික්ෂේප කිරීම
disapearence=අතුරුදහන්වීම | අදෘශ්‍යමාන වීම
disappear=අතුරුදන් | අතුරුදහන්වෙනවා | අන්තර්ධාන වෙනවා | එර්දි වෙනවා | නැතිවෙනවා | නොපෙනී යනවා | රහත්වෙනවා | වඳ වෙනවා | වැළහෙනවා | වියැකෙනවා | සෘද්ධි වෙනවා
disappearance=අන්තර්ධාන වීම | නොපෙනී යාම | වැළහීම
disappeared=විගත | විලුප්ත
disappoint=කලකිරවනවා
disappointed=කලකිරුණු | දොම්නසට පත් | බලාපොරොත්තු කඩ වුණු
disappointment=කලකිරීම | කාංශාව | කාංසාව | දොම්නස
disapproval=අනනුමතිය | අප්‍රසාදය | අමනාපය | විරෝධය
disapprove=අප්‍රසාදයට පැමිණෙනවා | විරුද්ධ වෙනවා
disarm=නිරායුධ කරනවා
disarmament=අවිහරණය | නිරායුධ කරණය | නිරායුධකරණය
disarrange=අවුල් කරනවා
disarrangement=අවුල් කිරීම
disarray=අවුල් ස්වභාවය | පිළිවෙළක් නැති බව
disarticulate=විසන්ධාන කරනවා | විසන්ධාන වෙනවා
disarticulation=විසන්ධානය
disassimilation=අපවෘත්තිය
disaster=අයයෝගය | ආපදාව | බ්‍යසනය | මහත් විපත | ව්‍යසනය | ව්‍යාසනය | විපත | විපත්තිය | වියසනය
disastrous=අතිශයින් අවාසනාවන්ත | දුර්භාග්‍ය | විනාශදායක
disavow=ප්‍රතික්ෂේප කරනවා
disavowal=ප්‍රතික්ෂේප කිරීම
disband=විසුරුවා හරිනවා | විසුරුවා හැරීම
disbar=උන්නීතිඥනය කරනවා | නීතිඥ බවින් පහ කරනවා | නීතීඥ වෘත්තියෙන් පහ කරනවා
disbelief=අවිශ්වාසය
disbelieve=අවිශ්වාස කරනවා | නො අදහනවා
disbeliever=අවිශ්වාස කරන්නා
disburse=මුදල් ගෙවනවා | වැය කරනවා | වියදම් කරනවා | විසදනවා
disbursement=විය පැහැදම් ගෙවීම | වියපැහැදම | විසදීම | විසඳීම | විසැඳුම
disbursements=විසැඳුම්
disc=කවය | තැටිය | බිම්බය | මජල | මණ්ඩලය | ලොවාදුව | වටය
discard=අස් කරනවා | අහක දමනවා | ඈත් කරනවා | ඉවත ලනවා | දුරලනවා | බැහැර කරනවා
discern=තේරුම් ගන්නවා | පැහැදිලි සේ දකිනවා | වටහා ගන්නවා
discernible=තේරුම් ගතහැකි | විඤේය | වේච්ඡ්‍ය
discerning=ඥානවන්ත | දැනුම් තේරුම් ඇති | විපරම් සහිත
discernment=අවබෝධය | වටහා ගැනීමේ ශක්තිය | සියුම් නුවණ
discharge=අස් කරනවා | අස් කිරීම | අස් කිරීමේ ලියවිල්ල | ආක්ෂේපණය කරනවා | ඉටු කිරීම | ඉෂ්ට කිරීම | උත්තරණය කරනවා | ගෙවා නිම කරනවා | ටිකට් කපනවා | ණය ගෙවනවා | ණය ගෙවීම | නිදහස් කරනවා | නිදහස් කිරීම | නිදහස් කිරීමේ ලියවිල්ල | පත්තු කිරීම | පිට කරනවා | බඩු බානවා | බඩු බෑම | මුදවනවා | මුදා හරිනවා | මුදා හැරීම | යුතුකම් ඉෂ්ට කරනවා | විසර්ගය | විසර්ජන | විසර්ජනය | විසර්ජනයකරනවා | හිස් කරනවා
discharger=විසර්ජකය
disciform=මණ්ඩලාකාර
disciple=ගෝලයා | ශ්‍රාවකයා | ශිෂ්‍යයා
disciplened=සංයත
discipleship=ගෝලකම
disciplinarian=විනයධරයා | සැලකිලිවන්තයා | හික්මවීමෙහි දක්ෂයා
disciplinary=විනය පිලිබඳ වූ | හික්මවීම ඇති කරන | හික්මවීම පිළිබඳ වූ
discipline=ආත්මදමනය | නීතිය | පුහුණු කරනවා | පුහුණුව | විනය | ශික්ෂණය | ශික්ෂා | ශික්ෂාව | සංයමය | හික්මවනවා | හික්මීම | හික්මෙනවා
disciplined=විනීත | ශික්ෂිත | සංයමය
disclaim=අයිතිවාසිකම් අත්හැර දමනවා | ප්‍රතික්ෂේප කරනවා | බලය | වගකීම | වියාචනය කරනවා | සම්බන්ධය අත්හැර දමනවා
disclaimer=අයිතියක් අත් හැරීමේ ප්‍රකාශය | වියාචනය
disclimax=බාධා ශිඛරය
disclose=අනාවරණය කරනවා | එළිකරනවා | එළිදරවු කරනවා | ප්‍රකට කරනවා | හෙළි කරනවා | හෙළිකරනවා
disclosure=අනාවරණය කිරීම | රහස එළිදරවු වීම | හෙළි කිරීම | හෙළිදරව්ව
disco=ඩිස්කෝ නැටුම
discocarp=ඇපොතීසිය | කූපිකාව
discoid=මණ්ඩලාකාර
discoidal=බිම්බාකාර | මණ්ඩලාකාර | මණ්ඩලාභ
discol=ඩිස්කොල්
discolour=පාට නරක් කරනවා | පාට නරක් වෙනවා | වෙනස් කරනවා | වෙනස් වෙනවා
discolourant=විවර්ණකය
discolouration=පාට නරක්වීම
discoloured=අවර්ණ | දුර්වර්ණ | විවර්ණ
discomfit=අදහස් ව්‍යර්ථ කරනවා | අමාරුවෙහි හෙළනවා | පරදවනවා
discomfiture=චකිතය | පරාජය | වත්ත වික්ෂේපය
discomfort=අපහසුව | අඵාසුව | අස්වැසිලි නැතිබව | වේදනාව
discomposure=නොසන්සුන්බව | සිත කැළඹීම
disconcert=අවුලට පත්වීම | කලබලයට පත් කරනවා | කලබලයට පත් වීම | චකිතය
disconfirmation=තහවුරු නොකීරීම | තහවුරුහරණය
disconformity=ව්‍යාජ අනුකුලතාව
disconnect=විබඳිනවා | විබැඳුම | විසන්ධි කරනවා | වෙන් කරනවා | සම්බන්ධය නැති කරනවා
disconnected=විසන්ධි කළ
disconnection=විබැඳුම
disconsolate=අස්වැසිල්ලක් නැති | දුකින් පසු වන
discontent=අතෘප්තිය | අරතිය | අසන්තෝෂය
discontented=අසන්තුෂ්ට | කලකිරුණු | බලවත් නොසතුටුභාවයෙන් සිටින
discontentment=අසන්තෝෂය
discontinuance=අත්හිටුවීම | නතර කිරීම
discontinue=අත්හිටුවනවා | නතර කරනවා | නවත්වනවා
discontinuity=අසන්තතතාව | අසන්තතිය | අසාන්තත්‍යය | කඩ ඉම | වෙන්ව තැබීම
discontinuous=අසන්තත | අසන්තතික | අසම්බද්ධ | වෙන් වූ
discord=අපස්වරය | අමිහිරි තුර්යය | අසංගතය | අසංගතිය | අසමගිය | එකමුතු නැතිකම | දුස්සංගමය | විරෝධය | විසංවාදය | විසම්මිතිය
discordance=විසමානුකුලතාව
discordant=අසංගත | අසම | එකමුතු නැති | දුස්සංගත | නොපෑහෙන | විරුජ | විසංවාදී | විසමානුකුල
discotheque=රාත්‍රී සමාජශාලාව
discount=අවමිල කරනවා | වට්ටම | වට්ටම් | වට්ටම් කරනවා
discountenance=අධෛර්ය්‍ය කරනවා | ආධාර නොදී සිටිනවා
discounting=වට්ටම් කිරීම
discounts=වට්ටම්
discourage=අධෙර්ය කරනවා | අධෛර්ය කරනවා | කලකිරවනවා | පසුබට කරනවා
discouragement=අධෙර්යය | අධෛර්ය කිරීම | පසුබට කිරීම
discourse=අනුශාසනාව | කථාව | දේශනය | දේශනා කරනවා | දේශනාව | වදාරනවා
discourteous=අගෞරව සහිත | අවිනීත | නොහික්මුණු
discourtesy=අගෞරවය | ගරුසරු නැති බව
discover=අනාවරණය කරනවා | එලිදරවු කරනවා | දක්වනවා | දකිනවා | දැනගන්නවා | සොයා ගන්නවා | සොයා ගැනීම
discovered=අසු වූ | සොයාගත්
discoverer=අනාවරණය කරන්නා | සොයාගත් තැනැත්තා
discovery=අනාවරණය | එළිදරවු වීම | සොයා ගැනීම | සොයාගත් දේ | සොයාගැනීම
discredit=අපකීර්තිය | අවනම්බුව | අවමන් කරනවා | අවිශ්වාස කරනවා | ප්‍රතිරාධනය කරනවා | හෙළා දකිනවා
discreditable=අපකීර්තිය ගෙන දෙන | නින්දිත | ප්‍රතිරාධ්‍ය | හෙළා දැකිය යුතු
discredited=නින්දිත
discreet=නුවණින් ක්‍රියාකරන | විචක්ෂණ | විචාරවත්
discrepance=විසංගතය
discrepancy=අඩුව | අසංගතිය | නොසීහුම | විප්‍රතිපත්තිය | විෂමතාව | විසංගණය | විසංගතතාව | විසදෘශභාවය | වෙනස
discrepant=එකඟ නොවන
discrete=ප්‍රභින්න | ව්‍යක්ත | විචාරශීලි | විභීන්න | වියුත | විවික්ත | වෙන්ව පවත්නා
discreteness=විඡාරශීලිත්වය | විහින්නත්වය
discretion=අභිමතය | අභිමතිය | මනාපය | විචක්ෂණ බුද්ධිය
discretionary=අභිමත | අභිමතානුසාරී
discrimen=ව්‍යාභේදය
discriminant=ප්‍රවිචාරකය | විවේචකය
discriminate=තෝරා ගන්නවා | වෙනස් ලෙස සලකනවා | වෙනස්කම් කරනවා
discriminating=තේරුම්ගත හැකි | විචක්ෂණ | වෙනස බලන | සලකන
discrimination=උවනානුවත විවේක බුද්ධිය | පරිහාරය | ප්‍රවිචාරණය | විචක්ෂණය | විචයන | විචයනය | විමංසන බුද්ධිය | විවයනය | විවසනය | විවේක බුද්ධිය | විවේචනය | වෙනස්කම් සැලකීම | සිහි විපරම
discrimination.=ප්‍රවිචාරණය
discriminative=තේරුම්ගත හැකි | විචක්ෂණ | වෙනස බලන | සලකන
discriminator=ප්‍රවිචාරකය
discursive=අනවස්ථිත | මාතෘකාවෙන් පිට ලියන | ව්‍යාඛ්‍යානාත්මක
discursiveness=විචාරත්වය
discus=කවපෙත්ත | චක්‍රායුධය
discuss=කතා වෙනවා | වාදවිවාද කරනවා | සාකච්ඡා කරනවා
discussion=මන්ත්‍රණය | සාකච්ඡාව
disdain=අවඥාව | පිළිකුල | පිළිකුල් කරනවා | ලඝු කොට සිතීම | සුළු කොට සිතනවා | හෙළාදකිනවා
disdainful=අවඥා සහිත
disease=අසනීපය | ආබාධය | ගාය | රුධා | රෝ | රෝගය | ලෙඩ | ලෙඩේ | ව්‍යාධි | ව්‍යාධිය | විය | විෂ බීජය
diseased=ගිලන් | රෝගී
diseases=රෝග
diseconomy=නොපිරිමැසුම | ව්‍යාර්ථිකය
disegno=දිසෙඤ්ඤෝ | මෝස්තර රචනය
disembarass=අමාරුවකින් මුදනවා | නිදහස් කරනවා
disembarassment=අමාරුවකින් මිදීම | නිදහස් කිරීම
disembark=ගොඩ බානවා | ගොඩබසිනවා
disembarkation=ගොඩබැසීම | ගොඩබෑම
disembodied=අශාරීරික
disembody=ශරීරයෙන් වෙන් කරනවා | හමුදාව විසුරුවා හරිනවා
disembowel=බඩවැල් ඉවත් කරනවා
disenchant=මුළාවීම්වලින් මිදෙනවා
disencumber=කරදරවලින් බැහැර වනවා
disengage=ගළවනවා | නිදහස් කරනවා | මුදනවා | මුදවාලනවා | ලිහනවා | වියොදනවා
disengaged=නිදහස් | නොබැඳුණු | වැඩක නොයෙදුණු
disentaglement=පටලැවිල්ලෙන් බේරීම
disentangle=පටලැවිල්ලෙන් බේරනවා
disentangling=විජටනය
disentitle=අහිමි කරනවා | අහිමි වෙනවා
disequilibrium=අසමතතුලිතතාව | අසමතුලනය | අසමතුලිතතාව | අසමතුලිතතාවය
disestablish=අවලංගු කරනවා | විප්‍රතිෂ්ඨාපනය කරනවා
disestablishment=අවලංගු කිරීම
disfavour=අකමැති වෙනවා | අරුවය | නොකැමැත්ත | රුව නොකරනවා
disfiguration=විරූපීකරණය
disfigure=පෙනුම නරක් කරනවා | විරූප කරනවා | විරූපණය | හැඩය නරක් කරනවා
disfigurement=අවලක්ෂණ කිරීම | විරූපවීම
disfranchise=ඡන්දබලය නැති කරනවා
disfranchisement=ඡන්ද බලය නැති කිරීම | ඡන්දබලය නැති කිරීම | වරප්‍රසාදය නැති කිරීම
disfrock=පූජකත්වයෙන් පහ කරනවා | සිවුරු ගළවනවා
disgace=අපමාන | අවනම්බුව
disgorge=ගිලගත් දේ වමාරනවා
disgrace=අගෞරවය | අත සෝදනවා | අපකීර්තිය | අයස | අවඥාව | අවනම්බුවට පත් කරනවා | අවමන් | අවමන් කරනවා | අවමානය | ඔළුවට අත හෝදනවා | ගරහ | ගර්භාව | නවනින්දාව | නිගරුව | නිගාව | නින්දාව | පරිභවය | පාච්චලය | බාරදුව | මදිකම | මූණෙ දැලි ගානවා | ලජ්ජාවට පත් කරනවා | සවුත්තුව | හෑල්ලුව
disgraceful=අයස | කැත | ගර්හිත | නින්දනීය | නින්දිත | නීච
disgruntled=අසන්තෝෂයෙන් සිටින | බලවත් අමනාපයෙන් සිටින
disguise=බොරු පෙනීම | බොරු වේශය | රැවටිලි කරනවා | ව්‍යාජය | වෙස් | වෙස් මාරු කරනවා | වෙස් වළා ගන්නවා | වෙස්මාරු කරනවා | වෙස්වලා ගන්නවා | හංගනවා
disguised=අප්‍රකට | වෙස් වළාගත් | සංලීන
disgust=අප්‍රිය | අරුවය | අරුවය ඇති කරනවා | කලකිරීම | ජුගුප්සාව | පිළිකුල | පිළිකුල ඇති කරනවා | බීභත්ස
disgusted=අරහන් | උකටලී | බලවත් සේ කලකිරුණු
disgustful=හිරිකිත
disgusting=අපුල | අශික්ෂිත | ප්‍රතිකූල | පිළිකුල් | පිළිකුල් උපදවන
dish=කබල | කෑම වර්ගය | තලිය | තැටිය | දීසිය | පරදවනවා | බඳුන
dishabille=අමුත්තන් ඉදිරියෙහි පෙනී සිටීමට නුසුදුසු අසම්පූර්ණ | විවස්ත්‍ර
disharmonius=එකමුතු නැති
disharmony=එකමුතු නැති බව | භින්නස්වරත්වය | විරෝධය | විස්වරත්වය
dishearten=හිත අධෛර්ය කරනවා
disheartened=අධෛර්යයට පත්
dished=අමාරුවේ වැටුණ
dishevelled=නොපීරූ
dishing=බොකැටීම
dishoarding=විරාශීකරනය
dishonest=කුටිල | කුහක | වංක
dishonesty=වංක භාවය | වංකභාවය | වඤ්චාව
dishonour=අගරු කරනවා | අගරුව | අගෞරව කරනවා | අගෞරවය | අපකීර්තිය | අවනම්බු කරනවා | කෙලෙසනවා | නින්දාව
dishonourable=නින්දිත | නොවැදගත්
dishonoured=අගරු කළ
dishy=මනබඳින
disillusion=මුළාවෙන් මිදෙනවා
disillusionment=බ්‍රමනිවෘත්තිය | මුළාව දුරු කිරීම
disincentive=අනුබල නොදෙන | විපෙළඹුම
disinclination=අමනාපය | නොකැමැත්ත | විනතිය
disinclined=නොකැමති | විනත
disinfecant=ව්‍යාසාදක
disinfect=විෂබීජ නසනවා
disinfectant=වසංගත රෝග බීජ නැති කිරීම සඳහා බෙහෙත් යෙදීම | ව්‍යාසාධකය | විශබීජ නාශකය | විෂ බීජ නාශකය | විෂබීජ නාශකය
disinfection=ව්‍යාසාදනය | ව්‍යාසාධනය | විෂබීජ නාශකය
disinfective=ව්‍යාසාධන
disinfector=ව්‍යාසාදකය
disinflation=උද්ධමනය මැඩලීමේ ක්‍රියාමාර්ග | නිරුද්ධමනය
disinformation=බොරු ප්‍රචාරය | හිතාමතා කරන බොරු ප්‍රචාරය
disingenuous=අවංකකමින් තොර | කපට
disinherision=අවඋරුම කිරීම | නිරාවේණිය කිරීම
disinherit=ප්‍රවේණියෙන් අස් කරනවා
disintation=ද්විධාකරණය
disintegrate=කොටස්වලට වෙන් කරනවා | කොටස්වලට වෙන්වෙනවා
disintegration=අනනූකලනය | අසමෝධානය | කැබිඳී යාම | පෘථක්කරණය | ව්‍යනුකලනය | ව්‍යානුකලනය | විශ්ලේෂය | විසමෝධානය
disintegrator=පෘථක්කාරකය
disinter=ගොඩලනවා | පොළවෙන් ගොඩගන්නවා
disinterested=අනාසක්ත | අවකුතුක | කුතුක රහිත | නොබැඳි | පක්ෂයක් නොගත් | මැලි | ස්වකීය ලාභයක් නොපතන
disinterestedness=අගති විරහිත බව | පරාර්ථයම සලකන බව
disinterment=ගොඩලෑම
disintoxicate=විෂහරණය කිරීම
disinvestment=නිරායෝජනය
disjoin=විසන්ධි කරනවා
disjoint=වියුක්ත | විසංහිත | විසන්ධි | විසන්ධිය | සන්ධි වෙන් කරනවා
disjointed=පුරුක් ගැසුණු | මනා ගැළපීමක් නැති
disjunct=වියුක්ත
disjunction=වියුංජනය | වියුජනය | විසම්බන්ධනය | විසම්බන්ධය
disjunctive=නිර්යුක්ත | විච්ඡේදක | වියුංජන | වියුඤ්ජන | වියොගී | වෙන් කරන | වෛකල්පික
disjunctor=විසම්බන්ධක
disk=ඩිස්කය | තැටිය | බිම්බය | මඬල | මණ්ඩලය
diskette=කුඩා තැටිය | ඩිස්කටය
dislevelment=මට්ටමේ නොපිහිටීම
dislike=අකමැති වෙනවා | අප්‍රසාදය | අප්‍රිය | අප්‍රිය කරනවා | අමනාපය | අරතිය | අරුචිය | ජුගුප්සාව | නොකැමැත්ත
dislocate=අවුල් කරනවා | සන්ධි පන්නනවා
dislocation=අවසන්ධිය | අවහන්දිය | අවුල් කිරීම | අවුල්වීම | ඇටයක් පැනීම | විපථනය | විස්ථානය | විස්ථාපනය | හුවංපරස
dislodge=ආරක්ෂා ස්ථානයෙන් පළවා හරිනවා | පදිංව තැනින් ඉවත් කරනවා | පළවා හරිනවා | පිහිටි තැනින් ඉවත් කරනවා
dislodgement=ඉවත් කිරීම | පිහිටි තැනින් ඉවත් කිරීම
disloyal=අපක්ෂාත | රාජද්‍රෝහී
disloyalty=ද්‍රෝහීකම
dismal=අඳුරු | දුක්මුසු දැකුම් ඇති | සතුටු නූපදවන
dismantle=කොටස් ගලවනවා | ගළවනවා
dismay=ත්‍රාසය | භය | භය ගන්වනවා | සිත් චංචල කරනවා | සිතේ කැළඹීම
dismembered=භින්න | විසන්ධි
dismemberment=කොටස් වෙන් කිරීම
dismiss=අස් කරනවා | ඉවත ලනවා | නිෂ්ප්‍රභ කරනවා | පහ කරනවා
dismissal=අස් කළ | අස්කිරීම | ඉවත ලූ | නිෂ්ප්‍රභ කිරීම | පහ කළ | පහකිරීම
dismissed=අළ
dismissible=ප්‍රභේය
dismutation=ද්වියාකරණය
disnormality=විප්‍රමතිය
disobedience=අකීකරුකම
disobedient=අකීකරු | අණක් ගුණක් නැති
disobey=අකීකරු වෙනවා | අණ කඩ කරනවා
disoblige=කෙනෙකුගේ කැමැත්ත නොසලකා හරිනවා | කෙනෙකුගේ පහසුකම් නොසලකා හරිනවා
disobliging=පහසුකම් නොසලකා
disolve=විසුරුවනවා
disoperculate=නිෂ්පිධාන
disorder=අක්‍රමය | අපිළිවෙළ | අවුල | ආබාධය | කලබලය | කැළඹිම | පිළිවෙළක් නැති බව | පෙරළිය
disorderliness=අවුල් සහිත බව | නොහික්මුණු බව | පෙරළිකාර බව
disorderly=අවුල් සහිත | නොහික්මුණු | පෙරළිකාර
disorganisation=අසංවිධානය | විසංවිධානය
disorganization=අවුල් වියවුල් කිරීම | විසංවිධානය
disorganize=අවුල් වියවුල් කරනවා
disorganized=අසංවිහිත
disorientate=අන්දමන්ද කරනවා
disorientation=දිශානතිහරණය | මංමුළාව
disown=සම්බන්ධ නැතැයි කියනවා
disoxidation=ඔක්සිජන්හරණය
dispair=කාංශාව | කාංසාව
dispansation=දේවනියමය | ශාසනය
disparage=අවඥා කරනවා | කුඩාකම් පානවා | නිගා කරනවා | හෙළා දකිනවා
disparagement=හෙළා දැකීම
disparaging=නිගාදෙන
disparate=කිසි සමානකමක් නැති | විසද්‍රෘශ | විසදෘශ | විසම
disparation=විසදෘශකරණය
disparition=තිරෝභාවය
disparity=අන්තරය | අසමානකම | විසදෘශසතාව | විසමතාව | වෙනස | වෛෂම්‍යය
dispassionate=අක්‍රෝධ | අගති විරහිත | අපක්ෂපාතී | නිකෙලෙස් | නිරාමිෂ | නිහ්ක්ලේශ | විරාගී | ශාන්ත
dispatch=කඩිසරකම | පිටත් කරනවා | පිටත් කොට යවනවා | පිටත් කොට යැවීම | මරාදමනවා | යමක් ඉක්මනින් කරනවා | සන්දේශය
dispatch-rider=ඉක්මනින් පණිවුඩ ගෙනයන්නා
dispauper=නිදැනි කරනවා
dispay=කලඑළිය
dispel=පලවා හරිනවා | පහ කරනවා
dispensable=අනවශ්‍ය
dispensary=ඩිස්පැන්සරිය | බෙහෙත් ශාලාව | බෙහෙත් සාප්පුව | බේත්ශාලාව
dispensation=ශාසනය
dispensatory=ඖෂධ නිඝන්ඩුව
dispense=අත්හැරැ දමනවා | නිමුදනවා | නියම කරනවා
dispenser=බෙහෙත් පිළියෙල කරන්නා
dispensing=ඖෂධ මිශ්‍ර කිරීම
disperation=අපකිරණය | විකිරණය | විසිරීම
dispergator=පෙප්ටයිස්කාරකය
dispermous=ද්විබීජක
dispersal=අපකිරණය | ව්‍යාප්තිය | විකිරණය | විසිරීම
disperse=අපකිරණ | අපකිරණ කිරීම | විසිර යනවා | විසිරී යනවා | විසිරෙනවා | විසුරුවනවා | විසුරුවා හරිනවා
dispersed=අපකිරණ | තැන් තැන්වල පිහිටි
dispersimeter=අපකිරණමානය
dispersion=අපකිරණය | විසරණය | විසිරීම
dispersivity=අපකිරණතාව
dispersoid=අපකිරණාභය
dispirited=අධෛර්යයට පත් | මලානික වූ
displace=අවුල් කරනවා | ඉවත් කරනවා | තනතුරෙන් වෙනස් කරනවා | විස්ථාපනය | විස්ථාපනය කරනවා
displacement=අවතැන්වීම | ජලෝත්පීඩනය | තනතුරු මාරු කිරීම | විස්ථාපන | විස්ථාපනය | විස්ථාපනය | ස්ථාන මාරු කිරීම
displacements=විස්ථාපනය
displacer=විස්ථාපය
display=ප්‍රදර්ශනය | ප්‍රදර්ශනය පිණිස තබනවා | පානවා | රඟපානවා | විදහා පෙන්වනවා | විදහා පෙන්වීම | විලාසිතය | සංදර්ශකය | සංදර්ශනය | සන්දර්ශනය
displayed=සමාරෝපිත
displaying=ප්‍රචාරක
displease=අමනාප කරනවා | අසතුටු කරනවා | මූණ ඇඹුල් කරනවා
displeased=අප්‍රසන්න | අසතුටු
displeasure=අප්‍රසාදය | අමනාපය | අසතුට | කලකිරීම | නොමනාපය | මැසිවිල්ල | රැහැණි
disport=ක්‍රීඩාවෙහි යෙදෙනවා | කෙළිසෙල්ලම
disposable=බැහැර දිය හැකි
disposal=අලෙවිය | නියම කිරීම | පිට කිරිම | පිළියෙල කිරීම | බැහැ කිරීම | බැහැර දීම | ව්‍යපහරණය | හමාර කිරීම
dispose=පිළියෙල කොට තබනවා | විධානකරනවා
disposition=චරිත ස්වභාවය | නියාව | පවරාදීම | ප්‍රණතිය | සංවිධානය | සංවිහිතිය | ස්වභාවය | සිතේ පවත්නා හැඟීම | සූදානම
dispossess= | අහිමි කරනවා | පැහැර ගන්නවා | බුත්තිය තොර කරනවා | බුත්තිය පැහැර ගන්නවා
dispossession=අහිමි කිරීම | පැහැර ගැනීම | බුත්තිය තොර කිරීම | බුත්තිය පැහැර ගැන්ම
disproof=විසාධනය
disproportionate=ප්‍රමාණානුකූල නොවන | විසමනුපාතික | විසමානුපාතික | සුදුසුවාට වඩා ලොකු
disproportionation=ද්විධාකරණය
disprove=විඛණ්ඩනය කරනවා | විසාධනය කරනවා
disputable=අවිනිශ්වත | තර්ක කළ හැකි
disputant=ආරවුල්කරු | විවාදකරු | හබකරු
disputatio=විවාදය
disputation=වාදවිධිය | විතර්කණය | විවාදය
disputatious=වාදප්‍රිය
dispute=අරගලය | අරෝ කරනවා | අරෝව කරනවා | ආරවුල | ආරාවුල | ආරාවුල් කරනවා | කලහය | තරඟ කරනවා | තර්ක කරනවා | මතභේදය | වාද කරනවා | වාදය | වියවුල | විරුද්ධ වෙනවා | විවාද කරනවා | සටන් කරනවා | හබ කරනවා | හබය
disputed=විතර්ක කළ | විවාද දළ
disqualification=අයෝග්‍යතාව | නුසුදුසුකම | බාධාව
disqualify=නුසුදුසු කරනවා | නුසුදුසු බවට පමුණුවනවා | නුසුදුසු වෙනවා
disquiet=නොඉවසිලිවන්තබව
disquietude=නොසන්සුන් බව ඇති කරනවා | නොසන්සුන්කම
disquisition=නිබන්ධය | සවිස්තර විවේචනය
disregard=අනාදරය | උපේක්ෂාව | කඩ කරනවා | ගණනකට නොගන්නවා | නොසලකා ඉන්නවා | නොසැලකිල්ල
disrepair=කැබිඳී යාම | ජරාවාස වීම
disreputable=අවකල් ක්‍රියාවෙන් යුත් | ගර්හිත | තුච්ඡ
disrepute=අපකීර්තිය | අපප්‍රකීර්තිය | අවනම්බුව
disrespect=අගෞරවය | අනාදරය | අයස | අවඥාව
disrespectful=අගරු | අනාදර | අවිනීත | උඩඟු | උතුමන් නොසලකන
disrobe=ඇඳුම් ඉවත් කරනවා | සිවුරු හරිනවා | හරවනවා
disrobed=සිවුරළු | හීරළු
disrupt=කඩාකප්පල් කරනවා | කඩාබිඳ දමනවා | භේද ඇති කරනවා
disruption=කඩා කප්පල් කිරීම | ප්‍රවිදාරණය | භේදනය
disruptive=කඩා කප්පල්කාරී
dissatisfaction=අමනාපය | අසතුටු බව
dissatisfied=අතෘප්ත | අතෘප්තිමත් | අමනාප වූ | අසතුටු වූ | උකටලී
dissatisfy=මනාපය ඇති කරනවා
disscoiation=අසංගමය | විඝමනය
dissected=බුන් | විච්ඡේදනය කළ
dissection=විකණ්ඩනය | විච්ඡේදනය
dissemble=කපටිකම් කරනවා | නියම හැඟීම් සඟවනවා | රැවටිලි කරනවා | ව්‍යාජ සේ හැසිරෙනවා
disseminate=පතළ කර හරිනවා | වපුරනවා
dissemination=ප්‍රචාරණ | ප්‍රචාරණය | ප්‍රචාලනය | ව්‍යාප්තිය | වැපිරීම | විසිරීම
disseminule=විසුරුව
dissension=අසමගිය | එකඟ නොවීම | භේදය | මතභේදය | විමතනය
dissent=අදහසකට විපක්ෂව සිටිනවා | අපමතිය | අසංමතිය | එකඟ නොවීම | එකඟ නොවෙනවා | භින්නමතිකත්වය | යෝජනාවකට විපක්ෂව සිටිනවා | විපක්ෂ වීම | විමතික වෙනවා | විරුද්ධත්වය | විසම්මතිය
dissenter=විපක්ෂ තැනැත්තා
dissenters=විමතිකයෝ
dissentient=අනුමත නොකරන | විපක්ෂ වන | විරුද්ධ | විසම්මුතික
dissentiente=අපමතික
dissentienter=විරුද්ධවාදියා
dissepiment=අනුප්‍රස්ථීකාව
dissertation=නිබන්ධනය | නිබන්ධය | ප්‍රකරණය | ශාස්ත්‍රීය නිබන්ධය
disservice=අදව්ව | අනර්ථය | අපකාර | අපකාරය | අලාභය
dissever=දෙකට කපනවා | වෙන් කරනවා
dissidence=විරුද්ධ වීම
dissident=එකඟ නොවන | භින්නමතික | විමතික | විරුද්ධ
dissilient=පිපිරෙන
dissimilar=අප්‍රතිරූප | අසදෘශ | අසමරූපී | අසමාන
dissimilarity=අසමරූපතාව | අසමරූප්‍යතාව | අසමානකම | අසමානතාව
dissimilation=අපවෘත්තිය
dissimulate=කපටිකම් කරනවා | කුහකකම් කරනවා | ව්‍යාජ ලෙස හැසිරෙනවා
dissimulation=කුහකකම | දම්භය | රැවටිල්ල | වංචාව
dissipate=නාස්ති කරනවා | පහ කරනවා | විසුරුවා හරිනවා
dissipated=කාමුක | පහ කරන ලද
dissipation=උත්සර්ජනය | දුරාචාරය | නාස්ති කිරීම
dissociate=සම්බන්ධකම නැති කරනවා
dissociated=විඝටිත
dissociation=මැදිහත් නොවීම | ව්‍යභිචාරිභාවය | විඝටනය
dissoluble=දිය විය හැකි
dissolute=අනාචාරයෙහි හැසිරෙන | සල්ලාල
dissolution=අවලංගු කිරීම | ද්‍රවණය | දිය වීම | නැතිවී යාම | නිරුද්ධිය | මරණය | විසිරීයාම | විසුරුවා හැරීම
dissolve=අන්තර්ධාන වෙනවා | අවලංගු කරනවා | ද්‍රවණය කරනවා | ද්‍රවණය වෙනවා | ද්‍රාවණය කරනවා | දිය කරනවා | දිය වෙනවා | දියවෙනවා | විසුරුවා අවසාන කරනවා | විසුරුවා අවසාන වෙනවා | විසුරුවා හරිනවා | හරිනවා
dissolved=ද්‍රාවිත
dissolvent=ද්‍රාවකය
dissonance=අමිහිරිබව | දුස්ස්වනය | විස්වනය
dissonant=එකට නොගැළපෙන | විෂම
dissuade=කරුණු කියා වළක්වනවා | නොකිරීමට කැමති කරවාගන්නවා
dissuasion=කරුණු කියා වැළකීම
dissuasive=කරුණු කියා වළකන
dissymmetry=විසමමිතිය
distad=විදුර
distaff=තර්කටිය
distal=දුර | විදුර
distance=ඈත | ඈත් වෙනවා | දුර | දුර ප්‍රමාණය | පරතරය
distant=ඈත | එපිට | දුර | දුරස්තර | වැඩි මිත්‍රකමක් නැති
distaste=අප්‍රියකම | අරුවය
distasteful=අප්‍රිය | අරුව උපදවන
disteleology=නිෂ්ඵලතාව
distemper=කයේ සනීප නැතිකම | ඩිස්ටෙම්පර් | බිත්තිවල සායම් ගානවා | සිත කලබල කරනවා | සිතේ සනීප නැතිකම
distend=ඇදෙනවා | පිම්බෙනවා | පුම්බනවා | ව්‍යාතන | විශාල වෙනවා
distensio=පිප්පීම | පිම්බීම
distension=ව්‍යාතතිය | විශාලවීම
distich=ගැදි දෙපදය
distichous=ද්විපංක්තික
distiction=සම්භාවනය | සම්භාවනාව
distil=ආසවනය කරනවා | වෑහෙනවා
distilant=ආසව්‍යය
distill=ආසවනය කරනවා | වෑස්සෙනවා
distillate=ආසූතය
distillation=ආසවනය | පෙරීම | පෙරූ ද්‍රව්‍යය | භාගික ආසවනය | වෑස්සීම | ස්‍රාවණය
distilled=ආසූත
distillery=ඉස්කාකරය | ඉස්කාගාරය | කල්දේරම් මඩුව
distinct=උත්කර්ෂවත් | ප්‍රත්‍යක්ෂ | ප්‍රභින්න | ප්‍රභේද්‍යු | පැහැදිලි | විශේෂ්‍ය | වෙනස් | වෙන් වෙන්ව පවත්නා | ස්පෂ්ට
distinction=උසස්කම | ගෞරවය | තාන්න මාන්නය | විලක්ෂණය | විශිෂ්ටතාව | විශිෂ්ටභාවය | වෙනස
distinctive=විශිෂ්ට | විශේෂ | විශේෂණීය | සවිශේෂණ
distinctiveness=විශිෂ්ටත්වය | විශේෂභාවය
distinctness=ප්‍රභින්නතාව | විශදතාව
distingue=කුලීන චාරිත්‍ර ඇති
distinguish=ගෞරව කරනවා | දක්වනවා | දකිනවා | ප්‍රභේදනය කරනවා | පැහැදිලිව වටහා ගන්නවා | වෙසෙසනවා | සලකනවා
distinguished=අග්‍රගණ්‍ය | කීර්තිමත් | විශිෂ්ට
distinguishing=ප්‍රභේදක | වෙසෙසන | සංලක්ෂණ
distintigration=ඛණ්ඩනය
distoccptor=දූර ප්‍රතිග්‍රාහකය
distort=ඇද කරනවා | කුරූප කරනවා | කුරූපණය කරනවා | කුරූපණය වෙනවා | වකුටු කරනවා | විකෘත කරනවා | විරූප කරනවා
distorted=කුරූපිත | විකෘත | විපරීත
distortion=අපරූපණය | කුරූපණය | දඟය | වරදවා කීම | විකෘති | විකෘතිය | විරූප කිරීම
distortionless=කුරූපණ රහිත
distract=උමතු කරනවා | වල්මත් කරනවා | හිත වියවුල් කරනවා
distracted=ආකුල | උමතු | කලබල වූ | වික්ෂිප්ත
distractile=විප්‍රයුක්ත
distraction=වික්ෂිප්ත වීම | වික්ෂේපය | සිත එකඟ නොවීම
distrain=නිරෝධනය කරනවා | බඩුමුට්ටු තහනම් කරනවා
distrainor=දේපල තහනම් කරන්නා | නිරෝධකයා
distraint=ණය වෙනුවෙන් කරන ලද තහනම
distrait=අකල්පනාවෙන් යුත් | උමතු වූ
distraught=දුක් නිසා සිත කැළඹුණු
distress=අළාමුළාව | ආපදාව | කනගාටුව | කම්කටොලු | තාපනය | තාපය | තුවාලය | තෝන්තුව | තෝන්තුවාව | දුකට පත් කරනවා | දොම්නස | දෞර්මනස්‍යය | පීඩාව | පීඩාවට පත් කරනවා | ලෙල්ලම | ව්‍යසනය | විනිග්‍රහණය | විපත | විපතට පත් කරනවා | විසාද | ශෝකය
distressed=පීඩා විඳින | විපතට පත්
distressing=ඛේදජනක | සංවේගදායක
distribute=පතුරනවා | ප්‍රහේදවාචකය | බෙදා හරිනවා | විසුරුවනවා
distributed=පැතුරුණු | බෙදා හරිනලද | ව්‍යාප්ත
distributing=ව්‍යාපක
distribution=පැතිරීම | බෙදා දීම | බෙදා හැරීම | බෙදාහැරීම | බෙදී යාම | බෙදුම | ව්‍යප්තිය | ව්‍යාප්තිය | විබෙදීම | විභාජනය
distributive=ප්‍රහේදවාචක | බෙදී යන | වර්ගවලට බෙදන | ව්‍යාපී
distributivity=ව්‍යාප්තතාව
distributor=ඩිස්ට්‍රිබියුටරය | බෙදා හරින්නා | ව්‍යාපක | ව්‍යාපකයා | ව්‍යාප්ති කාරකය | ව්‍යාප්තිකාරකය | විබෙදුව
distributory=අපශාඛාව
district=දිශාව | දිස්ත්‍රික්කය | පළාත | ප්‍රදේශය | රාෂ්ට්‍ර
distrophy=දුර්භරණය
distrust=අවිශ්වාස කරනවා | අවිශ්වාසය | සැක කරනවා | සැකය
distrustful=විශ්වාස නොකරන | සැක සහිත
disturb=කරදර කරනවා | කලතනවා | කලත්තනවා | කළඹනවා | පෙළනවා | බාධනය කිරීම | බාධා කරනවා | ලෙල්ලම් කරනවා | හුටපට වෙනවා
disturbance=කරච්චලය | කරදරය | කලබලය | කැරැල්ල | කැළඹීම | කැළඹුම | කැළෑඹීම | කෝලාහලය | චරචරය | බාධනය | ලෙල්ලම | විපථනය
disturbed=කරදර සහිත | කලබල සහිත | කැළඹුණු | විපථ
disturber=කලබලකාරයා
disuade=එපා කරනවා
disunion=අසමගිය | භේදය
disunity=අසමගිය | භේදය
disuse=අනභ්‍යාසය | අභාවිතය | අභාවිතිය | අව්‍යවහාරය
disused=අභාවිත | පාළු
disutility=අනුපයෝගීතාව
disvalue=නපුර | නරක
disyllable=යුගලාක්ෂර පදය
ditch=අගල | අගල් කපනවා | අගළ | ඇළිය | කඩවර | කාණුව | ඛාතකය
ditcher=කාණු කැණිය
ditching=කාණු කැණීම
dithecal=ද්විපේටික
dithecous=ද්විපේටික
dither=වෙවුලනවා
dithionate=ඩයිතයොනේට්
dithranol=ඩිත්‍රනොල්
dithyrame=ග්‍රීක ගීතිකාවක්
ditopogamy=විෂමකීලතාව
dittany=ශාකයක්
ditto=එම | එලෙසම
ditty=ගීතය | සින්දුව
diurectic=මුත්‍රකාරකය
diuretic=අධිමූත්‍රකය | මූත්‍ර වර්ධනය | මූත්‍රවර්ධක | මූත්‍රවර්ධකය | මූත්‍රා වැඩි කරන
diurnal=දවල්කාලයෙහි වූ | දවස මුළුල්ලේ | දිනපතා | දිනපතා සිදු වන | දිවා | දිවාකාල | දෛනික
diva=සුප්‍රසිද්ධ ගායිකාව
divalent=ද්විසංයුජ
divan=තුර්කියේ මන්ත්‍රී මණ්ඩලය | ධූමපානාගාරය
divaricate=අත්‍යපගාමී
dive=කිඳනවා | කිමිදිනවා | කිමිදෙනවා
diver=කිමිදින කුරුල්ලා | කිමිදින්නා | කිමිදුම්කරු | දියබරුව
diverge=අපසරණය වෙනවා | අපසාරණය වෙනවා | එකිනෙකට ඈත්ව යනවා | ප්‍රභේද වෙනවා | පිට පනිනවා
divergence=අපසරණය | අපසාරණය | අපසාරිතාව | අපසාරීතාව | අපසෘතිය | ප්‍රතිවිරුද්ධත්වය
divergent=අපසාරි | අපසාරී | ඈත්ව යන | එකිනෙකට වෙනස් | ප්‍රතිවිරුද්ධ | වෙන්වී යන
diverging=අපසාරී
divers=අනේක | කීප | විවිධ
diverse=නන් | නානා | නානාප්‍රකාර | නෙ | ප්‍රකීර්ණක | විවිධ | වෙනස් වූ
diversification=ආකාරපරිවර්තනය | නානංගකරණය | නානාංගකරණය | නානාප්‍රකාරකරණය | නානාවිධත්වය | භේදය | විවත්‍රභාවය | විවිධත්වකරණය | විවිධාංගකරණය | විවිධාංගීකරණය | විවිධාකරණය | විශේෂය
diversiflorous=විවිධපුෂ්පී
diversify=විසිතුරු කරනවා | වෙනස් බවට පමුණුවනවා
diversifying=නානාංග කිරීම
diversion=ක්‍රීඩාව | රංජනය | ව්‍යවර්තනය | විනෝදය | විපථ කිරීම | වෙනතකට යැවීම | හැරවීම | හැරවුම | හැරැවීම
diversity=අනේකවිධිතාව | නානාත්වය | නානාප්‍රකාරත්වය | නානාවිධත්වය | භේදය | විවත්‍රභාවය | විවිධත්වය | විශේෂය
divert=අහකට හරවනවා | යොමු කරනවා | විනෝදයට පත් කරනවා | වෙනතකට හරවනවා | හරවනවා
diverter=හරවනය
divertialitis=අපවර්තනිදාහය
diverticulum=අපවර්තකය
diverting=මනෝහර | විනෝදාත්මක
divest=විවේෂ්ඨනය කරනවා
divesting=ආපසු පැවරීම
divestive=විවේෂ්ඨක
divide=කොටස් කරනවා | බෙත්ම | බෙදනවා | බෙදා දෙනවා | බෙදා වෙන් කරනවා | බෙදෙනවා | භේද කරනවා
divided=අසම්බද්ධ | බෙදන ලද | බෙදු | බෙදූ | භින්න | විච්න්න | වෙන්වූ
dividend=භාජ්‍යය | ලාභාංශය | වීයූ
dividendo=අන්තර ක්‍රමයෙන්
divider=පතල් තලාඳය | බෙදන කටුව | බෙදනය | භාජකය
dividers=බෙදන කටුව | බෙදුම් කටුව | විභාජකය
dividing=භේදය
divination=අනාගතය දැකීම | දිවස් කීම | නිමිති කීම | පේන කීම | පේනකීම
divine=අනුමානයට සිතනවා | දිව | දිව්‍ය | දිව්‍යමය | දිවැස් කියවනවා | දිවැසින් මෙන් දකිනවා | දේව | දේවගැතියා | දේවා | දේවානුභාවයෙන් කියනවා | දේවානුභාවයෙන් දැනගන්නවා | ධර්මාචාර්යයා
divine-ear=දිවකන
divine-eye=දිවඇස | දිවැස
diviner=පේන කියන්නා | පේනකාරයා
diving=ප්ලව
divinity=දෙවියා | දේවත්වය | දේවධර්ම ශාස්ත්‍රය
divisibility=භාජ්‍යතාව | විබෙදියාව | විභේද්‍යුතාව
divisible=බෙදිය හැකි | භාජ්‍ය | විබෙදි | විබෙදූ
division=අංශය | කට්ටිය | කණ්ඩායම | කාර්යාංශය | කොටස | කොට්ඨාශය | කොට්ඨාසය | ඡන්දය විමසීම | පංගුව | පේරුව | බෙත්ම | බෙදීම | බෙදුම | බේ | භාගය | භේදය | මායිම | වසම | වැයික්කිය | විභජනය | විභාජනය | වෙන් කිරීම | හමුදාංශය
divisional=කොටසකට අයත් | පළාතකට අයත්
divisionalisation=කොට්ඨාසීකරණය | ප්‍රභේදනය
divisionism=විභේදන වාදය
divisor=භාජකය
divorce=දික්කසාද කරනවා | දික්කසාදය | විප්‍රයෝගය | වෙන් කිරීම
divorcee=දික්කසාද වූ ස්ත්‍රිය
divulge=අනාවරණය කරනවා | හෙළි කරනවා
divvy=ලාභය | වාසිය
dixeny=ද්විධාරකතාව
dixie=විනෝද චාරිකාවලදී ඉවීමට ගන්නා ලොකු හට්ටිය
dixylic=ද්විකශෛලමීය
dizygotic=ද්වී අණ්ඩජ | භාත්‍රීය
dizziness=ඉස කරකැවිල්ල | කරකැවිල්ල
dizzy=ඉස කරකැවිල්ල ඇති
dm=ඩොයිෂ් මාක්
dnger=අන්තරාව
dnown=පසිඳු
do=කරනවා | පිළියෙල කරනවා | පීඩාවට පත් කරනවා | රවටනවා | සනීපයෙන් සිටිනවා | සාදනවා | සෑහෙනවා | හැසිරෙනවා
doab=දෙගංමැද | දෙගංමැදිය
dobby=ඩොබිය
doble-minded=දෙවාරන්න
dobu=ඩෝබු
doby=රෙදි සෝදන්නා
doche=සන්තතිය
docile=කීකරු | හීලෑ
docility=කීකරුකම
dock=කප්පාදු කරනවා | කූඩුව | තටය | තටාකය | නැව් තටාකය | නැව් මඩුව | නෞකාගාරය | වල් පැළෑටි වර්ගයක් | වළිගය කොටට කපනවා | විත්තිකූඩුව | හිරකූඩුව
docket=සටහනක් සාදනවා | සටහන් පත්‍රය
docking=තටාක කිරීම | තටාකගත කිරීම | තටාකාගත කිරීම
dockyard=තටාකාංගනය | නැව් කොටුව | නෞකාගාරය | නෞකාතටාකය | නෞකාශය
doctor=ආචාර්යවරයා | උසස් උපාධිධරයා | දොස්තර | මිශ්‍රණයෙන් දූෂිත කරනවා | වෙදකම් කරනවා | වෛද්‍යුවරයා
doctorate=ආගම | උසස් උපාධිය
doctrinaire=අකාර්යක්ෂම | දෘෂ්ටිගතික | දෘෂ්ටිනිවේශකය
doctrinal=ආගම පිළිබඳ වූ
doctrine=දම | දහම | ධර්මය | භාෂිතය | මතය | වාදය
docu-theater=ප්‍රලේඛ රංගකලාව | ප්‍රලේඛ රංගය
docu-theatre=වාර්තා රංගය
document=ඔප්පුව | ප්‍රලේඛය | ලිපිය | ලියකියවිලි | ලියවිල්ල | ලේඛ | ලේඛනය | ලේඛය | ලේඛ්‍යය
documentalist=ප්‍රලේඛක
documentary=ලේඛනගත | ලේඛ්‍යගත | වාර්තා | වාර්තාව
documentation=ප්‍රලේඛන විද්‍යාව | ප්‍රලේඛනය
documented=ප්‍රලේඛගත | ලියවිලි ඇතුළත් | විස්තර සහිත
dodder=ගැහෙනවා
dodecagon=ද්වාදශාස්‍රය | පැති දොළහක් ඇති රූපය
dodecahecron=ද්වාදශ තලය
dodecahedron=මුහුණත් දොළහක් ඇති ඝනය
dodge=අහක පනිනවා | කර අරිනවා | බේරෙනවා | මග අරිනවා | රැවටිල්ලෙන් මග අරිනවා
dodgem=විනෝදමේලාවල ඇති කුඩා විදුලි මොටර්රිය
dodger=ප්‍රයෝගකාරයා
dodgy=අවිශ්වාස | කෛරාටික
dodo=මුරුසියේ සිට වඳ වූ ලොකු කුරුල්ලෙක්
doe=මුව දෙන | හා දෙන
doelenstuk=පුර බළ ප්‍රතිමූර්තිය
doer=කතු | කරන්නා | කර්තෘ | කාරක
doff=ඉවත් කරනවා
dog=අජුව | කුක්කා | කුක්කුර | ණහවා | පසුපස්සේ යනවා | බල්ල | බල්ලා | බලු | සුනඛයා | හනුව | හාදයා
dogatism=ආධානග්‍රාහිත්වය
doge=වැනීසියේ ප්‍රධාන මහේස්ත්‍රාත්
dogfight=ගුවන් සටන්
dogged=ඉතා දැඩි | උත්සාහය අත් නොහරින
doggedness=මහත් පරිශ්‍රමය
doggerel=ගම කවිය | විකට කවිය
doggie=සුනඛයාගේ සුරතල් නාමය
dogma=ආධාන ග්‍රාහය | ආධානග්‍රාහය | ආධානය | ලබ්ධිය | වරන්තන දෘෂ්ටිය | වෛධිකය
dogmatic=ආධානග්‍රාහී | ආධානගාහී | උද්ධත | විරුද්ධවාදයක් නොඉවසන
dogmatism=ආධාන ග්‍රාහිත්වය
dogmatize=මතයක් ලෙස ඉදිරිපත් කරනවා
doily=කුඩා රෙදිකඩ
doing=කරණය | කිරිම | කිරීම | සිද්ධිය
doings=කටයුතු | සිදුවීම්
doit=ඉතා කුඩා කාසියක් | දොයිතුව
doldrums=කළකිරීම | ඛේදය | ඩෝල්ඩ්‍රම් තීරය
dole=ඉතා කුඩා පංගුව | ඉතා ටික ටික බෙදා දෙනවා | කනගාටුව | දුක | යැපුම | ශෝකය
doleful=ශෝක පීඩිත
dolefulness=දුහ්ඛිත | ශෝකය
dolerite=ඩොලරයිට්
dolicephalic=දිගුසිරස් | දීර්ඝශීර්ෂ
dolichocephaly=දීර්ඝ කපාලිකතාව
doline=ඩෝලයින්
doll=බෝනික්කා
dollar=ඩොලරය
dollop=හැඩයක් නැති අහර පිඬ
dolly=ඩොලිය | බෝනික්කන්ගේ සුරතල් නාමය | බෝනික්කා
dolmen=ආදිකල්පිත ගල් මේසයක් | ගල් ගේ | ගල්මැස්ස | පුරාණ ශෛලමය නිර්මාණ | සුසාන කුටිය
dolomite=ඩොලමයිට් | ඩොලමයිට් නම් ගල් වර්ගයක් | ඩොලොමයිට්
dolomitization=ඩොලොමයිට් කරණය
dolorous=දුහ්ඛිත | විලාප කියන | ශෝකී
dolour=කනස්සල්ල | දුක
dolphin=ඩොල්පින් | තිමිංගලයා | දොල්පිනාව
dolt=ගුඩ්ඩයා | මූර්ඛයා
dolus=දොලුසය | වංචාව
domain=බලප්‍රදේශය | බලමණ්ඩලය | රාජ විෂය | රාජ්‍ය | රාජ්‍යය | වසම | විශාල වතුයාය | විෂය | විෂයපථය | ස්වාමිත්වය
dome=කොත | ගෝලාර්ධය | බුම්බුලාකාරය | මාලිගය | වර්තුලාව | ශිඛර | ශිඛර ගෝලාර්ධය | ශිඛරය | හිස
dome-shaped=බුබුලාකාර
domestic=අභ්‍යන්තර | ගෘහ | ගෘහය | ගෘහශ්‍රිත | ගෘහස්ථ | ගෙදර වැඩකාරයා | ගෙදරදොරේ වූ | රාෂ්ට්‍රීය | ස්වකීය රට පිළිබඳ | ස්වකීය රාජ්‍යය පිළිබඳ | ස්වදේශීය | හීලෑ
domesticate=පරිසරයට පුරුදු කරනවා | හීලෑ කරනවා
domesticated=හීලෑ | හීලෑ වූ
domestication=හීලෑකිරීම
domesticity=ගෙදර පරිසරය | ගෙදරදොර පිළිබඳ ඇල්ම
domicile=නිත්‍ය පදිංවය | නිත්‍යවාසය | පදිංවය | වසතිය | වස්තිය
domiciled=පදිංවකාරයකු සේ ලියා තැන්පත් වූ
domiciliary=පදිංවය පිළිබඳ වූ
dominance=ආධිපත්‍යය | ප්‍රධානත්වය | ප්‍රමුඛතාව | ප්‍රාමුඛ්‍යය
dominant=අග්‍රස්ථ | අධිපති | ආධිපත්‍යක | පරවශන | ප්‍රධාන | ප්‍රබල | ප්‍රමුඛ | ප්‍රමුඛය
dominate=අභිභවනය කරනවා | බලපවත්වනවා | බලපානවා | සැමටම ඉහලින් පවතිනවා | සැමටම ඉහලින් පෙනෙනවා
domination=අධිපති බව | ආධිපත්‍යය | ප්‍රභූත්වය | ප්‍රමුඛත්වය
dominatus=ස්වරාජ්‍ය බලය
domineering=උද්ධත | රොස් පරොස්
dominion=ආධිපත්‍යය | ඩොමිනියනය | ප්‍රභුත්වය | රාජ්‍යය | විතය
dominium=ආධිපත්‍යතාව
domino=අවගුණ්ඨනය
dominoes=දාදු ක්‍රීඩා විශේෂයක්
dominus=ආධිපත්‍යකයා
domitory=නිදන ශාලාව | ශයනාගාරය
domoneer=උඩඟු ලෙස හැසිරෙනවා
don=පළඳිනවා | මුදලි | විශ්වවිද්‍යාලයේ ආචාර්ය්‍යවරයා
donate=දන් දෙනවා | පරිත්‍යාග කරනවා
donatio=දානය | පරිත්‍යාගය
donation=ත්‍යාගය | දානය | පරිත්‍යාගය | සම්ප්‍රදාන
donations=පරිත්‍යාග
donatists=ඩොනාටියානුවෝ
donative=දිවෙල
done=අවසාන වූ | කම්මුතු | කරන ලද | වංවත | සකස් කරන ලද | ස්ථිර | සිදු වූ
donee=දානලාභියා | දානලාහියා | දීමනාව ලබන්නා | ප්‍රතිග්‍රාහකයා
doner=දානදායකයා
donga=ඩොංගාව
donjon=රජමැදුරක විශාල කුලුණ
donkey=කළුදෑවා | පිලා එන්ම | බූරුවා | මෝඩයා
donkey-boiler=පිලා බොයිලේරුව
donkey-engine=පිලා එන්ම
donkey-pump=පිලා පොම්පය
donna=ළමාතැනී
donnish=ගුරුවරයකුගේ වැනි | නියත
donor=දානදායකයා | දානපතියා | දායකය | දායකයා | දීමනාකාරයා | ප්‍රදායකයා
doodle=කුරුටුගානවා | වගකට නැති තැනැත්තා
doom=ඉරණම | කරුමය | තීන්දුව | දණ්ඩනයට තීන්දු කරනවා | දෛවය | මරණය | වරදට පත් කරනවා | විනාශය
doomed=මරණයට නියම වූ | විපතට නියම වූ
doomsday=ලෝක විනාස දිනය
door=ඇතුල්වන මග | කපාටය | කවාටය | ද්වාරය | දොර | දොරටු | ප්‍රතිහාර | ප්‍රවේශනය | ප්‍රවේශය
door-frame=උළුවස්ස
door-keeper=දොරටුපාල
door-mat=පාපිස්ස | බිස්ස | බිසිකඩ
door-sill=උම්මාරය | දොර පඩිය
door-step=උළුවහු පඩිය
doorman=ද්වාරික
doormat=පා පිස්නාව | පාපිස්න | පාපිස්ස
doornail=කිසිත් පලක් නැති
dope=ආරංව | මත්ද්‍රව්‍ය | මෝඩයා | රහස් තොරතුරු | රහස් බෙහෙතක් දෙනවා
doping=මාත්‍රණය
dorab=කටුවල්ලා
dordogne=දොර්ද්ඤ
dormancy=සුප්තතාව
dormant=අක්‍රිය | උදාසීන | ක්‍රියා විරහිත | නිද්‍රාණ | නිදා සිටින | නිදිගත් | සැඟවුණු | සුප්ත
dormer=පියසි කවුළුව
dormouse=මුළු ශීතසෘතුව තුළම නිදන ලොම් සහිත වල්ගයක් ඇති
dormy=ගොල්ප් ක්‍රීඩාවේදී යෙදෙන වචනයක්
doroda=මත්ස්‍යයෙක්
dorsal=පිට | පිටිපස පිහිටි | පෘෂ්ටවිෂයක | පෘෂ්ඨිය | පෘෂ්ඨීය
dorsifixed=පෘෂ්ඨලග්න
dorsifixus=පෘෂ්ඨලග්න
dorsinasty=අපිසන්නමනය
dorsiventral=පීෂ්ඨෝදර | පෘෂ්ඨෝදර
dory=රන්වන් කුඩා මත්ස්‍යයෙක්
dos=දායාදය
dosage=පරිමාත්‍රාව | බේත් ප්‍රමාණය
dose=බේත් වේල | මාත්‍රය | මාත්‍රාව | මාත්‍රාවක් දෙනවා | වඩිය | විරේචක බෙහෙත
dosimeter=මාත්‍රාමානය
dossal=අල්තාර තිරය
dossier=ලියුම් මිටිය
dot=තැන් තැන්වල යොදනවා | තිත | තිත් ගහනවා | තිලකය | පුල්ලිය | බින්දුව | ලපය
dotage=ජරා වෛකල්‍යය | ප්‍රේමාතිශය
dotal=දායාද
dotard=සිහිය මඳ මහල්ලා
dote=සිහිය දුර්වලව සිටිනවා
doting=ස්නේහයෙන් මුළා වූ
dotted=තැන් තැන්වල පිහිටි | තිත් ගසන ලද
dotting=කුඩු දැමීම
dotty=දුර්වල සිහිය ඇති | වෙවුලන ගමන් ඇති
double=ආපසු කැරකී යනවා | ඉක්මන් ගමන | ඉරට්ට | ජෝඩු වශයෙන් | ජෝඩුව | ද්වන්ද්ව | ද්වි | ද්වික | ද්විකය | ද්විගුණ | ද්විගුණ කරනවා | ද්විගුණ වෙනවා | ද්විත්ව | ද්විත්වය | දුවනවා | දෙ | දෙකට නමනවා | දෙකට නැමෙනවා | දෙගුණය | දෙගුණයක්ව | දෙපට කපන | දෙපටක් ඇති | දෙයාකාර | දෙවර | දෙවරක්ව | පසුකොට යනවා | යුග්ම | වංක | වටේ යනවා
double-action=දෙකිරි
double-minded=දෙපිටකාට්ටු
doubledecker=තට්ටු දෙකේ වාහනය
doubler=දෙ ගුණකය | දෙගුණකය
doublet=අංගරකාව | දෙඉත්ත | යමකය | යුග්මය
doubling=ද්විගුණනය | දෙගුණය කිරීම
doubloon=ස්පාඤ්ඤයේ රත්‍රන් කාසියක්
doubly=අතිශයින් | ද්වික | දෙගුණයක්
doubt=අනුමාන කරනවා | අනුමානය | අවිශ්වාසය | කංඛා | කුකුස | කුහුල | චකිතය | දෙගිඩියාව | දෝ | දෝහෝ | භය | විතර්කය | විභ්‍රම | විමතිය | විවකිච්ඡා | විවකිච්ඡාව | ශංක | ශංසය | සංකා | සංශය | සන්දේහය | සාංකාව | සැක | සැක කරනවා | සැකය | හංකාව | හාංකාසිය
doubtful=අඩමාණ | අනුමාන | කුකුස් ඇති | සං | සැක | සැක සහිත
doubtless=නිශ්ශංක | නිසැක | නිසැකව
douche=ආසේකය | ජලසේකය | දිය විදිනවා
douching=ආසේක කිරීම | ආසේකය
dough=ඇනූ පාන් පිටි
doughnut=කැවිලි වර්ගයක්
doughty=නිර්භීත | වික්‍රමාන්විත | වීර
dour=පරුෂ | රළු පෙනුම් ඇති
douse=පානක් නිවනවා | වතුර ඉස නාවනවා
dousing=දිවැස් යටුවම
dove=කපෝත | කොබෙයියා | පරවියා | පරෙවියා | ප්‍රේමාලාපයක් | පාරාපත
dovetail=කත්තුමල්ලිය
dow=ඔරු වර්ගයක් | ගුන්දිරාව | තුෂාර | දෝනිය | පිනි
dowager=වංසවතාගේ වැන්දඹු ස්ත්‍රිය
dowdy=අශෝභන ලෙස ඇඳ පැළඳගත් | අශෝභන ලෙස ඇඳ පැළඳගත් ස්ත්‍රී
dowel=කූඤ්ඤය | පළු ඇණය | පිරිද්දුම් ඇණය | මුර ඇණය | ලී ඇණය
dower=දායාද වශයෙන් දෙනවා | දෑවැද්ද | වැන්දඹු භාර්ය්‍යාවගේ උරුමය | සහජ ශක්තිය
dowery=දායාදය | දෑවැද්ද | සහජ ශක්තිය
down=අධස් | අධහ් | අධෝ | අව | දක්වා | දිගේ | පහළ | පහළට | පාත් | බිම හෙළනවා | බූව | මැඩපවත්වනවා | යට | යටට | යටි | ලා බුව | සම්පූර්ණයෙන් | සිහින් පිහාටු | සිහින් පුළුන්
downpour=වක්කර
downs=ඩවුන්ස් තණ බිම
downward=පහළට | යටි අත | යටි අතට | යටිකුරු | යටිකුරුව | යටියත්
downwards=අනභිවෘද්ධියට | පහළට | යටිකුරුව
downy=කෙස් සහිත | පතන | බූව සහිත | ලා බු සහිත | ලොම් සහිත | සිහින් පිහාටු සහිත
dowry=දායාදය | දෑවැද්ද | සහජ ශක්තිය
dowse=පානක් නිවනවා | වතුර ඉස නාවනවා
dowsing=දියෙක්සීම
doxa=මතය
doxology=ස්තෝත්‍ර ගීතය
doyen=ජ්‍යෙෂ්ඨයා | ශ්‍රේෂ්ඨයා
doze=අඩ නින්ද | අඩනින්ද | කිරා වැටීම | කිරා වැටෙනවා
dozen=දුසිම | දොළස
dozer=ඩෝසරය
dquarrel=දබරය
dr.=ණයකරු
drab=ඔපයක් නැති | වර්ණයක් නැති | වේශ්‍යා ස්ත්‍රී
drachm=අවුන්සයෙන් අටෙන් පංගුව | අවුන්සයෙන් අහසද්‍රීයෙන් පංගුව
drachma=ග්‍රීසියේ භාවිත වන මුදල්
draconian=ඉතා දරුණු | දුෂ්ට
draconis=ඩ්‍රැකෝනිස්
draft=අණකරය | කටු සටහන | කටු සැලැස්ම | කටුපිටපත | කෙටුම්පත | කෙටුම්පතක් සාදනවා | කෙටුම්පත් කරනවා | ග්‍රන්ථනය | ග්‍රන්ථනය කරනවා | ණයවරය | තෝරා යවනවා | මුදල් පත | ලියවිල්ල | සටහනක් සාදනවා | සැලැස්ම | හමුදාවකින් තෝරාගත් සමූහය
drafting=සංස්ථානය | සැලසුම් කිරීම | සැලසුම් රචනය
draftman=ගෘහ නිර්මාණ ශිල්පය | ප්ලෑන්කාරයා | සටහන් සකස් කරන්නා
draftsman=කෙටුම්පත් කරු | සංස්ථානක | සැලසුම් රචක | සැලසුම්කරු
drag=අදිනවා | අමාරුවෙන් ඇදගෙන යනවා | ආකර්ෂණය | ඇදීගෙන යනවා | ඇදීම | උකහනවා | උකහා ගන්නවා | දැති පෝරුව | දියේ අදින කොක්ක | දියේ අදින දැල | පහටිය | පෝරුව | බාධා කරනවා | බාධාව | රෝධය | වීර්ය්‍යයෙන් ඇදගෙන යනවා | හෙමින් යනවා
draggging=ආකර්ෂණය
dragging=ඇතිල්ලීම
draggle=බිම ඇදී කිලුටු වෙනවා
dragline=ඇදුම් පිරිකැණිය
dragoman=පරිවර්තනය කරන්නා | මකරා
dragon=මකරා
dragonfly=කූරා | දියමැස්සා | පූච්චා | සුන්දිරා
dragroon=අශ්වාරෝහක යුජ භටයා | බලාත්කාරකම් හා ක්‍රූරකම්කොට යටත් කරනවා
drain=අගල | අඩු වීම | අඩු වීමට හේතුව | අද්දවනවා | ඇළිය | ක්‍රමයෙන් හිස් කරනවා | ක්‍රමයෙන් හිස් වෙනවා | කාණුව | ටික ටික හින්දවනවා | ටික ටික හිඳෙනවා | දිය නළය | දිය බහවනවා | පරිවාහය | බැසයන්ට සලසනවා | වාස්සනවා | සොරොව්ව | හානිය
drainage=අගල | අපවහනය | කාණුව | ජලවහනය | ජලාපවහනය | වැසිකිළි කාණුව
drake=තාරාවා | තාරාවුන්ගේ පිරිමි සතා | සේරා
dram=කුඩා මත්පැන් ප්‍රමාණයක් | ඩ්‍රූම
drama=දෘශ්‍ය කාව්‍ය කලාව | දෘශ්‍ය කාව්‍යය | දෘශ්‍යකාව්‍ය | නාටකය | නාට්‍ය කලාව | නාට්‍යය | ලාස්‍ය
dramatic=චමත්කාරජනක | නාට්‍ය ස්වරූප | නාට්‍යමය | නාට්‍යයක සිදුවීමක් වැනි | නාට්‍යාකාර | නාට්‍යෝවත | විස්මය ඇති කරන
dramatical=චමත්කාරජනක | නාට්‍ය ස්වරූප | නාට්‍යයක සිදුවීමක් වැනි | නාට්‍යාකාර | විස්මය ඇති කරන
dramatisation=නාට්‍යයක් වශයෙන් සකස් කිරීම
dramatist=නාට්‍ය රචක
dramatization=නාටකීකරණය | නාට්‍යගත කිරීම | නාට්‍යයක් වශයෙන් සකස් කිරීම | නාට්‍යාරෝපණය
dramatizatoin=නාටකීකරණය | නාට්‍යගතකිරීම | නාට්‍යාරෝපණය
dramatize=නාටකාකාරයෙන් දක්වනවා
dramaturgy=නාට්‍ය කලාව | නාට්‍ය ශාස්ත්‍රය
drape=ආච්ඡාදනය | තිරය | පළඳවනවා | පළඳිනවා | රැළි කිරීම
draper=රෙදිපිළි වෙළෙන්දා
drapery=ජවනිකා ආදි ද්‍රව්‍ය | තිර | රැලිපිළි | රෙදිපිළි | වස්ත්‍ර | වස්ත්‍රාලංකාර
drastic=උග්‍ර | තදින් ක්‍රියා කරන | ප්‍රබල | සැර
drat=ශාප කරනවා
dratmatise=නාටකාකාරයෙන් දක්වනවා
draught=ඉපිළුම් ගැඹුර | කෙටුම් පත | ගණ්ඩුෂය | පෙවිය | බීම උගුර | බීම කට | මඩිය | මුදල් පත | වරකට බොන ප්‍රමාණය | වා පහර | සටහන | සැලසුම | සුළං ඇදීම | සුළං පහර | සුළං බැඳීම | හැඩ ලෑම
draughts=දාන් සෙල්ලම
draughtsman=ප්ලෑන්කාරයා | සටහන් සකස් කරන්නා | සැලසුම්කරු | සැලසුම්කරුවා | සැලැසුම්කරුවා | සැළසුම්කරු
draughty=හුළං ඇදී එන | හුළං සහිත
dravid=ද්‍රවිඩ
dravida=ද්‍රවිඩ
dravidian=ද්‍රවිඩ
draw=අදිනවා | අඳිනවා | අඳින්න | අරිනවා | ආකර්ෂණය | ආකර්ෂණය කරනවා | ඇදගන්නවා | ඇදගෙන යනවා | ඇදීම | උකහනවා | උකහා ගන්නවා | පොළඹවනවා | වාරය | සලකුණු කරනවා
draw-outs=වර්ණ දීපක
draw-tube=අදින නළය
drawback=ඇදුම් රාමුව | පිළිවර
drawbridge=සල පාලම
drawee=අණ ලද්දා | අණලද්දා
drawer=අණකරු | අදින්නා | මදින්නා | ලාච්චුව
drawers=යට කලිසම
drawing=ඇණවීම | ඇදීම | ඇඳීම | නූල් ඇදීම | පෝරණුවෙන් බෑම | පෝරනුවෙන් බෑම | වත්‍රකර්මය | වත්‍රය | සිත්තම | සීට්ටු ඇදීම
drawing-in-wire=අදින කම්බිය
drawings=ආදාන | ආපසු ගැනීම් | විනෝද ක්‍රීඩාවකින් උපයාගත් මුදල
drawl=ඇදලා කථා කරනවා | ඇදලා කථා කිරීම
drawn=අදින ලද | අඳින ලද | අවසාන විනිශ්චයකට නොපැමිණි | ආකර්ෂිත | ඇදී ගිය
dray=ඇඳි නැති බරකරත්තය | බර ඇදීමට යෙදූ ගැල
dread=උග්‍ර | ත්‍රාසය | තැතිගන්නවා | බියකරු | භය උපදවන දේ | භය වෙනවා | භීතිය | මහත් භය | රෞද්‍ර
dreaded=භය උපදවන
dreadful=ගොරතර | ඝෝර | දරුණු | බීරු | භයංකර | භයානක | භීම | විභීෂණ
dreadnought=විශාල යුද්ධනෞකා වර්ගයක්
dream=ස්වප්න | ස්වප්නය | සිහිනය | සීනය | හිස් සිතිවිල්ලෙහි යෙදෙනවා | හීන | හීන දකිනවා | හීන බලනවා | හීනය
dreamer=කාර්ය්‍යක්ෂම නොවූ තැනැත්තා
dreams=ස්වප්ත | ස්වප්නය | සිහින | සිහිනය
dreamy=අඩනින්දෙන් යුත් | උනන්දුවක් නැති | මන්දබුද්ධික | වත්තාපර | ස්වප්නරූපී | සිහින බඳු
drear=නීරස | ශූන්‍ය | සිතෙහි රුව නූපදවන
dreary=නීරස | ශූන්‍ය | සිතෙහි රුව නූපදවන
dredge=ඉසිනවා | මඩ අදින යන්ත්‍රය | මඩ කණිනවා
dredger=මඩ අදින යන්ත්‍රය | මඩකැණිය
dredging=මඩ කැණීම | මඩකැණීම
dregs=කල්කය | බොර | මණ්ඩි | වැඩකට නැති කොටස
dreikanter=වා කැට
drema=චර්මය
drench=පෙඟෙනවා | පෙනීම | වතුරෙන් පොඟවනවා | වැස්සෙන් පොඟවනවා | හුඟක් පොවනවා
drepaniform=දැයුරු
drepano-cladous=දැයුරු ශාඛී
dress=අන්දවනවා | ඇඳුම | පිළිය | පිළියෙල කරනවා | වස්ත්‍රය | වැස්ම | සකස් කරනවා | සරසනවා | ස්ත්‍රීන්ගේ ගවුම් ආදිය | හැඳිවත
dressage=අශ්වයෙකු පුරුදු කිරීම
dressed=හන්
dresser=මට්ටම් කටුව | ශල්‍ය වෛද්‍යුයාගේ අත් උදවුකාරයා
dressing=ඇන්දවීම | පටි බදාම | වේශ | සැකසීම | සැරහුම | සැරහුම් කරනවා | සැරැහීම | හැඩගැන්වීම
dressy=ජේත්තුකාර
drey=ලේන් කූඩුව
dribble=වෑස්සෙනවා
dribblet=පොඩිත්ත | පොද | බින්දුව
driblet=පොඩිත්ත | පොද | බින්දුව
dried=වියළි | වේලිච්ච | වේළන ලද
drier=ශෝෂකය
drierite=ඩ්‍රයරයිට්
driers=ශෝෂක
drift=අභිප්‍රාය | අවිනිශ්වතභාවය | අවිනිශ්වතව සිටිනවා | ඉදිවුල | උමඟ | කූඤ්ඤ කටුව | කොට්ටය | ගමන | ගසාගෙන යන දිසාව | ගසාගෙන යන වේගය | ගොඩ ගැසෙනවා | චංක්‍රමණය | චංක්‍රමය | ප්ලවනය | ප්ලාවනය | ප්ලාවිතය | පාවෙනවා | යම් දෙයකට නැම්ම | රාශිය | වතුරට ගසාගෙන යනවා | හුළඟට ගසාගෙන යනවා
drifter=මසුන් අල්ලන ඔරුව
drifting=උල්කටුව ඇල්ලීම
drill=කඩුවෙන් සිදුරු කරනවා | ඝන රෙදි වර්ගයක් | තොරපණය | නිතර පුරුදු කරනවා | නිතර පුරුදු කිරීම | පිළිවෙළට වපුරනවා | බීජ වපුරන පේළිය | බුරුමය | බුරුමයෙන් සිදුරු කරනවා | විත | විදමනය | විදින කටුව | විදිනවා | විදුම් යත | විදුම් යත | විදුම් යන්ත්‍රය | සරඹ | සරඹ පුහුණු කරනවා | හිල් විදිනවා
drill-bit=විදුම්කටුව
drilled=විදි
driller=විදින්නා
drilling=විදීම
drink=උරාගන්නවා | පානකය | පානය | පානය කරනවා | පෙවිලි | බීගන්නවා | බීම | බොනවා | මත්පැන්
drinking=ආපාන | පානීය | මධු පානය
drinks=මද්‍යපාන
drip=කටාරම | කාන්දු වීම | කාන්දු වෙනවා | බින්දු වශයෙන් වැටෙනවා | බින්දුව | වෑස්සීම | ස්‍රාවය
drip-ledge=කටාර
drip-proof=වෑස්සුම් වරන
driped=ඩ්‍රිප්ත කළ
dripping=සත්ත්ව තෙල් | ස්‍රාවය
drive=එලවනවා | එලවුම | එලැවීම | එලැවුම | එළවනවා | ගසාගෙන යනවා | ගෙනයනවා | දක්කනවා | දඩයම | ධාවකය | පදවනවා | පරිශ්‍රමය | පලවා හරිනවා | ප්‍රාජකය | ප්‍රාජනය | ප්‍රාපකය | ප්‍රේරණය | පැද යනවා | බලපානවා | බලවත් ව්‍යාපාරය | රථයෙන් යන ගමන | රිය පදවාගෙන යනවා | වේගවත් පහර
driveaway=අඹනවා
drivel=කෙළ වැගිරෙනවා | නන්දෙඩවිලි | නන්දොඩවනවා
driver=එලවනය | එලවන්නා | දක්කුව | රථාචාර්ය | රියැදුරා | සාරථි
driveway=වාහන ගමන් කිරීමට තැනූ මාර්ගය
driving=දුවවීම
drizzle=පොද ගසනවා | පොද වැටෙනවා | පොද වැස්ස | පොදවැස්ස | මල්වැස්ස | වැසිපොද | සිරිපොද | සිහින් පොද | හිරිකඩ | හිරිකඩ ගහනවා | හිරිපොද
droll=කවට | කවටයා | විකට | විහිලු | විහිලුකාරයා
drollery=විගඩම | විහිලු කතාව | හාස වත්‍රය
dromedary=මොල්ලි එකක් ඇති ඔටුවා
drone=අලසයා | ඒකස්වර සංගීතය | ගුමුගුමු නද දෙනවා | ගුමුගුමු නාදය | පිරිමි මී මැස්සා | මීමැසි හජ | හුංකාරය
drongo=කවුඩා
droop=එල්ලී වැටීම | එල්ලී වැටෙනවා | නමා වැටීම | නමා වැටෙනවා | නැමීම | පරවෙනවා | මැලවෙනවා
drop=අත්අරිනවා | එළනවා | ගිලිහී වැටෙනවා | පතනය | පහත බැසීම | පහත් කරනවා | ප්‍රපාතය | පාත බසිනවා | පාත් කරනවා | පොද | බස්සනවා | බැස්ම | බෑවුම | බින්දු | බින්දුව | බිඳ | රොණ | ලොසින්ජරය | වහිනවා | වැටීම | වැටෙනවා | වෑස්සෙනවා | සනවා | සිඟිත්ත | හලනවා | හෙළනවා | හෙළීම
drop-out=විගලිතය
drop-outs=මහ හැලුනෝ | විපතිතයෝ
drop-reaction=බින්දු පරීක්ෂාව
droplet=බින්දු පොඩිත්ත | බිඳිත්ත
dropper=බස්සනය | බිංදුකරය
droppings=වැටෙන දේ | සතුන්ගේ බෙටි
drops=බින්දු
dropsical=උදර රෝගය ඇති
dropsy=උදරරෝගය | ඔජරය
dross=නොවටිනා දේ | බිම් අඟුරු කැබලි | බොර | රොන් යොදය
drought=ඉඩෝරය | තද පෑවුම | තද පිපාසය | නියං | නියඟ | නියඟය | පෑවුම
drouth=ඉඩෝරය | නියඟය | පිපාසය
drove=රංචුව
drover=ගව වෙළෙන්දා | ගවපල්ලා
drown=ගිල්වා මරනවා | ගිලී මැරෙනවා | දියට යට කරනවා | දියට යට වෙනවා
drowning=ගිල්වා මැරීම | ගිලී මැරීම | ගිලීම
drowse=නිදිමතේ වැනෙනවා
drowsiness=කම්මැලිකම | නිදිමත
drowsy=අලස | කම්මැලි | කුම්භකර්ණ | නිදිබර | නිදිමත ඇති කරන
drub=තඩිබානවා | තළනවා | සම්පූර්ණයෙන් පරදනවා
drubbing=තඩිබෑම | පරාජය
drudge=බර වැඩ කරනවා | වාල් වැඩ කරනවා | වාලා
drudgery=අප්‍රිය වැඩ | මහත් ආයාසය | වාල්වැඩ
drug=ඉක්මනට නොවිකිණෙන බඩුව | ඔසුව | ඖෂධය | තමන් පාවිච්චි කරනවා | බෙහෙත | භෛෂජය | මත්ද්‍රව්‍යය
drugget=කම්බිලිය
druggist=ඔසු වෙළෙන්දා | බෙහෙත් වෙළෙන්දා | භෛෂජවාණිය
drugs=ඖෂධ | බෙහෙත්
druid=පුරාතන බ්‍රිතාන්‍යයන්ගේ පූජකයා
druids=ඩෘවිඩයෝ
drum=ඩංඩුං | පටහය | බෙර | බෙර ගසනවා | බෙරය | භේරී | සිංගාරම
drum-eye=සුරත්තට්ටුව
drumlin=ඩ්‍රම්ලිනය
drummer=බෙර වයන්නා | බෙර වාදකයා | බෙරකාරයා | සිංගාරම්කාරයා | හේරි වාදකයා
drumming=බෙර වාදනය | හේරි වාදනය | හේවිසි
drums=බෙර
drumstick=කඩිප්පුව | මුරුංගා
drumsticks=මුරුංගා
drunk=බේබද්දා | බොන ලද | මත් වූ | වෙරි වූ
drunkard=අකාරයා | බේබද්දා | බේබදු | රා සොඬා | වෙරිකාරයා
drunken=බේබදු
drunkeness=බීමත්කම
drunkenly=වෙරිමරගාතෙ
drunkenness=බීමත්කම | බේබදුකම | වෙරි
drupaceous=අෂ්ටිල
drupe=අෂ්ටි ඵලය | අෂ්ටිඵලය | අෂ්ටිලය
drupel=අෂ්ටිලිකාව
drupelet=අෂ්ටිලිකාව
druse=පොකුරු කැටය
dry=අලංකාරයක් නැති | ඇනුම්පද සහිත | කාෂ්ට | කිරිවැරූ | දිය සීරාව නැති | නිද්‍රාව | නිසරු | නීරස | පිසාසිත | වියළනවා | වියළි | වියැළි | වේළනවා | වේළෙනවා | ශුෂ්ක | හිඳුණු
dry-land=ගොඩබිම
dryad=රුක්දෙව්ලිය | වෘක්ෂ දේවතාවා
dryads=සෙවන ගස්
drydock=වතුර රහිත නෞකාගාරය
dryers=ශෝෂක
drying=වියලීම | වියළීම | වියළෙන | වේලීම | ශෝෂණ | ශෝෂණය
dryness=වියලිබව | වියළි බව | ශුෂ්කත්වය
dryopithecus=ද්‍රියොපිතෙකුස් | රුක්දෙවි වානරයා
dryrot=ලී කුඩු නැගීම
drystone=බදාම නොයොදා තනන ලද
dsweath=ඩහදිය
dual=ඉරට්ට | ද්වන්ද්ව | ද්වන්ද්ව යුද්ධය | ද්විතය | ද්විත්ව | ද්විවචනය | ද්විවිධ | දෙකක් පිළිබඳ වූ | යමක | යමකය | යමා | යුග්ම | යෞග | සහළ
dualism=ද්වෛතවාදය
dualistic=ද්වෛත
duality=ද්විත්වය | ද්විප්‍රකාරත්වය | ද්වෛතය | ද්වෛත්‍ය
dub=පටබඳිනවා | හජ කවනවා
dubash=තුප්පයියා | තෝල්කයා
dubbin=හම්වල උලන තෙල්
dubbing=කැවීම | හම්වල උලන තෙල්
dubhash=තුප්පයියා | තෝල්කයා
dubiety=අනුමානය | සැකය
dubious=අනුමාන | අස්ථිර | සැක සහිත
dubiousness=අස්ථීරබව | සැක සහිත බව
duboisine=ඩුබොයිසින්
ducal=ආදිපාද පදවිය පිළිබඳ
ducat=යුරෝපයේ කලින් පැවති රන් කාසියක්
duchess=ආදිපාදවරයාගේ භාර්ය්‍යාව | ආදිපාදවරිය
duchy=ආදිපාදවරයාගේ දනව්ව
duck=ගෝනිරෙදි | ඩක්කි | තාරාවා | තාරාවි | තාරාවිය | දළ රෙදි වර්ගයක් | දියේ ගිලී මතුවෙනවා | වල්ලභයා | සුන්දරී | හිස දියේ ගිල්වනවා | හිස නැමීම
ducking=තදින් තෙමීම | හිස දියේ එබීම
duckling=තාරා පැටවා
duckweed=නිශ්චල ජලය මතුපිට වැවෙන පැලෑටිය
ducky=ප්‍රේමාලාපයෙහි යොදන පදයක් | සීදේවී
duct=නළය | නායකය | නාලය | ප්‍රණාලය | ප්‍රණාළය | ප්‍රනාලිය | ශිරාව
ductile=තන්‍ය | පහසුවෙන් නැමිය හැකි | මෘදු
ductility=තන්‍යතාව
ductless=විනායක
ductube=ප්‍රණාලකය
ductule=නායිකාව
dud=නිෂ්ඵල | නොපුපුරණ වෙඩිල්ල | පඹයා | පොට්ට | වැඩකට නැති
dude=ජේත්තුකාරයා
dudgeon=අමනාපය | ක්‍රෝධය | රෝෂය
dudodenum=ග්‍රහණිය
duds=පරණ ඇඳුම්
due=කළයුතු | කෙළින් | ගාස්තුව | ගෙවිය යුතු | ගෙවියයුතු | ණය | දැන් පැමිණියයුතු | දිය යුතු දේ | දියයුතු | දේය | දේයය | නියම | නියමිත | නිස්ස | නිසි | බද්ද | යථාවත් | යෝග්‍ය | ලභ්‍ය | ලභ්‍යය | ලැබිය යුතු | ලැබියයුතු දේ | සුදුසු | හරි | හිඟය
duel=ද්වන්ද සටන | ද්වන්ද්ව යුද්ධය | ද්වන්ද්වය
duellist=ද්වන්ද සටනක යෙදෙන්නා
duenna=තරුණියන් බලාගන්නා වැඩිමහල් කාන්තාව
dues=ලභ්‍ය දේ | ලාභ්‍ය
duet=දෙදෙනෙකුට නියම සංගීතය | යුග ගීතය | යුග ගීය
duetist=යුග ගී ගයන්නා
duff=ඩප් | වැදගැම්මක් නැති | හිස්
duffer=ගුඩ්ඩයා | මූර්ඛයා | මෝඩ අදක්ෂ පුද්ගලයා
duffing-out=මකා දැමීම
duffle=බර ලෝම රෙද්ද
dugento=දහතුන් වන සියවස
dugone=මුහුදේ වෙසෙන ක්ෂීරපායි ගණයේ සතෙක්
dugout=පල්ලම
duke=ආදිපාදයා
dukedom=ආදිපාදයාගේ දනව්ව | ආදිපාදයාගේ පදවිය
dulcet=මධුර රසැති | මිහිරි රසැති
dulcify=මිහිරි කරනවා
dulcimer=තත් සහිත සංගීත භාණ්ඩ විශේෂයක්
dull=අඳුරු | උදාසීන | දීප්තිය අඩු කරනවා | දීප්තියක් නැති | නිස්තේජ | නීරස | නොපැහැදිලි | ප්‍රීතිය අඩු කරනවා | මන්දබුද්ධික | මුවාත නැති | මොට | මොට්ට | මොට්ට කරනවා | සිත් නොගන්නා
dull-emitter=අඳුරු විමෝචකය
dullard=මන්දබුද්ධිකයා | මොට්ටයා
dullness=මන්දබුද්ධිය
duly=නියම ලෙස | නියම වේලාවට | සුදුසු පරිදි
dumb=ගොත | ගොළු | නිශ්ශබ්ද | බධිර | මූක | මූග
dumbfound=දවල් තරු පේනවා
dumbly=ගොළු ලෙස | නිශ්ශබ්දව
dumbness=මුක්කම
dummy=අනුව්‍යාජ | කෘත්‍රිම බඩුවක් | ගොළුවා | ඩමිය | පඹයා | පුහුපොත | රැවටිල්ල | ව්‍යාජ
dumose=ගුම්බාකාර
dump=අඩු මිලට විකුණනවා | කුණු ගොඩ | තාවකාලික යුද්ධෝපකරණ ගබඩාව | නික්ෂේපය
dumper=ඩම්පරය
dumping=නික්ෂේපණය | ප්‍රපාතනය | හෙලීම
dumpling=අගාලුව | සුප් ආදියෙහි යොදන ඝන පිටි ගුළිය
dumps=කාන්සාව
dumpy=කොට | තරබාරු
dun=ඔපයක් නැති | ණය ගෙවීමට තදින් කියනවා | ණය ගෙවීමට බල කරන්නා | දුම් හෝ දුඹුරුපාට
dunce=ඉගෙනීමට අසමර්ථයා | මොට්ටයා
dunderhead=අඥානයා
dune=වැටිය | වැලිකන්ද
dung=අශූව | ගොම | මල | සත්ත්ව කසල | සතුන්ගේ කසළ
dung-hill=කසළගොඩ
dungarees=බරවැඩ කරනවිට අඳින රළු ඇඳුම් කට්ටලය
dungeon=ඇඳිරිගේ
dungmere=ගවරවළ
dunk=පොඟවනවා
dunlin=රතුපාට උරගයෙක්
dunnock=පක්ෂියෙක්
duo=ද්වය | ද්විකය | යුගල වාදනය
duodecagon=ද්වාදශාස්‍රය
duodecimal=ද්වා දශම | ද්වාදශම | ද්වාදශමය
duodenary=ද්වාදශමය
duodenum=ග්‍රහණිය
duodrama=ද්විපාත්‍ර නාට්‍යය
duologue=ද්විපාත්‍ර භාෂණය | දෙදෙනෙකු අතර සංවාදය | දෙබස | සතර කන් මන්ත්‍රණය
duopoly=ද්වි අධිකාරය | ශුද්ධ ද්විඅධිකාරය
duopsony=ද්වි ක්‍රයාධිකාරය
duought=පෑවිල්ල
dupe=අඥයා | ඉත්තා | පහසුවෙන් රැවටෙන තැනැත්තා | මුළා කරනවා | රවටනවා
duple=කොටස් දෙකකින් යුත්
duplet=යුග්මය
duplex=කොටස් දෙකක් ඇති | ද්විපථ | දෑඟ | දෙපත්
duplicate=අනු පිටපත් කිරීම | අනුපත | අනුපිටපත | අනුපිටපත් කරනවා | අමතර පිටපත | ද්විගුණ | ද්විගුණ කරනවා | ද්විවිධ | දෙ ගුණ කිරීම | දෙපටට නමනවා | දෙවන පිටපත | දෙවෙනි පිටපත | පිටපත් කරනවා | පිටපත් ගන්නවා
duplication=ද්වි ගුණනය | ද්වි ගුණිතය | ද්විකරණය | ද්විගුණකය | ද්විගුණනය | ද්විත්වරූප | පිටපත් කිරීම
duplicator=පිටපත් කිරීමේ යන්ත්‍රය
duplicity=ද්විගුණනතාව | දෙපිටකාට්ටුකම | වංචාව
duprene=ඩුප්‍රීන්
durability=කල් පැවැත්ම | කල්පවත්නා බව | විරස්ථිතිය
durable=කල් පවත්නා | සවිශක්ති ඇති | ස්ථිර
durain=ඩුරේන්
duralium=ඩුරේලියම්
duralumin=ඩ්‍යරැලුමින් | ඩියරැලුමින් | ඩියුරැලුමින්
duramen=අරටුව
durance=හිර අඩස්සිය
durangite=ඩුරැන්ගයිට්
duration=අවධිය | කාලමාත්‍රාව | පත්‍රයේ ආයුෂය | පවත්නා කාලය | ප්‍රවර්තන කාලය | ප්‍රවර්තනය | පැවැත්ම | පැවැතුම් කාලය
duress=උත්තර්ජනය | තර්ජනය කිරීම | බලාත්කාරකම | සංත්‍රාසනය
during=අතරතුර | අතරතුරේදී | තුරු
dusk=ගොම්මං වේලාව | සන්ධ්‍යාව | සැන්දෑ වේලාව
duskiness=මඳ ඇඳිරිය
dusky=අඳුරු වූ | කනස්සල්ලෙන් යුත් | කළු පාටට හුරු
dust=කුඩ | කුඩු | කුඩු ඉසිනවා | දුලි | දුහුවිලි | දූලි | දූලි පිසදමනවා | දූවිල්ල | දූවිලි | ධූලි | රජ | රජස් | රජෝ | රද | රොන් | වාතකේතු | සුන්
dustbin=කුණු පෙට්ටිය
duster=දූලිකඩ | පිස්නාව
dusting=කුඩු ඉසීම | දූලි වීම
dustman=කුණු අදින්නා
dusty=දූවිලි සහිත
dutch=ලන්දේසි
dutchman=සලන්දයේ වැසියා
duteous=කීකරු | යටහත් | යුතුකම ඉටු කරන
dutiable=තීරුවට යටත් වූ | බදු ගෙවිය යතු
duties=තීරු බදු | යුතුකම්
dutiful=කීකරු | යටහත් | යුතුකම ඉටු කරන
duty=කටයුත්ත | කර | කරණිය | කර්තව්‍ය | කාරිය | තීරු බද්ද | තීරුබද්ද | තීරුබදු | තීරුව | ධර්මය | නියමය | බද්ද | යුතුකම | රාජකාරිය | හුංගම
duvet=සිනිඳු ඝන ඇඳ ඇතිරිල්ල
dvicesium=ද්විසීසියම්
dvimanganese=ද්විමැංගනීස්
dvitellurium=ද්විටෙලියුරියම්
dwall=පර්ක්ෂේපය | බිත්තිය
dwarf=අඟුටු | අඟුටුමිට්ටා | කුදු | කුන්දිරා | කුරා | කුරු | කුරුමිට්ටා | කොටා | මිට්ටා | ලකුණ්ඩක | වාමන | වාමනයා | වැඩෙන්ට නොදී වළකනවා
dwarfing=අඟුටුවීම
dwarfish=කුරු | මිටි
dwell=නිවසනවා | පදිංචිව සිටිනවා | වාසය කරනවා | වැජඹෙනවා
dweller=පදිංචිකාරයා
dwelling=නිවාසය | පදිංවය | වාසස්ථානය
dwindle=අඩු වෙනවා | ක්ෂය වෙනවා | පිරිහෙනවා
dyad=ජෝඩුව | ද්වික | ද්විකය | ද්විදිශය | යුගල
dyadic=ද්වික | ද්විදිශය | ද්විදිශ්‍යය
dyak=ඩයක්
dye=ඩයි | ඩයි කරනවා | පැහැ ගන්වනවා | රංජකය | රන්කුඩු | වර්ණය | සායම | සායම් | සායම් පොවනවා
dyed=සායම් කරනලද
dyeing=සායම් පෙව්ව | සායම් පෙවීම | සායම් පෙවුම
dyeline=රැඳුවම
dyer=රජකයා | රැඳුම්කරු | සායම් පොවන්නා
dyestuffs=රංජක ද්‍රව්‍ය | සායම් | සායම් ද්‍රව්‍ය
dying=අවසාන | නසින | නැසීයාම | මහත් ආහාවෙන් සිටින | මැරීම | මැරෙන
dyke=අගල | කොටු වේල්ල | ඩයිකය | ප්‍රාකාර බැම්ම | වේල්ල
dyname=ඩයිනේම
dynami=ගතික | ප්‍රවෛගික
dynamic=උනන්දු | ක්‍රියාශීලී | ගතික | ප්‍රවෛගික | වේගවත්
dynamical=ගත්‍යාත්මක | ගතිමය | වේගය පිළිබඳ වූ
dynamics=ගති විද්‍යාව | ගතිකය | ගතිවිඥානය | ගතිවිද්‍යාව
dynamis=ගති ශක්තිය
dynamism=ගතිකත්වය | ගතිවාදය | ගතිශක්ති වාදය | පරාක්‍රමය | ප්‍රවෛගිකත්වය
dynamite=ගල්වෙඩි දමා පුපුරවනවා | ඩයිනමයිට් | වේගයෙන් පුපුරන වෙඩිල්ල
dynamo=ඩයිනමෝව | විදුලිබලය උපදවන යන්ත්‍රය
dynamogenesis=කමිඳුරු ජනනය
dynamometer=ඩයිනමෝමීටරය | ශක්ති දහනය මනින උපකරණය
dynamotor=ඩයිනමෝටරය
dynast=අධිපතියා | රාජයා
dynasty=රාජ වංශය
dynatron=ඩයිනට්‍රෝනය
dyne=ඩයිනය
dynesty=අන්වය | රාජවංශය
dynode=ඩයිනෝඩය
dyophsites=ද්විස්වාභාවවාදියෝ
dysarthria=දුෂ්පාර්වය
dyschezia=දුෂ්පුරීක්ෂණය
dyschronous=විවිධකාලීන
dysentery=අතීසාරය | දුරාන්ත්‍රය | පාචන රෝගය | රක්තාතීසාරය
dysfunction=දුෂ්කෘතිය
dysgraphia=දුර්ලේඛය
dysjunction=වියුංජනය | විසම්බන්ධය
dyslalia=දුර්ලාලනය
dyslexia=වචන අන්ධතාව
dyslogia=දුර්වචය
dysmanorrhoea=දුරාර්තවය
dysnomia=අවසිද්ධිය
dysparathyroidism=දුෂ්පැරාතයිරොයිඩතාව
dyspareunia=දුර්මෛථුනය
dyspepsia=අර්ණය | ආමය | දුස්පාචය | මන්දාග්නිය
dyspeptic=අර්ණරෝගයෙන් පෙළෙන්නා | ආමරෝගියා
dysphagia=දුර්භක්ෂය
dysphasia=දුර්භාෂ්‍යය
dysphemia=දුරුච්චාර්යතාව
dysphonia=දුස්ස්වනය
dysphoria=අවසිද්ධිය
dysphotic=අවප්‍රකාශ
dysplastic=දුර්විකාර්ය
dyspnoea=ඩිස්නියාව | දුරානනය | දුහ්ශ්වසනය
dysprosium=ඩිස්ප්‍රෝසියම්
dysrhythmia=දූරිත්මියාව
dysteleology=දුස්සාධ්‍යතාවාදය | නිස්සාධ්‍යතාවාදය
dystimbria=දුරනුනාදය
dystrophia=දුෂ්පෝෂණය
dystrophic=දුෂ්පෝෂක
dystrophy=සදොස් පෝෂණය
