f=සංගීතයෙහි ස්වරයක්
f=සංගීතයෙහි ස්වරයක්
f-number=ඡායාරූපකරණයේදී නාභි දුර
f.a.a=භාගික හානියෙන් නිදහස් ව
f.a.a.=භාගික හානියෙන් නිදහස්ව
f.a.c.=ගැල්කුලී හා ප්‍රවාහණය
f.a.o.=ආහාර හා කෘෂිකර්ම සංවිධානය | ආහාර හා කෘෂිකාර්මික ආයතනය
f.a.s.=නැව දක්වා නොමිලේ | නොමිලේ නැව අසට
f.g.a.=භාගික හානියෙන් තොරව
f.i.f.o.=ප්‍රථමයෙන් ලැබ ප්‍රථමයෙන් නිකුත් කල
f.m=සංඛ්‍යාන මූර්ජනය
f.o.b=නැවතෙක් නොමිළේ
f.o.b.=නැව තෙක් නොමිලේ | නැවට පටවන තෙක් නොමිලේ
f.o.r.=මිරිය තෙක් නොමිලේ
f.o.s=මුද්දර ගාස්තුවෙන් තොර
f.o.t.=ප්‍රශස්ත පැහිනිම සංඛ්‍යාතය | ප්‍රශස්ත පැහිනියම් සංඛ්‍යාතය
f.p.a.=විශේෂ වන්දියෙන් තොර
f.r.=මුදල් රෙගුලාසි
f.s.=ආරක්ෂක සාධකය
f.s.m.=සංඛ්‍යාත මාරු මූර්ඡනය
fabianism=්ෙබියානුවාදය
fable=උපමා කථාව | උපමාකථාව | උපහැරණය | මිථ්‍යා ප්‍රබන්ධය | වෘත්තාන්තය
fabriation=ගජ බින්නය
fabric=ගැළපීම | ගොඩනැගිල්ල | ගොඩනැගිල්ලේ බාහිර කොටස | චීත්ත | දැල | නිර්මාණය | නිර්මිතිය | රෙදිපිළි
fabricate=ගළපා සාදනවා | ගොතනවා | පිරිසකසනවා | බොරුවට ප්‍රබන්ධ කරනවා
fabricated=අටපට්ටම්
fabrication=කෙබර | ගළපන ලද්ද | ගෙතීම | පිරිසැකැස්ම | බොරුව | මිථ්‍යා ප්‍රබන්ධය
fabrics=රෙදි වර්ග
fabulous=අත්‍යධික | උපමා කථාත්මක | කල්පිත | මිත්‍යා | විස්මයාවහ
facade=ඉදිරි කෙවුම | ගොඩනැගිල්ලේ ඉස්සරහ පැත්ත | ප්‍රාසාද මුඛය | මුහුණත
face=ආකෘතිය | ඉදිරියෙන් පෙනෙන කොටස | උවන | තලය | තුඩ | පෙනුම | ඵලකය | බඩය | මතුපිට වැස්මක් යොදනවා | මුඛ | මුණගැසෙනවා | මුණය | මුද්‍රණාක්ෂර මුහුණත | මුව | මුහුණ | මුහුණ පානවා | මුහුණත | මූණ | මූණත | මූණු | මූන | වක්ත්‍රය | වත | වදන | වුවන | වුවන්
face-left=වමත් මූණත
face-right=දකුණත් මූණත
faces=අශුව | බොර | මල
facet=අනීකය | ඇසි මුහුණත | මුහුණස | මූණත | මූනිත්ත | විෂය මුඛය | විෂයාංශය
facetious=උපහාසයට කැමැති | කවටකමට කැමැති | සරදමට කැමැති
facia=උපකරණ පුවරුව
facial=මුහුණ පිළිබඳ වූ | වක්ත්‍ර | වක්ත්‍රීය
faciation=අනුසංගමය
facies=ප්‍රාගනුසංගමය | මුහුණත | මුහුණුවර | මුහුණේ ආකාර විකාරය
facile=අනුකූල | පහසු | මෘදු | ව්‍යක්ත | සූර
facilitate=පහසුකම් සලසනවා
facilitation=පහසු කිරීම | සුසාධ්‍ය කිරීම
facilities=පහසුකම් | ලෙහෙසිය | වුවමනා උපකරණ ආදිය | සුදුසු ප්‍රස්තාව
facility=දක්ෂකම | පහසුකම | ලෙහෙසිය | ව්‍යක්තභාවය
facing=අබිමුව | අභිමුඛ | පිට වැස්ම | මුහුණස | මුහුණස ලියවීම | මූණත ලියවීම
facism=ඒකාධිපති වාදය
facsimile=අනුවත්‍රය | නිවැරදි පිටපත | ප්‍රතිකෘතිය | ප්‍රතිරූප
fact=ඇත්ත | කරුණ | කාරණාව | තත්ත්වය | තතු | තතුව | තොරතුර | පරිසිද්ධිය | ප්‍රමිතිය | බැව් | යමක් පවත්නා බව | සිද්ධාන්තය | සිද්ධිය | සිය
faction=කට්ටිය | කලහය | පිල | බේදය | භේදය
factionalism=කට්ටිවාදය | ගණවාදය
factious=කලහකාරී
factitious=අතාත්වික | කෘත්‍රිම | ස්වභාවික නොවන
factor=කරුණ | කළමනාකාරයා | ගුණකය | පැක්ටර්වරු | මූලාංකය | සාධකය | හේතුව
factorability=සාධකවලට බිඳිය හැකි බව
factorable=සාධකවලට බිදිය හැකි
factorial=ක්‍රමාරෝපණ | ක්‍රමාරෝපිත | ක්‍රමාරෝපිතය | සාධකාත්මක
factoring=සාධකවලට බිඳීම
factorisation=සාධක සෙවීම | සාධකවලට බිඳීම
factorise=සාධක සොයනවා
factorization=සාධක සෙවීම
factors=සාධක
factory=ඉස්ටෝරුව | කම්හල | කර්මාන්ත ශාලාව | කර්මාන්තශාලාව | කර්මාන්තාලය | පට්ටලය | පිටරට වෙළඳ කාර්යාලය | යන්ත්‍රාගාරය | වැඩපොළ | විශාල කර්මාන්ත ශාලාව
factotem=කිංකරයා | සියලු දේ කරන්නා
factual=කරුණු පිළිබඳ වූ | තථ්‍ය | පරිසිද්ධි වාචක | පරිසිද්ධිවාචක | සත්‍ය | සිද්ධි වාචක
factum=ක්‍රියාව | පරිසිද්ධිය
facture=කරසන
faculae=දිදුල
facultative=වෛකල්පික
faculty=අධ්‍යයනේන්ද්‍රිය | අධ්‍යාපන පීඨය | අධිකාරය | ආචාර්ය ගණය | ආයතනය | ඉන්ද්‍රිය | ඉන්ද්‍රිය ශක්තිය | ඉන්ද්‍රියය | ඉන්ද්‍රීයය | පැවිදිසි අනුඥාව | පීඨය | පීඨසප්පියා | බු මහිමය | වත්ත ප්‍රභවය | විද්‍යාංශය | විශේෂ සාමාර්ථ්‍යය
fad=කාමතාව | පන්නකාමය | පන්නය | පිස්සුව | විශේෂ කැමැත්ත
faddist=පිස්සා
fade=පරවෙනවා | මැලවෙනවා | මැලැයීම | මැලීම | විවර්ණ වෙනවා
faded=පර | මලානික | ම්ලාන | මුකුලිත
fadeless=පාට වෙනස් නොවන
fadeometer=ලායනමානය | ලායනාමානය
fader=මලයනය
fading=මැලයීම | මැලැයීම | මැලීම | හායනය
faddy=විවිධ අදහස් ඇති
faecal=අශුව සහිත
faeces=අශුව | අශූව | අසූව | ගූ | බොර | මල | වසුරු
faerie=කාල්පනික | දෙව්දූ | මායාවී
faery=කාල්පනික | දෙව්දූ | මායාවී
faff=පැකිලෙනවා
fag=ආවතේව කාරයා | කෙඩෙත්තු කරනවා | කෙඩෙත්තු වෙනවා | කෙඩෙත්තුව | බොහෝ සේ වෙහෙසෙනවා
fagend=අන්තිම තොංගල
fagged=කෙඩෙත්තු වූ
faggot=කෝටු මිටිය | දර මිටිය
fagot=කෝටු මිටිය | දර මිටිය | මිටිය
fagoted=මිටි බැඳි
fagoting=මිටි බැඳීම | මිටි ලෑම
fah=සංගීත ස්වරයක්
fahrenheit=පාරන්හයිට් | පැරන්හයිට් උෂ්ණමාපකය
faience=පයන්සා | විසිතුරු පිඟන් බඩු
fail=අසමත් වෙනවා | අසමත්වීම | අසමර්ථ වෙනවා | අසමර්ථවෙනවා | නිෂ්ඵල වෙනවා | පාඩු පමුණුවනවා | පිරිහෙනවා | බැරි වෙනවා | වරද්දනවා | වස්තුභංගත්වයට පැමිණෙනවා | වැරදීම | හරි නොයනවා | හිඟ වෙනවා
failing=දෝෂය | පාඩුව | බැරිකම
failsafe=නිෂ්ක්‍රිය සුරක්ෂිත
failure=අපොහොසත් වීම | අසමත් වීම | අසමර්ථ වීම | අසාමර්ථ්‍යය | ඇණ හිටීම | ඇනහිටීම | ක්‍රියා නොකිරීම | පැහැර හැරීම | බැරිකම | වගකට නැති තැනැත්තා | වස්තු භංගත්වය | විකල වීම | විකලය | විනාශය | විපත
fain=ඉතා සතුටින් | සතුටු ඇති
faint=ක්ලාන්ත | ක්ලාන්ත වෙනවා | ක්ලාන්තිය | තෝන්තුව | තෝන්තුවාව | දීප්තියෙන් හීන | දුර්වල | ධෛර්ය්‍යයෙන් හීන | නිලංකාර කාර වෙනවා | ප්‍රභාහීන | බියසුලු | මන්ද | මූර්ඡා වෙනවා | මූර්ඡාව | ශක්තියෙන් හීන | ස්වල්ප | සිහිනැති වෙනවා | හීන්
fainting=ක්ලාන්තය | මුරුත්තාව | මුස | මූර්ඡාව | මූර්වණය | විෂමූර්ඡාව
faintly=අඳුරුව | යන්තමින්
faintness=ක්ලාන්තිය | මන්දතාව
fair=අපක්ෂපාති | අවංකව | කරුණාවන්ත ලෙස | කළු නොවූ | තරමක් හොඳ | නිර්දෝෂ | පැහැදිලි | පිංකම්පොළ | පෙරහැර | පොළ | ලක්ෂණ | වැසි නැති | වෙළඳපොළ | ශෝභන | සතුටුදායක | සම මට්ටම් | සල්පිල | සල්පිළ | සාධාරණ | සාධාරණ ලෙස | සෑහෙන | සූර්යාලෝකය ඇති
fairing=නැවකට සවිකරන ආරක්ෂක සැකිල්ල
fairly=තරමක්
fairness=යුතුකම | ශෝභාව | සාධාරණත්වය
fairway=නැව්පාව
fairy=කුඩා භූත විශේෂයක් | දිව්‍යමය | දෙව්දුව | විද්‍යාධරී | සුරඟන
fairy-ring=හතු මල
fairyland=සුරලොව
faith=ආගම | ඇදහිල්ල | ඇදහිලි | භක්තිය | ලබ්ධිය | විශ්වාසය | ශ්‍රද්ධාව | සත්‍ය වචනය | හැදහිල්ල | හැදහිලි
faithful=නිවැරදි | භක්තිමත් | විශ්වාස කළ හැකි | විශ්වාසී | ශ්‍රද්ධාවන්ත | ළැදි
faithfully=අවංක ලෙස
faithless=අශ්‍රද්ධාවත් | ද්‍රෝහී
fake=කූට | කෘත්‍රිම | ප්‍රයෝගය | බොරු | බොරු කරනවා | මායාව | රැවටිල්ල | ව්‍යාජ | ව්‍යාජය | හොර
fakir=සන්නාසියා
fal-lal=අලංකාර ආයිත්තම
falaise=දඹය
falcate=දාත්‍රාකාර | දෑකැති හැඩ
falciform=දාත්‍රාකාර | දෑකැතිහැඩ
falcon=උකුස්සා | කුරුළුගොයා
falconer=කුරුළුගොයින් පුහුණුකරන්නා
falconry=කුරුළුගොයින් පුහුණු කිරීම
falklore=ජනශ්‍රතිය
fall=අඩු වීම | අඩුවෙනවා | අපකීර්තිය | ඇද වැටෙනවා | ඇල්ල | එල්ලෙනවා | ගිලිහෙනවා | නැති වෙනවා | පතනය | පතිත වෙනවා | පරිහානිය | ප්‍රපාතය | පාතය | පාත් වෙනවා | පාපය | පිරිහෙනවා | පෙරළෙනවා | බස්නාව | බැස්ම | බෑවුම | භ්‍රංශය | යටත් වීම | යටත් වෙනවා | වැටීම | වැටෙනවා | වැම්මෙනවා | වැසීම | සම්පාතය | සිද්ධ වෙනවා | හැලෙනවා | හෙනවා
fallable=වැරදෙන සුලු
fallacia=ආභාසය
fallacious=අභාසවත් | අසත්‍ය | ආභාසය | ආභාසික | තර්කානුකූල නොවූ | මිථ්‍යාවත් | වැරදි සේ වටහාගත්
fallacy=ආභාසය | භ්‍රමය | මිථයාව | මිථ්‍යා තර්කය | මිථ්‍යාව | මුළාව | වැටහීම | වැරදි
fallen=පාපයට පෙළඹුණු | පිරිහුණු | මරණයට පත් වූ | වට | වැටුණු
fallers=නැවතුම් දෑරුම්
fallibilism=වද්‍යුය | වරදිනසුලුබව
fallible=ප්‍රමාදී | වරදිනසුලු
falling=වැටෙන
fallow=නිෂ්ඵල | පජුවන් හෝ දුඹුරුවන් | පුරං | පුරන් වූ | පුරන් වූ බිම | වඳ
false=අනියම් | අබූත | අභූත | අසත් | අසත්පුරුෂ | අසත්‍ය | කුහක | කූට | කෙබර | චාටු | ද්‍රෝහී | බොරු | මිත්‍යා | මිථ්‍යා | ව්‍යජ | ව්‍යාජ | වැරදි | සදොස් | හොර
falsegood=මිථ්‍යාව
falsehood=අසත්‍යතාව | බේගල් | බොරුව | මිථ්‍යාව | මුසාවාදය | ව්‍යාජත්වය | ව්‍යාජයක්
falseness=අසත්‍යතාව | ද්‍රෝහීකම
falsetto=බොරු හජ
falsework=නොතිර වැඩ | බොල් වැඩ
falsidical=අසත්‍යභාෂී
falsifiability=අසත්‍යේක්ෂණය
falsification=අසත්‍යනය | අසත්‍යයනය | අසත්‍යෙක්ෂණය | බොරු කිරීම
falsify=නිෂ්ඵල කරනවා | බොරු කරනවා | වරද්දනවා | ව්‍යාජනය කරනවා
falsitas=රැවැටීම
falsity=අසත්‍යතාව | ද්‍රෝහීකම | ව්‍යාජතාව
falter=අධෛර්ය වෙනවා | ඇනහිටිනවා | ගොත ගහනවා | පැකිලෙනවා
faltung=පිරිවෙළුව
fambu=දඹ
fame=කීර්තිය | ප්‍රසිද්ධිය | යශ | යශස | යශහ් | යශෝ | යස | යසස | විශ්‍රුතිය | ශ්‍රී
famed=කීර්තිමත් | ප්‍රසිද්ධ
familial=කුටුම්බ | පවුල්
familiar=කුලුපග | ගරුසරු නැති | නිතර දැක පුරුදු | පිශාචයා | යහළුවා | සාමාන්‍ය | හුරු | හුරුපුරුදු | හොඳින් දන්නා
familiarisation=හුරුපුරුදු කැරුම
familiarise=හුරුපුරුදු කරනවා | හුරුපුරුදු වෙනවා
familiarity=හුරුපුරුදුකම | හුරුව
familiarize=දැනුම හා පුරුද්ද ඇති කරගන්නවා
famility=අධික මිත්‍රත්වය | අනාදරය | කුලූපගබව | නිදහස් හැසිරීම | නිපුණත්වය
family=කුටුම්බය | කුලය | ගෙයි වැසියෝ | ගෝත්‍රය | පවුල | පවුලට අයත් | පෙළපත | වර්ගය | සන්තානය
famine=අහේනිය | දුර්භික්ෂය | දුර්භීක්ෂය | සා | සාගත | සාගතය | සාය
famish=හාමතේ තබනවා | හාමතේ සිටිනවා
famous=කීර්තිමත් | නම් දරාපු | පසිඳු | පළ | ප්‍රංශු | ප්‍රසිද්ධ | ශ්‍රීමත්
fan=අවාන | කුල්ල | ගිනි මොලවනවා | චාමරය | පංකාව | පවන් ගහනවා | පවන් සලන යන්ත්‍රය | පවන් සලනවා | පවන් සළනවා | පවන්පත | පොළනවා | ලෝලයා | වටාපත | විජනිය | විනිපත | විනිය | සුළං සෙමින් හමනවා | හුළංපෙත්ත
fanatic=අන්ධභක්තිකයා | භක්ති උන්මන්තකයා | භක්ති උන්මාදක | සීමාන්තිකයා
fanatical=උමතුවෙන් උනන්දු වූ | භක්තියෙන් උජ්ජ්වලිත
fanaticism=අන්තගාමී බව | ආගම් පිස්සුව | ධර්මෝන්මාදය | භක්ති උන්මාදය | සීමාන්තික උද්‍යෝගය
fancier=ප්‍රදර්ශනය පිණිස සතුන් ඇතිකරන්නා
fanciful=අනියම් | අයුක්තියක් නැති | කාල්පනික | මනහ්කල්පිත | මායාවී | හිතුබුද්ධියේ කෙරෙන
fancy=අධික | අනියම් | අරුමෝසම් | අලංකාර | ආශා කරනවා | කල්පනා කරනවා | කල්පනාමාත්‍රය | මනාපය | මනෝරථය | මුළාව | සිතාගන්නවා | සිතිවිල්ල | හිතුබුද්ධිය
fandango=ස්පාඤ්ඤ නැටුමක්
fane=කෝවිල | දේවාලය
fanfare=කාහලනාදය | මහත් තූර්ය ඝෝෂය
fang=දළ | දළය | දිග දත | බලු දත
fanged=දළ සහිත | විසකුරු
fantail=අවානක් වැනි වලිගයක් ඇති පරවියා
fantasize=දවල් හීන දකිනවා
fantasm=මනස්සෘෂ්ටිය
fantastic=අද්භූත | අද්භූතජනක | අරුම පුදුම සහිත | මනස්සෘෂ්ටික | මනහ්කල්පිත | මායාවී | විකාර
fantasy=අපූර්ව සිහිනය | මනස් සෘෂ්ටිය | මනස්සෘෂ්ටිය | මනහ්කල්පිත | විජ්ජාව | විවත්‍ර කල්පනාව
faquir=සන්නාසියා
far=අතිශයින් | අධිකව | ඈත | එපිට | එපිටහ | එහා | තොර වූ | දුර | දුර පිහිටි | දුර වූ | දුරින් | දුරු | දූරීභූතව | බැහැර | විශාල ප්‍රමාණය
far-sight=දූර දෘෂ්ටිය
far-sighted=දූරදර්ශී
farad=පැරඩය
faraday=පැරඩේ
farce=කෝලම් | ප්‍රහසනය | විකට නාට්‍යය | විකාරය | විහිළුව
farceur=ප්‍රහසනාකාර
farcical=උපහාස | ප්‍රහසනාත්මක | සිනහ උපදවන
fare=කල දවස යවනවා | කෑම | කුලිය | ගමන් කරනවා | ගමන් ගාස්තුව | ගාස්තුව | සිද්ධ වෙනවා
farewell=ආයුබෝවන්
farina=කුඩු | පිෂ්ටය
farinaceous=පිටි ඇති | පිටි වැනි | පිෂ්ටමය | පිෂ්ටවත්
farm=අංග සම්පූර්ණ ගොවිපොළ | කුලියට රැකබලා ගන්නවා | ගොවිකම් කරනවා | ගොවිපළ | බදු ගන්නවා | රේන්ද කරනවා | රේන්දය
farmer=ගොයියා | ගොවියා | රේන්ද කාරයා
farming=ගොවිකම | ගොවිතැන
farmyard=ගොවිපොළ ගාල | මිදුල
faro=සූදුවක්
farraginous=අවුල් සහිත
farrago=අවුල්ජාලය | සම්මිශ්‍රණය
farrier=අශ්ව වෛද්‍යුවරයා | අශ්වයන්ට ලාඩම් ගසන්නා
farriery=අශ්ව වෙදකම
farrow=ඌරු පැටවුන් රංචුව
farsi=පර්සියන් භාෂාව
fart=අධෝවාතය | ගුදයෙන් වාතය පිට කරනවා | ගුදවාතය | පඩය | පඩිනවා
farther=ඔබ්බට | තවත් එහා | වඩා දුර වූ
farthest=ඉතා ඈතින් | ඉතා දුර වූ
farthing=තුට්ටුව | පාදිම | පාර්දිම
farthingale=කවාකාර යටසාය විශේෂයක්
fasces=බලධාරයාගේ ලාංඡනය
fascia=කවලිකාව | දිග ලී පතුර | යකඩ පතුර
fasciation=කලාපනය
fascicle=කළඹ | කාණ්ඩය | පොකුර | මිට | මිටිය
fascicled=කලාපික
fascicular=කලාපීය
fascicule=කළඹ | පොකුර | මිට | මිටිය
fascimile=ප්‍රතිකෘතිය
fascinate=ප්‍රීතියෙන් පිනවනවා | වශී කරනවා | සිත අල්ලාගන්නවා
fascinating=මනහර | ලයාන්විත | වත්තාකර්ෂණීය | ශෝභාවත්
fascination=මෝහනය | වශීකරණය | සිත් ඇද ගැනීම
fascine=දඬුමිටිය
fascism=උග්‍රරාජ්‍යවාදය | පැසිස්ට් වාදය | පැසිස්ට්වාදය
fascist=ධනවාදී ඒකාධිපතියා | මුසොලීනි අනුගමනය කරන්නා | මුසොලීනිගේ පාක්ෂිකයා
fashion=අන්දම | ආකාරය | තනනවා | තාලය | නිර්මාණය කරනවා | පන්නය | මෝස්තරය | ලතාව | ලීලය | ලීලා | ව්‍යවහාරය | විලාසිතා | විලාසිතාව | සිරිත | හැඩගස්වනවා | හැඩය
fashionable=ජේත්තු | විලාසිතාකාරී | විලාසිතාගත | ශිෂ්ටසම්මත | හොඳට ඇඳ පැළඳගත්
fast=ඉක්මන් | උපවාසය | උපවාසයෙහි යෙදෙනවා | කාමුක | ද්‍රුත | දැඩි | දැඩි ලෙස | නිරාහාරව සිටිනවා | යුහුව | වේගයෙන් | වේගයෙන් ගමන් කරන | ශීඝ්‍ර | සත්‍යග්‍රහය | ස්ථිර | හිඟු
fasten=තද කරනවා | තද වෙනවා | බඳිනවා | යොමු කරනවා | සවි කරනවා
fastener=අගුළ | ගාංචුව | ගැටේ | බැම්ම
fastening=අගුළ | ගාංචුව | ගැටේ | බැම්ම | සවි කිරීම
fastidious=පරෙස්සමෙන් තෝරන | පහසුවෙන් සතුටු නොකළැකි
fastigiate=උත්ප්‍රාන්තය
fastigiation=උත්ප්‍රාන්තනය
fasting=උපවාසය | උපෝෂිත | ලංඝනය
fastness=දුර්ගය | බලකොටුව
fat=ඝන | තඩි | තර | තරබාරු | තූල | තෙල | තෙල් සහිත | ථුල්ල | පීවර | පුෂ්ටිමත් | මහත | මාංසල | මේද | මේදය | මේදස් | ලාහ උපදින | ස්ථූල | ස්ථූලත්වය | සාරය | සාරවත්
fatal=අරිෂ්ට | අසාධ්‍ය | මරණීය | මාරක
fatalism=දෙවවාදය | දෛව වාදය | දෛවවාදය | භවිතව්‍යතාවාදය
fatalist=දෛවවාදියා
fatalistic=දෛවවාදය පිළිබඳ වූ
fatality=අනතුර | කර්මශක්තිය | දෛවයෙහි නොවැළැක්වියහැකි බලය | නියතිය | මාරක විපත | මාරක සිද්ධිය
fate=අවසානය | ඉරණම | ඉරනම | ඉසේකෙටුම | කර්මය | දෛවය | නියතිය | භවිතව්‍යතාව | මරණය | විදි
fated=නියත
fateful=අවාසනාවන්ත | කරුමක්කාර | කරුමකාර | දෛවනියුක්ත | මාරක | ශාපලත්
father=ආදිකර්තෘ | උත්පාද කරනවා | උත්පාදකයා | කර්තෘත්වය පිළිගන්වනවා | ජ්‍යෙෂ්ඨයා | තාත්තා | දරුකමට හදාගන්නවා | නායකයා | පාදිලි | පිතෘ | පිය | පියබව පිළිගන්වනවා | පියා | විශේෂයෙන් ගෞරව කළයුත්තා
father-hood=පිතෘත්වය
father-in-law=සුහුරු
father-land=ජන්ම භූමිය
father-less=පියා නැති
fatherly=කරුණාවන්ත | පියකු වැනි
fathers=පියවරු | මුතුන්මිත්තෝ
fathom=ගැඹුර මනිනවා | බඹ | බඹය | බ්‍යාමය | ව්‍යාම | සත්‍යය සොයා දැනගන්නවා
fathomless=අගාධ | පත්ලක් නැති
fatigium=උත්සන්නය
fatiguability=විඩාසුලුව
fatigue=කෙඩෙත්තුව | තෙහෙට්ටුව | පරිශ්‍රමය | ප්‍රයාසය | බලවත් වෙහෙස | මාන්සිය | විඩාව | විඩාවෙනවා | වෙහෙස | වෙහෙස කරන කටයුත්ත | වෙහෙස කරනවා | සරත | සරතස | සරම | හෙණ්ඩත | හෙම්බත් වෙනවා | හොළ
fatigued=ක්ලාන්ත | ග්ලාන | හෙම්බත්
fatricide=භාත්‍ර ඝාතකයා | භාත්‍ර ඝාතනය
fats=තෙල් | මේද | මේද වර්ග
fatstock=මස් පිණිස ඇති කරන සත්තු
fatted=තර කරන ලද
fatten=ආරනවා | තර වෙනවා | තරකරනවා | සාරවත් කරනවා
fattura=කරසන
fatty=තෙල් වැනි | තෙල් සහිත | ස්ථූල
fatuity=මෝඩකම
fatuous=තකතිරු | මෝඩ | වැදගැම්මකට නැති
fauces=කෘකය
faucet=කුඩා කරාමය | පැටි කරාමය
faucial-diptheria=කෘකීය ඩිප්තීරියාව
fault=අවගුණය | ඇවැත | කඩතොලු | ඡිද්‍ර | ඡිද්‍රය | දොස | දෝෂය | පලුද්ද | පළුද්ද | ප්‍රමාදදෝෂය | ප්‍රමාදය | භ්‍රාන්තිය | ලෙඩේ | වජ්ජ | වද්‍යුය | වරද | වැරදීම | වැරැද්ද | විභේදය | සෝලිය
faulting=විභේදනය
faultless=අදෝෂ | අනවද්‍යු | නිරවද්‍යු | නිවරද | නිවැරදි | නිස්කලංක
faulty=අගුණ | අපරාධ | ඛලිත | දෝෂ සහිත | වැරදි ඇති | සදොස්
faun=රෝමයෙහි කුඹුරට හා කැලයට අධිපති දෙවියා
fauna=සත්ත්ව වර්ගයා | සත්ත්ව සංහතිය | සත්වසංහතිය
faunnia=පැනියා
fauvism=වනමෘග වාදය
favour=අනුග්‍රහය | ආධාරය | උදවු වෙනවා | උපකාර කරනවා | උපකාරය | කරුණාව | කුඩා තෑග්ග | ඡන්ද | ඡන්දය | පක්ෂ භජනයක් | පක්ෂව සිටිනවා | ප්‍රසාදය | පිහිට වෙනවා | ලියුම | වාසිය
favourable=අනුකූල | මනාප | වාසි සහිත | වාසිදායක | සතුටුදායක | හිතවත්
favouring=නමට
favourite=ප්‍රියතම | ප්‍රියතමය | වල්ලභ වූ තැනැත්තා
favouritism=අනිසි අනුග්‍රහය | අනිසි පක්ෂ පාතිත්වය | අනිසි පක්ෂපාතිත්වය | පක්ෂභජනය
fawn=අධික ගෞරවය දක්වනවා | පජුවන් | පජුවන් පාට | මුව පොව්වා | මුවපැටියා
fawning=අධික යටහත් පහත්කම් දක්වන
fay=දෙව් දුව | සුරඟන
feable=දුර්වල
fealty=ස්වාමිභක්තිය
fear=චකිතය | ත්‍රාසය | තැති ගැනෙනවා | තැතිගන්නවා | තිගැස්ම | තිගැස්සෙනවා | පොල් පේනවා | බඩ දනවා | බය | බානවා | බිය | භය | භය වෙනවා | භයක් | භයට හේතුව | භයින් සිටිනවා | භීතිය | මහත් ගෞරව දක්වනවා | යටහත්කම | වන්තාව | සත්ත්‍රාසය | සැක කරනවා | සැකය
feared=භ්‍රාන්ත
fearful=ගොර | ගොරතර | ඝෝර | බයාදු | බියකර | බියකරු | බිරු | බිහිසුණු | භයානක | භීරු | භීෂණ | භෛරව | සභය
fearless=අබය | අභද්‍ර | අභය | අභීත | අභීරු | එඩිතර | ක්ෂේම | තද | නිර්භය | නිර්භීත | විශාරද | ශූර | සිංහ
fearsome=ඝෝර | බිහිසුණු
feasibility=සාධ්‍යතාව | හැකිකම
feasible=කළහැකි | සාධ්‍ය
feast=උත්සව පවත්වනවා | උත්සවය | පිනවනවා | පිනවීම | මංගල්‍යය | මගුල් කනවා | විශාල භෝජන සංග්‍රහය
feat=දක්ෂ වූ ක්‍රියාව | දුෂ්කර වූ ක්‍රියාව | වික්‍රමය
feather=පැතලි කීලය | පිච්ඡය | පිල් | පිහාට්ට | පිහාටුව | පිහාටුවලින් වසනවා
feather-veined=පක්ෂාකාර නාරටි සහිත
feathered=පිහාටු ඇති
feathery=ඉතා සියුම් | පිහාටු වැනි
feature=අංගය | උප ලක්ෂණය | කඩවසම | මූණුවර | ලක්ෂණය | විශේෂාංගය | විෂය මාතෘකාව | වෘත්තාන්තය | හැඩය | හැඩරුව
features=ගතිගුණ විදහා පෙන්වනවා | මුහුණුවර | ලක්ෂණ | විශේෂ විභාගය | හැඩහුරුකම විදහා පෙන්වනවා
febrifacient=ජ්වරකාරකය
febrifuge=ජ්වරහාරකය
febrile=උණ සහිත
febrous=කෙඳි සහිත | කොහු සහිත
february=පෙබරවාරි මාසය
fec=නිර්මාපක
feces=අසූව | මල
fecet=ප්‍රශ්නයක එක පැත්තක්
fecit=නිර්මාපක
feckless=දුර්වල | වගකට නැති
fecund=ඵල දරන | බොහෝ දරුවන් ඇති | සාරවත්
fecundation=සංසේචනය
fecundity=ජනක ශක්තිය | දරුපල | දරුඵල | සඵලතාව | සාරවත්බව
fecunidty=දරු පලදාව
federal=පෙඩරල | සන්ධිය | සාමූහික
federalism=පෙඩරල්වාදය | සන්ධිය වාදය | සන්ධීයවාදය
federate=ඒකාබද්ධ කරනවා | ඒකාබද්ධ වෙනවා
federated=ඒකාබද්ධ
federation=එක්සත් වීම | පෙඩරල රාජ්‍යය | පෙඩරලකරය | සන්ධියනය | සමූහාණ්ඩුව
fee=කුලිය | ගාස්තුව | ගාස්තුව ගෙවනවා | පාරිතෝෂිකය | භෘති | වැටුප
feeble=අබල | අබලන් | අබලි | ඔබල | දුබල | දුර්වල | බෙලහීන
feeblemindedness=මන්දබුද්ධිකතාව
feebleness=බෙලහීනකම | මාන්දුව
feec=විදේශ විනිමය හිමිකම් සහතිකය
feed=කවනවා | කෑම ලබාගන්නවා | කෑම සපයනවා | පිනවනවා | පෝෂණය | පෝෂණය කරනවා | පෝෂ්‍ය කරනවා | පෝෂ්‍ය වෙනවා | රක්ෂා කරනවා | රස්සා කරනවා | වඩවනවා | වුවමනා දේ සපයනවා | සංග්‍රහ කරනවා | සංවර්ධන කරනවා | සතුටු කරනවා
feed-back=ප්‍රතිපෝෂක | ප්‍රතිපෝෂණය
feed-line=ප්‍රතිවාචක පාඨය
feedback=ප්‍රතිචාරය | ප්‍රතිපෝෂණය | ප්‍රතිලබ්ධිය
feeder=කවන්නා | පෝෂකය
feeding=ආහාරදීම | කැවීම | කෑම සැපයීම | පෝෂක | පෝෂ්‍ය කිරීම
feel=අතගා බලනවා | ඇඟෙනවා | දැනීම | දැනෙනවා | විඳිනවා | ස්පර්ශය | හඟිනවා | හැඟීම | හැඟුම | හැඟෙනවා | හිතෙනවා
feeler=පහස්නාව | ස්පර්ශේන්ද්‍රිය
feeling=දයාව | වින්දනය | වේදනය | වේදිතය | ස්පර්ශය | හැඟීම | හැඟීම්
feelingly=අනුකම්පා සහිතව
feelings=හිත | හිතේ ඇතිවන හැඟීම්
feet=අඩි | පාද
fefined=රසවත්
feign=පරල වෙනවා | බොරුවට අඟවනවා | මායම් වෙනවා | රැවටිලි කරනවා
feint=බොරුවට අඟවනවා | රැවටිල්ල | වංචාකාර උපාය | ව්‍යාජය
feldspar=ඛනිජයක් | පෙල්ස්පාර්
felicific=අභිනන්දන
felicitate=සතුට පළ කරනවා
felicitation=අභිනන්දනය
felicitous=ඉතා යෝග්‍ය | කල්‍යාණ | මනහර | වාසනාවන්ත
felicity=මහත් වාසනාව | රමණීයත්වය | සෞභාග්‍යය
feline=අසත්පුරුෂ | බළල් වර්ගයට අයත් | විශ්වාස නොකළැකි
fell=කපා බිම හෙළනවා | ගසා බිම හෙළනවා | දරුණු | නිසරු කඳුගැටය | මුඩු කඳු බිම් | රෞද්‍ර
fellah=මිසර දේශයේ ගොවියා
fellaheen=මිසර දේශයේ ගොවියෝ
fellahs=මිසර දේශයේ ගොවියෝ
fellers=විලංගු
felling=ගස් කැපීම
felloe=රෝදයක වක් අත්ත
fellow=අධිශිෂ්‍ය | අධිසාමාක | එකා | ග්‍රහයා | පොදු | මිත්‍රයා | මිනිහා | සකා | සභාධ්‍යායයා | සමාගම්කාරයා | සමාන | සමානයා | සහකාර | සහකාරයා | හවුල්කාරයා
fellowe=වක් අත්ත
fellowship=අධිශිෂ්‍යත්ව | අධිශිෂ්‍යත්වය | මිත්‍රත්වය | සංඝය | සභාධ්‍යායත්වය | සමූහය | සහායත්වය
felly=රෝදයක වක් අත්ත | වක් අත්ත
felon=දුෂ්ටයා | බරපතල අපරාධකාරයා
felonious=දුෂ්ට
felony=ආතපාපරාධය | පෙලනීය | බරපතල අපරාධය | සාහසික අපරාධය
felspar=ඛනිජයක් | පෙල් ස්පාර් | පෙල්ස්පාර්
felt=තහඩු ලොම් | තහඩු ලෝම | පෙල්ට් | ලොම් රෙදි විශේෂයක්
felted=ජටිත
felting=තහඩ ලෝම සෑදීම | තහඩු ලොම් සෑදීම | තහඩු ලෝම | පෙල්ට් ඇතිරිය
felucca=කුඩා නැවක්
fem.lady=උත්තමාව
female=ගැහැණිය | ගැහැණු | ගැහැනු | ගෑණු | ගෑණු සතා | ගෑනු | ජායා | ජායාංගී | බවලතා | ස්ත්‍රි | ස්ත්‍රී | ස්ත්‍රීලිංගික
female-crow=කැවිඩිය
feminine=කෝමල | ගැහැණු | ලලිත | ස්ත්‍රී | ස්ත්‍රීන් පිළිබඳ
femininity=ස්ත්‍රීභාවය
feminism=කාන්තා සම අයිතිය | ස්ත්‍රි වාදය
feminist=එබඳු මත දරන්නා
femoral=ඌර්වීය
femur=ඌර්වස්ථීය | ඌර්විකය | කලවා ඇටය
fen=අනුපය | ගොහොරු බිම | වගුර | හැල
fence=ආවරණය | කඩු හරඹ කරනවා | කඩු හරඹය | කොටු කරනවා | පර්ක්ෂේපය | ප්‍රාවරය | යොමුව | වැට | වැටකින් ආවරණය කරනවා
fencing=කඩු හරඹය | වැට | වැට බැඳීමේ උපකරණ
fend=ආරක්ෂාව සලසාගන්නවා
fender=ලිප් ආවරණය | වලක්නය | වේග වලක්වනය
fenestra=ගවාක්ෂය
fenestrate=ගවාක්ෂීය
fenestrated=ගවාක්ෂීය
fennel=මහදුරු | රට ඈඳුරු
fenugreek=උලුහාල් | උළුහාල්
feoff=පියොපිය බුක්තිය
feoffee=බුත්තිලාභියා
feoffment=බුත්තිය දීම
feral=නොහික්මුණු | ප්‍රචණ්ඩ
ferery=මීවන ආදිය විශේෂයෙන් වවන ස්ථානය
ferm=මිවන
ferment=ඇවිස්සෙනවා | එන්සයිම | කිණ්වය | කින්වය | තවනවා | පැසවන ද්‍රව්‍යය | පැසෙනවා | බීජය | මද්‍ය බවට හැරෙනවා | මහත් කලබලය | මුහුන් | රා වෙනවා | සංක්ෂෝභය
fermentation=පැසවීම | පැසීම | පිපීම | මද්‍යු බවට හැරීම | මහත් කලබලය
fermium=කෘත්‍රිම විකිරණශීලි මූලද්‍රව්‍යයක්
fern=පර්ණාංග | මීවන | වැරැල්ල | හීන් පඹ
ferns=පර්ණංග | මීමන
ferocious=චණ්ඩ | දරුණු | බිහිසුණු | රුදුරු | රෞද්‍ර
ferocity=රෞද්‍රභාවය
ferrate=ලෝහ මිශ්‍ර
ferret=උත්සාහයෙන් එළිදරව් කර ගන්නවා | මුගටි වර්ගයක්
ferric=ලෝහ මිශ්‍ර
ferrimagnetism=පෙරිචුම්බකත්වය
ferrite=පෙරයිට්
ferro-chromium=පෙරෝක්‍රෝමියම්
ferro-vanadium=පෙරෝවැනේඩියම්
ferrobactcria=පෙරොබැක්ටීරියා
ferroconcrete=දැඩියම් කළ කොන්ක්‍රීට් | යකඩ කොන්ක්‍රීට්
ferrocrete=පෙරෝක්‍රීට්
ferroelectric=පෙරෝවිද්‍යුත්
ferromagnetic=පෙරෝචුම්බක
ferromagnetism=අයශ්චුම්බකත්වය | පෙරෝචුම්බකත්වය
ferrous=ලෝහ මිශ්‍ර
ferrugineous=යමලවන්
ferruginous=යමලවන් | යමුසු
ferrule=විල්ල
ferry=ගංතොට | තොට | තොටින් එගොඩ කරනවා | තොටු පොළ | තොටුපළ | තොටුපොළ | තොටුපොළේ අඟුල | තොටුපොළේ ඔරුව | පාරුපාලම | පාලම් පාරුව
ferry-tax=නදී සුංක
ferryman=තොටියා
fertile=ඵලවත් | ශූර | සඵල | සරු | සශ්‍රීක | සාර | සාරවත්
fertilisation=සංසේචනය
fertilise=සරු කරනවා
fertiliser=පොහොර | පෝර | සාරදය
fertilisers=පෝර | පෝර ද්‍රව්‍ය
fertility=ජනක ශක්තිය | දරුපල | දරුඵල | සරුකම | සරුබව | සරුභාවය | සරුව | සශ්‍රීකත්වය | සාඵල්‍යතාව | සාඵල්‍යය | සාරත්වය
fertilization=ගැබ්ගැන්වීම | පෝර යෙදීම | සංසේචනය
fertilize=පල දරන්ට සලසනවා | සඵල කරනවා | සාරවත් කරනවා
fertilizer=පෝර
fertilizers=රසායනික පෝර
ferule=පැතලි කෝදුව
fervent=ඉතා උනන්දු | ඉතා ළැදි | උද්‍යෝගී | ජ්වලිත
fervid=අතිශය වේගවත් | ඉතා උණුසුම් | උද්යෝගයෙන් ජ්වලිත වූ
fervour=බලවත් ළැදිකම | මහත් උනන්දුව
fesciculatum=කටුකිතුල්
festal=උත්සවයක් පිළිබඳ වූ | ප්‍රීති සහගත | මංගල්‍ය | මංගල්‍යයක් පිළිබඳ වූ
fester=පැසවනවා | පැහැවනවා | විකට නළුවා | සැරව බවට හැරෙනවා
festival=උත්සව දිනය | උත්සවය | උළෙල | ජයන්තිය | පූජෝත්සවය | මංගල්‍යය | මහෝත්සවය | මේලාව | සැණ | සැණකෙළිපොල | සැණකෙළිය | සැණය
festive=ප්‍රීතිමත් | මංගල්‍ය
festivity=උත්සවය | උත්සවශ්‍රීය | ප්‍රමුදිතභාවය
festoon=මල්වැල | මාලා කර්මයෙන් සරසවනවා | මාලාව | ලතා කර්මයෙන් සරසවනවා | ලතාකර්ම | ලතාව | ලියවැල | වක්‍ර රේඛා මෝස්තරය
festoons=දූපත් වැල
festschrift=උපහාර ග්‍රන්ථය
fesult=පල
fetch=එක්ක එනවා | එක්ක යනවා | කැඳවාගෙන එනවා | ගොස් ගෙනෙනවා | දිය එළිය | දියෙල්ල | පමුණුවනවා
fetching=සිත්ගන්නා
fete=උත්සව දිනය | උත්සව පවත්වනවා | උත්සවය | මංගල්‍යය | සංග්‍රහ කරනවා
fetid=කුණු වූ | දුගඳ | දුගඳ හමන
fetish=අප්‍රාණික පූජා වස්තුව | අර්චනකය | පූජා ලාංඡනය | මෝඩ භක්තිය
fetishism=අර්චණකාමය | අර්චන කාමය | අර්චනක්‍රමය | පෙතිෂවාදය
fetter=බාධා කරනවා | බාධාව | විලංගු ලනවා | විලංගුව | සංයෝජනය | හැකිල්ල | හැකිලි
fetters=පාදම
fettle=අවස්ථාව | තත්ත්වය | පාහිනවා | මටනය | සූදානම
fettling=අහුකොන් කැම | වාත්තු අහුකොන් කැම
fetus=ගර්භය | ගැබෙහි වූ දරුවා | භ්‍රෑණය
feu=අවුරුදු පතා බදු ගෙවන ඉඩම
feud=ආරාවුල | උපනාහය | ප්‍රවේණිය | වෛරය | හබය
feudal=වැඩවසම් | වැඩවසම් ක්‍රමයට අයත්
feudalism=වැඩවසම් ක්‍රමය
feudatory=අනුව ප්‍රවේණියක් භුක්තිවිඳන
feudoloid=සමන්තාහ
fever=ඇවිස්සීම | උණ | ජ්වරය | දාහය | විදාහ | හුණ
fevered=ඇවිස්සුණු | උණ සහිත | මහත් කලබල සහිත
feverfew=පැලෑටියක්
feverish=ඇවිස්සුණු | උණ සහිත | මහත් කලබල සහිත
few=ඇතැම් | කීප | ටික දෙනෙක් | ස්වල්ප
fewness=අල්පභාවය
fey=අමුතු | පුදුම
fez=තුර්කි තොප්පිය
fiance=ආදරවන්තයා | විවාහ ගිවිසගත් තැනැත්තා
fiancee=ආදරවන්තීය | විවාහ ගිවිසගත් තැනැත්තිය
fiard=පියාඩය | පියෝඩය
fiasco=බොරුව
fiat=ආඥප්තිය | ආඥාව | ඇණැවුම | නියෝගය | භවතුව
fib=බොරු කියනවා | මුසාවාදය
fibre=කෙන්ද | කෙඳි | කොස්ස | තත | තන්තු | තන්තුව | පට්ටය | ස්වභාවය
fibreboard=තන්තු පුවරුව
fibreglass=කෙඳි වීදුරුව
fibres=කෙඳි | කෙඳි
fibril=කුඩා සිහින් තන්තු | කෙඳිත්ත | තන්තුකය | තන්තුකාව
fibroid=තන්ත්වාභ | තන්තුමය
fibrose=තන්ත්වීකරණය
fibrosis=කන්තුමනාව | තන්තුමතාව
fibrositis=රක්තවාතය නිසා ඉදිමීම
fibrous=කෙඳි | තන්තු | තන්තුමය | සූත්‍රල
fibula=කුඩුපය | කෙණ්ඩයේ කුඩා ඇටය
fickle=අස්ථිර | චපල | ජොහොරු
fickleness=චපලත්වය
fiction=අන්දරය | කල්පිත රචනාව | කල්පිතය | පරිකල්පිතය | ප්‍රබන්ධ කථාව | ප්‍රබන්ධකථාව | ප්‍රබන්ධය | මුසාවාදය | සම්මුතිසත්‍යය
fictionism=ප්‍රබන්ධවාදය
fictitious=අභූත | අසත්‍ය | කල්පිත | කල්පිත ප්‍රබන්ධ | බොරු | මිත්‍යා | ව්‍යාජ
ficusing=නාභිගත කරන | නාභිගාමක
fiddle=රවුකිඤ්ඤ ආදිය වයනවා | රවුකිඤ්ඤ ගහනවා | රවුකිඤ්ඤය | වීනාව | සාරංගිය
fiddlestick=ලටපට
fiddlesticks=වීණාවාදකයා
fiddling=වැදගැම්මකට නැති | වීණා වාදනය
fideicommissary=වීදකොමිස් ලාභියා
fideicommissum=වීදකොමිසය
fideism=භක්තිවාදය
fidelity=අනුකූලතාව | නිවැරදි බව | පතීවෘතාව | භක්තිය | විශ්වාසකම | විශ්වාසත්වය | විශ්‍රබ්ධතාව | සත්‍යතාව | සතිත්වය | සරදය
fides=භක්තිය
fidget=දඟලනවා | නොසන්සුන් බව දක්වනවා
fidgety=අශාන්ත | නොසන්සුන්
fiducia=විශ්වස්තය
fiducial=උද්දේශ්‍ය
fiduciary=භාරකාරයා | විශ්වස්තයා | විශ්වාසය පිට රඳා පවත්නා | වීදකොමිස් භාරකරු
fie=චී | වහ්
fief=නින්දගම | නිලකාර ප්‍රවේණිය | වැඩවසම්
field=ක්ෂේත්‍රය | කුඹුර | කෙත | ගෝචර | ගෝචරස්ථානය | පන්දු රකිනවා | පාටීරය | පිට්ටනිය | පිටිය | භූමිය | ලියද්ද | විෂය | වෙල | වෙල්
field-glass=බිහිදක්නය
field-intensity=ක්ෂේත්‍ර තීව්‍රතාව
fiend=යක්ෂයා | රාක්ෂයකු වැනි තැනැත්තා | රාක්ෂසයා
fiendish=ඉතා දරුණු
fierce=උග්‍ර | ඔළ | ඔළමොළ | ක්‍රෑර | චණ්ඩ | දරුණු | පරොස් | ප්‍රචණ්ඩ | බිහිසුණු | භීම | මොළ | රුදු | රෞද්‍ර | වාල | සකුළු | සැඩ | සැඩ | සැඩපරුෂ | සැහැසි
fiery=උග්‍ර | කිපෙනසුලු | ගිනි වැනි | දැවෙන | සැර
fiesta=උත්සවය | නිවාඩුව | සැනකෙලිය
fife=කුඩා නළාව | හොරණෑව
fifferently=වෙනම
fifo=පෙපිපෙනි | පෙර පිවිසි පෙර නිකුත් | පෙරැතුළු පෙර පිට
fifteen=පසළොස | පහළොව | පහළොහ | පාළොහ
fifteenth=පහළොස්වෙනි
fifth=පඤ්චම | පස්වෙනි
fiftieth=පනස් වෙනි
fifty=පණහ | පනහ
fig=අත්තික්කා | දිඹුල්
figenfunction=අයිගන් ශ්‍රිතය
fight=ඇනකොටා ගන්නවා | ඇර ගන්නවා | කලහය | කාවැටෙනවා | කොලහල | කෝලාහලය | ගහගන්නවා | ගිනිකෙළිය | ඝට්ටනය | ඩබරය | ඩාමරය | දබරය | ධෛර්යය | පොර අල්ලනවා | පොර බදනවා | පොරකනවා | පොරය | සටන | සටන් කරනවා | සටනෙහි යෙදූ | හටන
fighter=සටන්කරන්නා
fighting=කලහකාර | කලහකාරි | රණ්ඩුසරුවල්
figment=කල්පනාමාත්‍රය | මිත්‍යා කථාව
figurative=උපමා අලංකාර සහිත | රූපික | සාලංකාර
figure=අංකය | ඉදිරිපත් වෙනවා | ඉලක්කම | ඉලක්කම් ලියනවා | ගණන් ලියනවා | තැනැත්තා | දර්ශනය | දේහය | පෙනී සිටිනවා | පෙනුම | මිල | රුව | රූ | රූප | රූපය | රූපසටහන | විසිතුරු කරනවා | සංඛ්‍යාංකය | සංඛ්‍යාව | සටහනින් දක්වනවා | සණ්ඨානය | සිතා ගන්නවා | සිතියම් කරනවා | හැඩය
figure-ground=රූප භූමිය
figured=විවත්‍ර
figures=සංඛ්‍යා
figurine=කුඩා ප්‍රතිමාව | රූපිකාව | රූසිඟිත්ත
filamentous=සූත්‍රිකාමය
filaria=පයිලේරියාව | බරවා උණ | බරවා රෝගය
filariasis=ශ්ලීපද
filbert=ගෙඩි හටගන්නා ගසක්
filch=සොරකම් කරනවා
file=ගොනු ගත කරනවා | ගොනුව | නඩු කොපිය | නාම වට්ටෝරුව | පිහිර | පිළිවෙළට අමුණනවා | පීර | පීරිගානවා | පෙළගැසී යනවා | ලිපි ගොනුව | ලිපිගොනුව | ශ්‍රේණිය
filial=දරු | දරුවකු පිළිබඳ | දාරක | පුත්‍ර | පෞත්‍ර
filiation=දරුකමට බාරගැනීම | දාරක බන්ධනය | පූත්‍රීකරණය
filibuster=බාධා කරනවා | බාධා කරන්නා | සටන් කරන්නා
filicinean=පර්ණාංගී
filicineous=පර්ණාංගී
filiform=සුත්‍රාකාර | සූත්‍රාකාර | සූත්‍රිකාකාර
filigree=විසිතුරු රන් රිදී වැඩ
filing=ගොනු කිරීම | පිරී ගෑම | පීරි ගෑ කුඩු | පීරි ගෑම
filings=පීරි කුඩු | පීරිකුඩු
filioque=පීතෘපුත්‍රජ
filipino=පිලිපීනයේ වැසියා
fill=තෘප්තියට පමුණුවනවා | පිරවුම | පිරෙනවා | පුරවනවා | සම්පූර්ණ කරනවා | සම්පූර්ණ ප්‍රමාණය | සම්පූර්ණයෙන් වසා සිටිනවා
filler=පිරවුම | පිරවුම් ද්‍රව්‍යය | පිරැවුම් ද්‍රව්‍යය | පුරවනය
fillet=කැබලි කොට කපනවා | තුනී පටිය | පටියකින් බඳිනවා | පිරිපටිය | සිරස්පටිය
filling=පිරවීම | පිරවීමට යොදන දේ | පිරවුම | සක්ක
fillip=නියපොතු පහර | පෙළඹවීම
filly=තරුණ වෙළඹ
film=තුනී ආලේපය | පටය | පටලය | විත්‍රපට | චිත්‍රපටය | චිත්‍රපටිය | චිත්‍රපටියට ගන්නවා | සේයාරුව | හීන් පටලයකින් වැසෙනවා | හීන් සිවිය | හීන් සිවියකින් වසනවා
film-goer=සිනමාගාමියා
film-script=තිරනාටකය
filmfan=සිනමා ලෝලයා
filmstrip=චිත්‍රපට ඛණ්ඩය | චිත්‍රපට තීරුව | චිත්‍රපටිකාව
filmy=පටලාකාර | පටලින් වැසුණු
filter=පිල්ටරය | පෙරන යන්ත්‍රය | පෙරනය | පෙරනවා | පෙරහන | පෙරෙනවා
filterability=පරිශ්‍රාව්‍යතාව
filterable=පෙරෙන
filtering=පෙරීම
filth=අපවිත්‍ර දේ | අශික්ෂිත දේ | කැලිකසළ
filthiness=අපවිත්‍ර වීම | කැතකම
filthy=අපවිත්‍ර | කැත
filtrate=පෙරනය
filtration=පරිශ්‍රවණය | පෙරීම
fimbria=කඩරැල්ල
fimbriate=කඩරැළි | කඩරැළි සහිත
fimbricate=කඩරැළි
fimbrillate=කඩරැළිති
fimbrilliferous=කඩරැළිති
fin=මාළුවාගේ වරල | වරල | වල්පත
finagle=යමක් කපටිකමින් ලබාගන්නවා
final=අන්ත | අන්තිම | අවසාන | අවසානය | සුනිශ්වත
finale=අවසාන භාගය | සමාප්ති භාගය | සමාප්තිය
finalism=නිෂ්ටාවාදය | නිෂ්ඨා වාදය | නිෂ්ඨාවාදය
finality=අවසානතාව | නිමාව | නිෂ්ටාව | නිෂ්ඨාව | පරිසමාප්තිය
finally=අවසාන වශයෙන්
finance=මුදල් | මුදල් පාලනය | මුල්‍ය | මූල්‍ය | මූල්‍යය | වියදම් කරනවා | වුවමනා මුදල් සපයනවා
finances=මුදල් | මුදල් තත්ත්වය
financial=මුදල් පිළිබඳ | මූල්‍ය
financier=ධනපතියා | ධනාධිකාරී | මුදල් යොදන්නා | මූල්‍ය සම්පාදක
financing=මුදල් යෙදවීම
finch=කුඩා පක්ෂි වර්ගයක්
find=දැන ගන්නවා | දැනෙනවා | නිශ්චය කරනවා | පෙනෙනවා | ලබා ගන්නවා | ලැබෙනවා | සපයනවා | සම්බ වූ දෙය | සම්බ වෙනවා | සම්භ වෙනවා | සොයා ගන්නවා | සොයා ගැනීම | හම්බ වෙනවා
finder=සෙවීමේ උපකරණය | සොයන්නා
finding=අධිගමනය
fine=අලංකාර | කදිම | තුනී | දඩ | දඩ ගසනවා | දඩගැසීම | දඩමුඩය | දඩමුදල | දඩය | පිරිසුදු | පිරිසුදු කරනවා | මාහැඟි | යස | ලලිත | ලිත | ශෝභන | සණ්හ | සිනිදු | සියුම් | සියුම් ලෙස | සිහින් | සුකුමාර
fineness=පිරිසුදුකම | විශිෂ්ටත්වය | සිනිඳුකම | සියුම | සියුම් බව | සියුම්බව | සුඛුමතාව
finery=අලංකාර ඇඳුම් පැළඳුම් | සියුමාලය
finesse=තීක්ෂ්ණ උපාය | සියුම් දක්ෂකම
finger=ඇඟිල්ල | ඇඟිල්ල වැනි දේ | ඇඟිලි ගහනවා | ඇඟිලිවලින් අල්ලනවා | ඇඟිලිවලින් තට්ටු කරනවා
finger-print=ඇඟිලි සටහන
fingered=ආංගුලික
fingering=අත ගෑම
finial=කොතග | කොත් කැරැල්ල | ප්‍රාසාද කැටය
finical=දුරාරාධ | ලෙහෙසියෙන් සතුටු නොකළැකි
finicking=දුරාරාධ | ලෙහෙසියෙන් සතුටු නොකළැකි
fining=තීන්දුව
finis=අවසානය | නිමි
finish=අවසාන කරනවා | අවසාන වෙනවා | අවසානය | අහවර කරනවා | ඉවර කරනවා | ඉවර වෙනවා | කම්මුතු කරනවා | කා දමනවා | තොර කරනවා | නමහම | නිම | නිමහම | නිමාව | නිමැවුම | නිෂ්ඨාව | ශෝභනත්වය | සම්පූර්ණ කරනවා | සම්පූර්ණ වෙනවා | සම්පූර්ණත්වය | හමාර කරනවා
finished=ඉවර | කම්මුතු | නිමාවට පැමිණි | නිමි | සකලාංගසම්පූර්ණ | සුං
finisher=නිමකුරුව
finishing=නිමහම | නිමා කිරීම | නිමාම් කිරීම
finite=අවසාන | නියත | නිරූපිත | පරිච්ඡින්න | පරිමිත | සීමා කරන ලද | සීමිත
finitism=පරිමිතවාදය
finn=පින්ලන්ත වැසියා
finnan=මාළු වර්ගයක්
fins=වරල්
fiord=කඳු අතරෙහි වූ පටු කලපුව | පියාඩය | පියෝඩය
fiords=කඩතොලු
fipple=සංගීත භාණ්ඩයක කුංචකය අසලින් තත පිරිමැදීම
fir=දේවදාර | පර් දැව
fire=අනල | උනන්දු කරනවා | කේතු | ගින්දර | ගින්න | ගිනි | ගිනි අවුලුවනවා | ගිනිගොඩ | තෙද | තේජස | තේජෝ | දල | දල්වනවා | දවනවා | දීප්තිය | නල | පත්තු කරනවා | පත්තු වෙනවා | පාවක | පුළුස්සනවා | බලවත් උනන්දුව | බලවත් වේගය | බානු | මොළවනවා | රස්සාවෙන් අස් කරනවා | වහ්නි | වෙඩි තබනවා | වෙඩි තැබීම | වෙඩිතියනවා | වේලනවා | හතැස් | හූතාසන
fire-arms=ගිනි අවි
fire-brand=අලාතය | එළිඅත්ත | ගිනි පෙනෙල්ල | පෙණෙල්ල
fire-cracker=රතිඤ්ඤ
fire-extinguisher=ගිනි නිවනය
fire-fly=කණමැදිරියා | කණාමැදිරියා | කළාමැදිරියා | ඛජ්ජෝත
fire-god=හතැස් | හූතාසන
fire-man=ගිනි නිවන භටයා
fire-proof=ගිනිවරන
fire-wood=දර
fire-works=ගිනිකෙළිය
firearm=ගිනි අවි | තුවක්කු | තුවක්කුව | පිස්තෝලය
firebrand=උල්කා
firebrick=ගිනි ගඩොල | ගිනිගඩොල
fireclay=ගිනි මැටි
firedamp=පතල් වායුව | මෙතේන්
firefly=ඉන්ද්‍රගෝප | ඉන්ද්‍රගෝපක | කදෝ | කදෝකිමි | කදෝපැණි | කලාමැදිරියා
fireguard=ගිනි ගැන සෝදිසියෙන් සිටින්නා | ලිප ඉදිරියෙහි පිහිටි ආවරණය
fireman=ගිනි නිවන භටයා | ගිනි නිවන්නා | ගිනිකෙළිකාරයා
firepolishing=ගිනි මට්ටම් කිරීම
fireproof=ගිනිවරණ
fireship=ගිනි නැව
fireside=ගිනි ගොඩ වටේ | ගෙදර
firewood=දර
fireworks=ගිනි කෙළි | මල්වෙඩි
fireworship=හෝමය
firing=ඇවිලීම | ගිනි තැබීම | දර | දල්වන | පිලිස්සීම | බිම් අඟුරු | වෙඩි තැබීම
firkin=කුඩා පීප්පය
firm=අවල | කඨින | කඨෝර | ඝන | තහවුරු | තාදි | තැන්පත් | තිර | තිරසර | දැඩි | නිසල | ව්‍යාපාර ආයතනය | ව්‍යාපාරය | ව්‍යාපාරික ආයතනය | වෙඩි වගේ | වෙනස් නොකළැකි | වෙළඳ සමාගම | සනාතන | සමාගම | සවි | සවිමත් | ස්ථායි | ස්ථාවර | ස්ථිර
firmament=අන්තරීක්ෂය | අහස
firmer=තිරතර
firmly=ඝනව | දැඩිව | ස්ථිර ලෙස
firmness=ඝන බව | දැඩි බව | ස්ථාවර බව
firmware=ස්ථීරාංග
firn=නේවේ හිම කැට
first=අග්‍ර | ආදි | ඉතා වේලාසනින් පැමිණි | එක්වැනි | පළමු | පළමුව | ප්‍රථම | ප්‍රධාන | මුඛ්‍ය | මුල | මුල් | මුල් අදිනවා | හැමට කලින්
first-aid=ප්‍රථමාධාර
firstling=කුලුඳුල් මෘගයා
firth=ප්‍රිත් | පුනීල මෝය | විශාල මෝය | සමුද්‍රවංකය
fiscal=කෝෂීය | පිසිකල් | පොදු දේපලට අයත් | පිස්කල් නිලධාරියා
fiscus=කෝෂය
fish=කූරියා | පිළි | පිළී | බිලීබානවා | මත්ස්‍ය | මත්ස්‍යයා | මස් | මස්ටකයා | මාලු | මාළු | මාළු අල්ලනවා | මාළු බානවා | මාළු සඳහා යොදන | මාළුවා | මාළුවා ගේ ශරීරමාංශය | මින් | මීන
fish-eater=මත්ස්‍ය භක්ෂකයා
fish-hook=බිලීකොක්ක
fish-market=ලෙල්ලම
fish-pot=කරක්
fisher=ධීවරයා | මස් මරන්නා
fisheries=ධීවර
fisherman=ධීවරයා | මස් මරන්නා | මාළුකාරයා
fishery=ධිවර අයිතිය | ධීවර කර්මාන්තය | මසුන් අල්ලන ස්ථානය | මාළු බිම
fishing=පතුරු මූට්ටු ලෑම | මසුන් ඇල්ලීම
fishy=මාළුවකු වැනි
fissile=භිදුර | ලෙහෙසියෙන් පැලෙන | විඛණ්ඩ්‍ය
fission=පැළීම | පිපිරීම | විඛණ්ඩනය
fissionable=විඛණ්ඩ්‍ය
fissiparous=විඛණ්ඩනශිල
fissure=කැඩුම | ගැඹුරු විවරය | ඡිද්‍රය | දැදුර | දැදුරු | පාටිතය | පැල්ලම | විවරය | සිදුර
fist=අත් අකුරු | මිට | මිට මොළවනවා | මිටින් පහර දෙනවා | මුෂ්ටිය
fisticuff=ගුටිය
fisticuffs=ගහගැනීම | ගුටි බැට
fistula=ඔඩු සහිත වණය | පිස්ටියුලාව | බගංදරාව | සානිකාව
fistular=නාලාකාර | සනාල
fistulose=නාලාකාර | සනාල
fit=අනුච්ඡවික | අනුසීහුම | ආක්ෂේපය | ආකාරය | උචිත | ඔබිනවා | ඖවත්‍ය | ක්ෂම | ගළපනවා | ගැස්ම | ගැහීම | නිරෝගී | නිසි | පුහුණුව සිටින | මූර්ඡාව | යොදනවා | යෝග්‍ය | යෝග්‍ය වෙනවා | වද්දනවා | සවි කරනවා | සෑහෙන | සෑහෙනවා | සීහෙනවා | සුදුසු | සූදානම් කරනවා | හදිසි උනන්දුව | හරිගස්සනවා | හරියනවා | හැඩය | හේත්තු කරනවා | හේත්තු වෙනවා | හේත්තුව | හේතුව | හොඳින් සූදානම්ව සිටින
fitful=අස්ථිර | ඉඳහිට ඇති වන
fitment=උපකරණ | ගෘහ භාණ්ඩ
fitness=ඖවත්‍යය | යෝග්‍යතාව | සුදුසුකම
fitout=ඇඳුම් ආදී අවශ්‍ය දේ
fitter=වැද්දුම්කරු | සවිකරුවා
fitting=අනුකූල | අනුසීහවීම | අනුසීහුම | පිරිවැද්දුම | යෝග්‍ය | සජ්ජනය | සුදුසු | හේත්තු මිටියම් වැද්දීම | හේත්තු වැද්දීම
fittings=උපකරණ | උපමෙවලම් | මෙවලම් | සවිකුරු
five=පංච | පඤ්ච | පස | පහ
five-storied=පස මහල්
fivefold=පඤ්චවිධ
fiver=පවුම් පහේ නෝට්ටුව
fives=අත්පන්දු ක්‍රීඩා විශේෂයක්
fix=තහවුරු කරනවා | තහවුරු වෙනවා | තිර කරනවා | නියම කරනවා | පටලැවිල්ල | ප්‍රතිෂ්ඨාපනය කිරීම | යොමු කරනවා | සවි කරනවා | සවි වෙනවා | හමුව
fix.=අල්ලනවා | ස්ථාපනය
fixate=ප්‍රතිෂ්ඨාපනය කිරීම
fixation=ඔල්මාදය | තහවුරු කිරීම | තිර කිරීම | තිරවුම | පටක තිර කිරීම | පතිෂ්ඨාපනය | ප්‍රතිබද්ධය | ප්‍රතිෂ්ඨාපනය | ප්‍රයෝජ්‍ය කිරීම | ප්‍රයෝජ්‍යකරණය | සවි කිරීම | සවි වීම | ස්ථාපනය කිරීම
fixation-point=ප්‍රතිෂ්ඨාපන ලක්ෂ්‍යය
fixative=තිරකාරකය | තිරකුරුව | මැලියම් | වලිච්වය
fixed=අචල | තිර | නියම | නිහිත | වෙනස් නොවන | සවි | ස්ථාපිත | ස්ථාවර | ස්ථිර | ස්ථීර
fixedly=නොසෙල්වී
fixer=කිරකුරුව | තිරකුරුව
fixing=කලම්ප | තිර කිරීම
fixity=සන්තත්‍යය | ස්ථාවරභාවය
fixture=තිරවුර | නියමිත කටයුත්ත | පිඩිය | සවිකර මල | සවිකුරුව
fixtures=තිරවුරු
fizz=සිරි සිරි ගෑම
fizzle=නිෂ්ඵල වෙනවා
fizzy=සිරි සිරි හඬ සහිත
fjord=කඳු අතරෙහි වූ පටු කලපුව
flabbergasted=අන්දුන් කුන්දුන් වූ
flabbiness=අධික සේ තරකම
flabby=සවි නැති
flabellate=විනි හැඩ
flabelliform=විනි හැඩ
flaccid=වෑරුණු | විශුන | ශිථීල
flag=එල්ලා වැටෙනවා | කොඩිය | කොඩිවලින් යමක් දැනුම් දෙනවා | කොඩිවලින් සරසනවා | දද | ධජ | ධජය | ධ්වජය | පන් වර්ගයක් | පසු බසිනවා | මැලවෙනවා
flag-pole=කොඩිගස
flagallata=ප්ලෙගාලාටා
flagellae=කශිකා
flagellant=කශිකාධරයා
flagellata=ප්ලගෙලාටා
flagellate=ආන්ත්‍රික කශිකාධරයා | ඉපලෙන් තළනවා | කශිකාධර | කශිකාධරයා | කසෙන් තළනවා
flagellation=තාඩනය | තැළීම
flagelliform=කශිකාකාර
flagellum=කශිකාව | දිගට වැඩෙන ලතාව
flageolet=දෙවිවර බටනලාව
flagging=ක්‍රමයෙන් හීන වන
flagitious=දරුණු | සාහසික
flagon=ගුරුලේත්තුව
flagrant=අතිශයින් නින්දිත | දරුණු | බරපතල | බියසැක නැති
flagstaff=කොඩිගස
flagstone=පැතැලි ගල්කැටය
flail=කසය
flair=විචක්ෂණභාවය | සහජ දක්ෂතාවය
flak=සතුරු අහස් යාත්‍රාවලට වෙඩි තබන තුවක්කු
flake=පතුර | පතුරු යනවා | පෙත්ත | ලවය
flaky=කොරපොතු සහිත | පතුරු සහිත | පෙති වැනි | පෙති හැඩ | පොතු වැනි
flam=බොරු ප්‍රවෘත්තිය | රැවටිල්ල
flambeau=ගිනිසුළ | ගිනිහුල | පන්දම
flambeaux=පන්දම්
flamboyant=අතිවිවත්‍ර | චිත්තාකර්ෂණීය
flame=අග්නිජාලාව | අධික කෝපය | අධික රාගය | අවුළනවා | ඇවිළෙනවා | ගිනි දැල්ල | ගිනිදැල්ල | ජ්වාලය | ජාලාව | දැල්ල | දැල්වෙනවා | දීප්තිය | ශිඛා | ශිඛි | සිඛාව | සිඛි | සිළු | සුන්දරී
flame-coloured=ගිනිපැහැ
flamenco=ස්පාඤ්ඤ ගැමි සංගීතය
flaming=අතිශය වර්ණවත් | ඉතා වේගවත් | ජ්වලිත | දීප්තිමත් | රක්තවර්ණ
flamingo=රණහංසයා
flamingoes=රණහංසයෝ
flammable=දැවෙනසුළු | වාලීය
flan=කෑම වර්ගයක්
flange=දාරය | නෙරිගැටිය | පලංඡිය | පලංජීය | පලංය | පලන්‍ය
flanging=නෙරිගැටියම
flangs=පලං
flank=අංශය | අංශයෙහි පිහිටා තිබෙනවා | ඇන්ද | ඇලපත | නෙත්තිය | පැත්ත | පැත්තකින් පහර දෙනවා | පැත්තකින් යනවා
flanks=ඇළපත් | දැළ
flannel=ප්ලැනල් | පැනෙල් | සිහින් කම්බිලි
flannelette=ප්ලැනලට් | රෙදි වර්ගයක්
flap=එල්ලෙනවා | පත්ත | පියන | පෙත්ත | වැදෙනවා | වැනෙනවා | හැපෙනවා
flapjack=කුඩා වෙල්ලවැහුම
flapper=ගැටිස්සී | පත්ත
flare=අතිශයින් බබළනවා | ඇවිලෙනවා | ගිනිමැලය | තරහ ඇවිස්සෙනවා | දැල්වෙන පන්දම | පැතිරෙනවා | මහත් සේ පැතිරීම | ලෙළ සිළුව | ලෙළසිළුව | විලක්කුව | සැලෙන ගිනි දැල්ල
flash=ඇවිලෙනවා | ක්ෂණය | ක්ෂණික දීප්තිය | ගිනි පිට කරනවා | දීප්තිය පිට කරනවා | පතුරුවනවා | පැතිරෙනවා | බබළනවා | සැණෙළිය
flash-back=පශ්චාත් ලෝකනය | ප්‍රතිජ්චලනය | පිළි සැණෙලිය
flash-point=ජ්වලනාංකය
flashboard=යති පෝරුව
flasher=සැණෙලියනය
flashing=ජ්වලිත | දැල්වූ | පහරණය | සැණෙලි
flashover=පිටිසැණෙළිය | පිටිසැණෙළීම
flashy=ක්ෂණික දීප්තියක් ඇති | නිස්සාර | බාහිරාලංකාරයෙන් යුත්
flask=අරු පෙට්ටය | ප්ලාස්කුව | බෝතලය | ශරාව
flat=අත්තලය | අපතාරතාව | ඉඳුරා කියනු ලබන | එකහෙලාම | ඒකාන්ත | කොහු වෙනවා | කෝමල | තට්ටු ගෙය | තට්ටු නිවාසය | තලාව | තැන්න | තැනි | තැනිතලා | තුල් | නීරස | නීරස ලෙස | නොදිලිසෙන | පළල් පාරුව | පැතලි | පැතළි | පියානාවෙහි කළු කුංවකාව | පෙතලි | මට | මහල් නිවාසය | මාලකය | විශේෂ ලක්ෂණයක් නැති | සමතල | සමතලා | සිත් නොගන්නා | හරියටම
flatly=සමතලා ලෙස
flatness=පැතලි බව | සමතලා බව
flats=තලා | පැතලි යකඩ | පැතලි රූප
flatten=පැතැලි කිරීම | වේගය අඩු කරනවා | සමතලා කරනවා | සමතලා වෙනවා
flattening=පැතලි වීම
flatter=අධික ප්‍රශංසා කරනවා | අධික ප්‍රශංසා දක්වනවා | ආ වඩනවා | චාටු බස් කියනවා | බොරු ප්‍රශංසා කරනවා | බොරු ප්‍රශංසා දක්වනවා | මට්ටම් කටුව | රවටනවා
flatterer=ඉච්චාකාරයා
flattery=ඉච්චා බස | කයිවාරු | කයිවාරුව | චාටුව | පුරාජේරුව
flatulence=උදරාධ්මානය | ප්‍රාධ්මානය | බඩේ වාතය පිරවීම
flatulency=උදරාධ්මානය | බඩේ වාතය පිරවීම
flatulent=බඩේ වාතය පිරුණු
flatus=ප්‍රාධ්මාව
flatworm=පැතළි පණුවා
flaunt=අහංකාර ලෙසින් දක්වනවා | හැසිරෙනවා
flautist=නළාකාරයා
flavescent=පඬුපාටට හුරු
flavone=ප්ලේවෝන්
flavoprotein=ප්ලේවොප්‍රෝටීන්
flavour=ආස්වාදය | පුසුඹ | රස කරනවා | රස කවනවා | රසය | රුවය | වාසනය | විශේෂ ලක්ෂණය
flavouring=ස්වාදනය
flaw=කැලල | දෝෂය | පලුද්ද | වැරැද්ද
flawless=නිකැළැල් | නිර්දෝෂ
flaws=සංචරණ
flax=ප්ලැක්ස් හණ | බූගැටිය | හණ | හන
flaxen=හණ වැනි | හණවලින් සාදන ලද
flay=ගළවනවා | හම ගසනවා
flck=රොද
fld=රැල
fle=පීර
flea=බලු මැක්කා | මැක්කා | මැකි | මැකිණි | වැලි මැක්කා
fleabite=ඉතා සුළු පීඩාව | ඉතා සුළු මුදල | මැක්කා කළ තුවාළය
fleck=තිත | පුල්ලි කරනවා | පුල්ලිය | බින්දුව
fleckless=නිර්මල
flecnode=නතුගැටය
flection=ආනමනතාව | නැම්ම | නැමීම | වරනැඟීම
fledge=පිහාටු ඉඳෙනවා
fledgeling=අදක්ෂයා
fledgling=අදක්ෂයා
flee=පලායනවා | මඟහැර යනවා
fleece=අමු ලොම් | ලොම් කන්න | ලොම් කපාගන්නවා | ලොම් කැපීම | ලොම් වැනි දේ
fleecy=මෘදු | ලොම් වැනි | ලෝමශ
fleet=නාවික බළඇණිය | නැව් කණ්ඩායම | නොගැඹුරු | නොදැනී වේයෙන් යනවා | මූදු කඩතොල්ල | වේගවත් | ශීඝ්‍ර | සමුදාය
fleeting=අස්ථිර | ක්ෂණික | නොදැනී පලා යන
fleetness=වේගය
flesger=ගෝඝාතකයා
flesh=ආමිෂය | කය | පෘථග්ජන ගතිය | මංස | මස | මස් | මාංශ | මාංශය | මාංස | ලේ රසට පුරුදු කරනවා
fleshings=ඇඳුම් විශේෂය
fleshly=කාමුක | ලෞකික
fleshy=මස් සහිත | මාංසල | ස්ථූල
fleur-de-lis=ප්‍රංශයේ රාජ්‍ය සලකුණ
flew=ඉගිලුනා
flex=නතිවර්තන ලක්ෂ්‍යය | නමනවා | පහසුවෙන් නැමෙන කම්බිය | සුනම්‍ය කම්බිය | සුනම්‍යකය
flexibility=නම්‍යතාවය | සුනම්‍යතාව | සුනැමියාව
flexible=කර්මන්‍ය | නම්‍ය | පහසුවෙන් නැමිය හැකි | මුරණ්ඩු නොවූ | වෙනස් කළ හැකි | සුනම්‍ය | සුනැමි
flexile=අවනත වන | නම්‍ය
flexion=ආනමනතාව | නැම්ම | නැමීම | මිංජනය | වරනැඟීම | සම්මිංජනය
flexitime=සුඛනම්‍ය රාජකාරි වේලාවන්
flexor=සම්මිංජකය
flexouous=නැමුණු
flexture=නැම්ම
flexuose=නැමුණු
flexuous=චක්‍ර | වංගු සහිත
flexure=ආනමනය | නතිය | නැම්ම | නැමුණු බව | වංගුව | සම්මිංජය | සම්මිංය
flibbertigibbet=සපාදූප
flick=ගැහෙනවා | වෙවුලනවා | හදිසි සුළු පහර
flicker=චංචලනය | මන්දදීප්තිය | විටින් විට ඇවිලෙනවා | සෙලවෙමින් ඇවිලෙනවා
flier=අහස් නැවියා
flies=උඩස්ස
flight=ඉගිලීම | ඉගිලෙන දුර ප්‍රමාණය | ඉගිලෙන පක්ෂි රැළ | උත්කර්ෂය | උත්පතනය | පලා යාම | පියසැරිය | පියාසැරුම | වේගය | වේගවත් ගමන | සොල්දර පඩි පෙළ | සෝපාන පංක්තිය
flighty=චපල | හිතුබුද්ධියේ ක්‍රියා කරන
flimsy=ඉතා තුනී | නිස්සාර | ලෙහෙසියෙන් බිඳ වැටෙන
flinch=ඇකිළෙනවා
fling=ඇනුම්පදය | දමා ගසනවා | දමා ගැසීම | වේගවත් නැටුම | හිතුමතයේ සෙල්ලමෙහි යෙදීම
flint=අනුකම්පා රහිත තැනැත්තා | ඉතා තද | ගින්ගල් | ගිනිගල | ගිනිගල් | ගිනිගලින් සෑදූ | නපුරු | ප්ලින්ට්
flint-glass=ප්ලින්ට් වීදුරු
flip=හෙමින් උඩ ගසනවා | හෙමින් උඩ විසිකරනවා
flippancy=වාචාලකම
flippant=දොඩමලු | වාචාල | වැදගැම්මකට නැති
flirt=අඟර කරනවා | විලාස පානවා | විලාසිනී
flirt-girl=සකබමරේ
flirtation=අඟර කිරීම | චාපල්‍යය
flit=ඉගිලෙනවා
flitch=තරය | ලුණු ඌරුමස් පළුවක්
flitting=යුහුව ඔබමොබ හැසිරීම
fllower=ශ්‍රාවක
flmbeau=ගිනිහුළ
float=ඉපිල්ල | ඉපිලුම | ඉපිලෙනවා | ඉල්පෙනවා | කොල්ලෑව | චලය | තරණය | දියත් කරනවා | නොගිලී මතුපිට පවතිනවා | පහුර | ප්ලාවකය | ප්ලාවතය | පා කරනවා | පාකරනවා | පාරුව | පාවිය | පාවීම | පාවෙන දේ | පාවෙනවා
floatation=ඉපිලීම | ඉපිලුම | වෙළඳ ව්‍යාපාරයක් ආරම්භ කිරීම
floating=අනියම් | ඉපිලීම | ඉපිලෙන | චල | ප්ලව | ප්ලවන | පාවෙන | වෙනස් වන
flocculation=කැටියෑම | සම්පිණ්ඩනය
floccule=කැටිය
flocculent=පිහාටු වැනි | රොද සහිත | සම්පිණ්ඩ
flocculi=හිරුවලා
flock=ක්‍රිස්තියානි සභාවේ පිරිස | න | යූථ | රංචු ගැහෙනවා | රංචුව | රළ | රැළ | රොත්ත | ලොම් රොද | සමූහය
flocks=සුන්බුන් | සුන්බුන් කෙඳි
floe=පාවෙන අයිස් කුට්ටිය
flog=කෝටුමස් කරනවා | තළනවා | තැළෙනවා
flogging=තාඩනය
flood=ගංවතුර | ගැල්ම | ගිල්ම | ජලගැල්ම | ජලෝඝය | දිය ගලන්ට සලස්වනවා | දෙගොඩතළා යන වතුර | ධාරාව | ප්‍රවාහය | පිටාර | මහවතුරු | මහෝඝය | වඩදිය | වතුර | සගය | සඝය | හාත්පස පතුරුවනවා
floodplain=පිටාර තැන්න
floor=තට්ටුව | තලය | තැරැව් බිම | නිශ්ශබ්දව සිටීමට සලසනවා | පත්ල | බිම | බිම හෙළනවා | බිම්තලය | බුමු | බූමි | භූ | භූම | මහල
flooring=බිම සැකසීමට යොදන ද්‍රව්‍ය
floozie=ගැහැනිය | තරුණිය
flop=අමාරුවෙන් ඉඳ ගන්නවා | ලොකු වැටීම | වැටි වැටි යනවා | වැනි වැනී යනවා
flora=උද්භිද වර්ගය ශාක සංහතිය | තුරුලිය | පැළෑටි ලෝකය | වාක්ෂලතා | වෘක්ෂලතාදිය | වෘක්ෂලතාදිය පිළිබඳ විස්තරය | ශාක සංහතිය | ශෘක නිඝණ්ඩුව
floral=පුෂ්ප | මලින් කරන ලද | වෘක්ෂලතාදිය පිළිබඳ වූ
florentine=ඉතාලියේ ලොරන්ස් නගරයට අයිති
florescence=පුෂ්පෝද්ගමය | මල් හටගැනීම
floret=කුඩා මලක් | පුෂ්පිකාව
floribunda=රෝස වැනි ශාකයන්
floriculture=මල් වැවීම | මල්වගාව
florid=අත්‍යාලංකෘත
florigen=ප්ලොරිජන්
florin=සිලින් දෙකේ ඉංග්‍රීසි කාසිය
florist=මල් වවන්නා | මල් විකුණනන්නා | මල්කරු | මාලාකාරයා | මාලිකයා
floruit=වැජඹුණු කාලය
floss=නොඇඹරූ පට කෙඳි | සේද රොඩු
flossy=පට මෙන් සිනිඳු
flotation=ඉපිලුම
flotilla=කුඩා නැව් කණ්ඩායම
flotsam=ජලක්ෂේපය | විපතට පත් නැවකින් පාවී යන බඩු
flounce=අංග වික්ෂේපය | උද්දාමයෙන් එහා මෙහා යනවා
flounder=අමාරුවෙන් ක්‍රියා කරනවා | මත්ස්‍ය වර්ගයක්
flour=කුඩු කරන ලද්ද | චුර්ණය | පිටි | පිටි හලනවා | පිටිකොටනවා
flourine=ප්ලෝරින්
flourish=අලංකාරවත් අකුරු | භූෂණශෝභාව | මහත් තූර්යඝෝෂය | වැජඹෙනවා | සමෘජ වෙනවා
flourishing=විජෘම්භණය
flouroscein=ප්ලුවෝරෝසයින්
flourspar=ප්ලුවෝස්පාර්
floury=පිටි වැනි | පිටි සහිත
flout=අවඥාවෙන් සලකනවා | ගර්හා කරනවා | හෙළා දකිනවා
flow=උනනවා | ගලනවා | ගලා බසිනවා | ගලා යනවා | ගලායනවා | ගළනවා | ගැලීම | පබද | පහසුවෙන් නික්මෙනවා | ප්‍රවාහය | බැස යාම | මෙමෙනවා | රූරාබහිනවා | වඩදිය | වහනය | වහනය වෙනවා | වැක්කෙරනවා | වැගිරෙනවා | විපුලත්වය | සරණි | සිලියනවා
flowchart=ගැලීම් සටහන
flower=උත්කර්ෂයට පැමිණෙනවා | උතුම් කොටස | කුසුම | කුසුමය | පීදෙනවා | පුෂ්ප | පුෂ්පය | මල | මල් | මල් දරනවා
flower-bud=කුප්පිය | මල්කැකුළ
flower-honey=මල්පැණි
flower-pot=මල් පෝච්වය
flower-vase=මල් බඳුන
flowered=මලින් සැරසූ
flowery=අලංකාරයෙන් අනූන | කුසුම | මලින් ගැවසි | විසිතුරු
flowing=ගලායන | නොපැකිළ පවත්නා | පහසුවෙන් නික්මෙන | බුරුල්ව එල්ලා වැටෙන | විස්‍රාවණය
flown=අහසින් ගිය | ඉගිලුණු
fluctuate=අඩු වැඩි වෙනවා | උච්චාවච වෙනවා | උච්චාවචන වෙනවා | උච්චාවචනය | උස් පහත් වෙනවා | පාතෝත්පාතවීම | වරින්වර වෙනස් වෙනවා
fluctuation=අඩුවැඩි වීම | අඩුවැඩිවීම | උච්චාවචනය | උච්චාවටනය | නිතර වෙනස් වීම | විප්‍රකාරය
flue=දුම් නළය | දුම්වාන | වාහිනිය
fluency=ව්‍යක්තභාවය
fluent=කථා දක්ෂ | කථාවෙහි දක්ෂ | මුඛරි | ලිවීමෙහි දක්ෂ | ව්‍යක්ත | විචල්‍යය
fluff=බූව | ලොම්
fluffy=ලොම් ඇති
fluid=අස්ථිර | ගලායන | තරල | තරලය | ද්‍රව | ද්‍රවය | දියර
fluidity=තරලත්වය | තරලතාව | තාරල්‍යය | ද්‍රවතාව | ද්‍රවභාවය
fluitant=ප්ලවන
fluke=පැතැල්ලා | මත්ස්‍ය වර්ගයක්
flume=දිය ආර | දියැලිය | පීල්ල
flummery=ආහාරයක්
flung=දමා ගැසුවා
flunkey=පහත් සේවකයා | බොරු ප්‍රශංසාකාරයා
flunky=පහත් සේවකයා | බොරු ප්‍රශංසාකාරයා
fluorecence=ප්‍රතිදීප්තිය
fluoresccnce=ප්‍රතිදීප්තිය
fluoresce=දීප්තිය ලබනවා | ප්‍රතිදීප්ත කිරීම
fluorescence=ප්‍රතිදීප්තිය
fluorescent=ප්‍රතිදීපන | ප්‍රතිදීප්ත
fluorimeter=ප්‍රතිදීප්තිමානය
fluorine=කහ පැහැති වායුවක් | ප්ලුවොරීන්
fluorometry=ප්‍රතිදීප්තිමිතිය
fluorophore=ප්‍රතිදීප්තිධරය
fluoroscope=ප්‍රතිදීප්තික්ෂය | ප්‍රතිදීප්තීක්ෂය
fluorosis=ප්ලෝරෝසියාව
fluorspar=කැල්සියම් අඩංගු ඛනිජය
flurries=හදිසි ලුහු වැහි
flurry=කලබල ගතිය | කලබල හට ගන්නවා | නොසන්සුන්කම | මහත් චකිතය
flush=එක මට්ටමට පිහිටි | දළු ලනවා | දළුලෑම | දිලෙනවා | දීප්තිය | දෝර යැවීම | ධෛර්ය්‍යය | පිරුණු | වේගයෙන් දිය පිරවීම | වේගයෙන් දිය පිරීම | වේගයෙන් වතුර පුරවනවා | වේගවත් හැඟීම | හදිසි සමෘය | හදිසියෙන් දිය පිරීම
flushed=පුමුදිත | මූණ රතු වූ
flushing=දෝර හැරීම | සෝදා හැරීම
flute=ඇලිය | කානුව | නළාපිඹිනවා | නළාව | බටනලාව | වටැලිය | වස්කුලල් | වස්දඬුව | වස්දණ්ඩ | ශුෂීර | සුෂිර | සුසිර
fluted=දාර ඇති
fluting=ගොටුරැලි | ගොටුරැලි දැමීම | නළා වැඩ
flutist=නළාකාරයා
flutter=කලබල කරනවා | කලබල වෙනවා | චංචලභාවය | මඳ කලබලය | ලෙළීම | වත්ත සම්භ්‍රමය | වැනීම | වෙව්ලීම | ස්පන්දනය
fluvial=ගංගාවන්හි දක්නට ලැබෙන | වතුරු
fluviatile=වතුරු
fluvioglacial=හිම ද්‍රාවක
flux=අනිත්‍යභාවය | කඩුත්තුව | කාල ප්‍රවාහය | ගැලීම | ප්‍රවාහය | පොඩි | වෙනස් වන ස්වභාවය | ස්‍යන්දය | ස්‍යන්ධය | ස්‍රවය | ස්‍රාවය
fluxion=ව්‍යත්පන්නය
flw=ප්‍රස්‍රවණය
fly=අහසින් යනවා | ඉගිල්ලෙනවා | ඉගිලෙනවා | ඉගිළෙනවා | ජවලීවරය | තටු ගසනවා | තටු ගහනවා | දැදැරෙනවා | පලා යනවා | පියාඹනවා | පියාසර කරනවා | මක්ඛිකා | මක්ෂිකා | මැස්සා | මැසි | මැහි | ලෙළ දෙනවා | සැහැල්ලු අශ්වරථ වර්ගයක් | සෙට්සියා
fly-blow=ඉහඳ
fly-trap=මැසි උගුල
flyback=පසු පිම්ම
flying=ඉගිල්ලීම | ඉගිලෙන | ඉගිළීම | ගගනාවතරණය
flywheel=ගුරු රෝදය | ජව රෝදය
foal=අශ්ව පැටියකු වදනවා | අශ්ව පැටියා | කොටළු පැටියා
foam=පෙණ | පෙන | පෙන දමනවා | පෙන නගිනවා | පෙඳ | මණ්ඩය | මුහුද
foaming=පෙණ දමන | පෙණයීම
fob=කුඩා ඔර්ලෝසු සාක්කුව | රැකියාව | වංචා කරනවා
focal=කේන්ද්‍රීය | නාභිගත | නාභිය | නාභීය
focalization=නාභිගතකරණය
focaloid=නාභ්‍යාහය
foce=තදකරනවා
foci=කේන්ද්‍ර | නාභි | නාභී
focus=එල්ල කරනවා | එල්ල වෙනවා | කේන්ද්‍රය | නභ්‍යයනය කරනවා | නාභිගත කරනවා | නාභිගත කිරීම | නාභිය | යොමු කරනවා | යොමු වෙනවා | ලක්ෂ්‍යය | සමාහාර මධ්‍යය
focuses=කේන්ද්‍ර | නාභි
focusing=නාභ්‍යායනය | නාභිගත කිරීම
focussing=නාභ්‍යායනය | නාභිගත කිරීම | නාභිගාමක
fodder=ඝාසය | පෝෂය | මෘගහාර සපයනවා | සත්ත්වාහාර
foe=සතුරා
foeticide=ගැබ් නැසීම | භෲණ නාශනය
foetid=කුණු වූ | දුගඳ | දුගඳ හමන
foetus=කලලය | ගර්භය | ගැබෙහි වූ දරුවා | භ්‍රූණ | භ්‍රූණය | භ්‍රූණයා | භෲණය
fog=අවුල | ඝන මීදුම | ධූමිකාව | නොපැහැදිලි බව | මීදුමෙන් වසනවා | මුළා කරනවා | සැකය
fogey=හණ මිටිකාරයා
fogging=ඇඳිරි ගැස්ම | දුම් ගැස්වීම | දුම්ගැහීම | ධූමනය
foggy=නොපැහැදිලි | මීදුමෙන් වැසුණු
foghorn=මීදුම් නළාව
fogy=හණ මිටිකාරයා
foible=ඇදකුදය | දුර්වලකම | දෝෂය
foil=උලක් නැති මොටකඩුව | ප්‍රභාවර්ධකය | බාධා කරනවා | මුල් පත | ලෝපත | ව්‍යර්ථ කරනවා | සැක ඇතිකරවනවා
foining=පිරිද්දීම
foist=පවරනවා | බොරුවෙන් ඇතුල් කරනවා | වංචාවෙන් පිළිගන්වනවා | හොරෙන් ඇතුල් කරනවා
fold=අකුළනවා | ඔතනවා | ගාල | ගාල් කරනවා | නැම්ම | පට්ටිය | රැල්ල | රැලි | රැළි | හකුළනවා
folder=පත්‍රිකාව | ෆෝල්ඩරය
folding=නැම්ම | සම්මිඤ්ජනය
foliaceous=පත්‍රාකාර | සපත්‍ර
foliage=කොළ අතු
foliar=පත් වැනි
foliate=පත්‍ර සහිත | පත්‍රී
foliation=පත්‍රන්‍යාසය | ප්‍රාක් පත්‍රණය
folic=ඔල්මාදය | විකාරය
foliicolous=අපිපත්‍රී
folio=ගණන් පොතේ පත්ඉරුව | පත් ඉරුව | පත්ඉරුවල අංක යොදනවා | පත්තිරුව | පිටුව | සඟල පිටුව
foliose=පාත්‍රාකාර | සපත්‍ර
folium=චලිතය | පර්ණකය
folk=ගම | ගැමි | ජන | ජන සමූහය | ජනතාව | ජනයා | නෑදෑයෝ
folklore=ජන කථා | ජන ශ්‍රුති | ජනප්‍රවාදය | ජනශ්‍රුතිය | පුරාණ චාරිත්‍ර වාරිත්‍රාදිය | රටවැසියන් ගේ ඉතිහාසය
folkplay=ජනනාටකය
folks=නෑදෑයෝ
folktale=ජන කථාව | ජනකතාව
folkways=ජනාචාර
follicle=කුඩා කුහරය | කෝශය | පත්‍රාකාර | වරාව | සපත්‍ර
follicular=වරාව වැනි
folliculiformis=වරාව වැනි
follies=මෝඩකම්
follow=අනුගමනය කරනවා | අනුව එනවා | අනුව පැමිණෙනවා | අනුව යනවා | තේරුම් ගන්නවා | නිගමනය වශයෙන් ලැබෙනවා | නිසා පැමිණෙනවා | පස්සේ එනවා | පස්සේ යනවා | පසුව පැමිණෙනවා | පිළිපදිනවා | ලුහුබඳිනවා | ලුහුබැඳ යනවා | සිද්ධ වෙනවා | හනු බඳිනවා
follow-on-current=අනුයන ධාරාව
follow-up=අනුබැඳුම
follower=අතවැසියා | අනුගාමිකයා | අනුගාමිය | අනුවරයා | ගෝලයා | භක්තිකයා | ශ්‍රාවකයා | ශ්‍රාවිකාව | ශ්‍රෝතෘ
followers=පරිජනයා | පිරිවර
following=අනුගාමික පිරිස | අනුගාමී | අනුව | අපර | අපරාපරිය | ඒ ළඟ | පදානුපදික | පරිවාර ජනයා | පසුපස්සේ | පසුව එන | මතු සඳහන් වන
folly=අනුවණ ක්‍රියාව | මෝඩකම | විනෝදය
foment=අවුස්සනවා | තවනවා | පොළඹවනවා
fomentation=තැවිල්ල | තැවීම | පෙළඹවීම
fomites=විසපැහැසිය
fond=ආලය ඇති | ප්‍රිය | මෝඩ | සුරතල්
fondle=සුරතල් | සුරතල් කරනවා | හුරතල් වෙනවා
fondling=සුරතලය
fondness=කැමැත්ත | ළැදිකම
fondu=පොන්ඩු | රස කළ කේජු
fonix=චාපිකාව
fonkling=හුරතලය
font=උල්පත | තෙල් භාජනය | මුද්‍රණ අකුරුවර්ගය
fontanel=රන්ධ්‍රය
fontanelle=කුඩා දරුවෙකුගේ හිස් කබලෙහි මුදුනෙහි වූ අවකාශය | රන්ධ්‍රය
food=අන්න | අහර | ආහර | ආහාර | ආහාරය | කෑම | ගෝචර | පිණ්ඩය | පෝෂ්‍යය | බොජුන්
food-response=ආහාර ප්‍රතිචාරය
foodstuffs=ආහාර වර්ග
fool=අඥානයා | අන්ධයා | අමනයා | කවටයා | දද | මෝඩයා | මෝලා | රවටනවා | විගඩම් කරනවා | විහිළු කරනවා | හොර වෙනවා
foolery=නරිනාටකය | විගඩම | විහිළුව
foolesh=මූර්ඛ
foolish=අඥ | අඥාන | අන්දමන්ද | අනුවණ | අමන | ඔලමොට්ට | ඔළමොට්ටළ | තකතීරු | බොළඳ | මෝඝ | මෝඩ
foot=අඩිය | පද | පය | පයින් යනවා | පා | පාතලය | පාදය | පාබළ සෙනඟ | පාමුල | පිය | සරණත
foot-ball=පාපන්දුව
foot-board=පාපුවරුව
foot-candle=අඩි ඉටිපන්දම
foot-chain=පාදම
foot-fetters=පාදශංඛල
foot-impression=පා ලසය
foot-mark=පා සලකුණ
foot-note=අධෝලිපිය
foot-path=අඩිපාර | පාමංකඩ | පෙත්මඟ
foot-poundal=අඩි පවුන්ඩලය
foot-print=පදලස | පාදලාඤ්ජනය | පාදසටහන
foot-rest=පාද ඵලකය | පාදපීඨය | පාපුටුව
foot-rule=අඩිකෝදුව
foot-ruler=කෝදුව
foot-wear=වහන | වහන් | සපත්තු
foot-writing=පා ලිවීම
footage=අඩියාව
football=පාපන්දුව
footboard=පාපුවරුව
footbridge=ඒදණ්ඩ
footer=පාද තලය
footfall=අඩි ශබ්දය
footgear=පාපළඳනා
foothill=කන්දක් ළඟ පිහිටි කුඩා කන්ද
foothold=පය තැබීමට ඉඩ | යන්තම් අවකාශය
footing=අඩිතාලම | අවස්ථාව | කොන්දේසිය | පය තැබීමට ඉඩ | ප්‍රතිපත්තිය | ස්ථානය
footless=අපා | අපාද | අපාදක
footlight=රඟමඬලේ ඉදිරි භාගයේ පිහිටි එළිය
footlights=පාදස්ථ ආලෝකය
footloose=හිතූ ලෙසට හැසිරෙන
footman=සේවකයා
footnote=අධෝ ලිපිය | අධෝලිපිය | පාදසටහන
footnotes=අධෝලිපි
footpad=මංකොල්ල කාරයා | මංකොල්ලකාරයා
footprint=පා සටහන | පා සළකුණ | පාද ලාංඡනය | පිය සටහන
footrule=අඩි කෝදුව
footscrew=පාද ඉස්කුරුප්පුව
footsore=ඇවිද බොහෝ මහන්සි වූ
footstep=අඩි ශබ්දය
footsteps=අඩි පාරවල්
footstool=පාපුටුව
footwall=පාබිත
footway=පිය මඟ
fop=ජේත්තුකාරයා
foppery=ජේත්තුව
foppish=ජේත්තු
for=අතරතුර | උදෙසා | ගැන | ට | තුළ | දෙසට | නිසා | පිණිස | බැවින් | මක්නිසාද යත් | වස් | වෙනුවට | වෙනුවෙන් | සඳහා | හන්දා | හින්දා
forage=පැහැරගන්නවා | බලෙන් සපයාගන්නවා | යවස | සත්වාහාර
foraging=යවසනය
foramen=ඡිද්‍රය | ද්‍රය
foraminiferal=ඡිද්‍ර ගොහොරුව
foray=ආක්‍රමණය | සටනට යනවා
forbade=තහනම් කළා
forbear=ඉවසනවා | වළකිනවා
forbearance=ඉවසීම | තිතික්ෂාව | වර්ජනය | සහන
forbearant=සහනකාමී
forbears=මුතුන්මිත්තෝ
forbid=එපා කරනවා | තහනම් කරනවා | ප්‍රතිෂේධ කරනවා
forbidden=තහනම් කරන ලද
forbidding=අප්‍රියකර | භය උපදවන
forbore=ඉවසුවා | වැළකුනා
force=අදහස | කණ්ඩායම | පිරිස | බල කරනවා | බලකාය | බලපෑම | බලය | බලවේගය | බලහත්කාරකම | බලාත්කාරකම | බලාත්කාරය | බලෙන් ඇති කරනවා | බලෙන් ගන්නවා | බලෙන් වැඩෙන්ට සලසනවා | වළංගුකම | වේගය | ශක්තිය | සේනාව
forced=අනියම් | බල කරනලද
forceful=ප්‍රබල | බලසම්පන්න
forcefully=සැරෙන්
forceps=අඬුව | ඩැහි අඬුව | සංදංශය
forcible=බලාත්කාර | බලෙන් කරන ලද
forcing=බලකිරීම
ford=ගංතොට | ගඟින් එතෙර වෙනවා | තිත්ථ | තීර්ථය | තොට | තොටු පොළ | තොටුපළ | තොටුපොළ | දිය නොගැඹුරු තැන
fore=ඉදිරිය | ඉස්සරහ | පළමු
fore-exercise=ප්‍රාහ්‍යාසය
fore-finger=දබරැඟිල්ල
fore-point=පෙර ලක්ෂ්‍යය
fore-sight=ඉදිරි දැක්ම
forearm=අග්‍රබාහුව | කල් තබා සූදානම් වෙනවා | යටි බාහුව
forebay=පෙර වැව
forebode=නිමිති කියනවා
forebrain=පෙර මොළය | පෙරමොළය
forecast=අනාගත වාක්‍යය | අනාගත සිදුවීම් කියනවා | අනාවැකි කියනවා | අනාවැකිය | කලින් සිතාගන්නවා | නිමිතිකීම | නියම කරනවා | පුරෝකථනය | පූර්ව නිවේදනය | භාවි ප්‍රකාශනය | භාවිකථනය | භාවීකථනය
forecasting=අනාවැකි කීම | පූර්ව කථනය | භාවිකථනය | භාවීකථනය
forecastle=නැවේ උඩ තට්ටුවේ ඉදිරි කොටස
foreclose=කලින් තහනම් කරනවා | පූර්වපිධානය | පෙරවරණය කිරීම
foreclosure=පූර්වපිධානය | පෙරවරණය
foreconscious=ප්‍රවිඥානය
forecourt=ඉන්ධන සේවාහලක ඉන්ධන නිකුත් කරන තැන
foredoom=ඉරණම නියම වෙනවා
forefather=මුතුන් මිත්තන්ගෙන් කෙනෙක්
forefeit=අලාභය | දඩය | යමක් අහිමි වෙනවා
forefeiture=අහිමිකරය
forefeltur=අලාභය | දඩය
forefiet=අහිමිකරණය
forefinger=තර්ජනාංගුලිය | දබර ඇඟිල්ල
forefront=ප්‍රමුඛස්ථානය
forego=කලින් සඳහන් වෙනවා
foregoing=යට සඳහන් කළ
foregone=අවශ්‍යයෙන් වියයුතු | නිසැක
foreground=පෙරබිම | වත්‍රයක ඉදිරි කොටස
forehead=නලළ | නළල | ලලාට
forehearth=පෙර ලිප
foreign=අන්‍යජාතික | ආගන්තුක | නුපුරුදු | විජාතීය | විදෙස් | විදේශ | විදේශීය | සම්බන්ධකමක් නැති
foreign-aid-grants=විදේශ ආධාර ප්‍රදාන
foreigner=අන්‍යජාතිකයා | තුප්පහියා | නොරැටියා | පරදේශියා | පරයා | පිටරැටියා | විජාතික | විදේශිකයා
foreknow=කලින් දැනගන්නවා
foreknowledge=අනාගත ඥානය
foreland=දේශතුඩුව | පෙරබිම
forelap=කෝණම
foreleg=ඉස්සරහ ගාතය
forelock=නළලෙහි වූ කෙස් රොද
foreman=ප්‍රමුඛයා | පෝර්මන් | වැඩ නායක | වැඩ මූලික | වැඩ මූලිකයා | වැඩනායක | වැඩමූලික | ාේමන්
foremanship=වැඩ නායකත්වය | වැඩනායකත්වය
foremast=නැවේ ඉස්සරහ කුඹගස
foremost=අග්‍ර | අග්‍රගණ්‍ය | පරුමක | ප්‍රධාන | ප්‍රමුඛ | පුරස්සර | මුඛ්‍ය
forename=මුල්නම
forenoon=පෙරවරු | පෙරවරුව
forensic=අධිකරණ | අධිකරණ වෛද්‍යු | වෝභාර
foreordain=පෙර නිමිති දක්වනවා
foreordination=දෛවය
forepaw=සතෙකුගේ ඉදිරි නිය
foreperiod=ප්‍රසමය
forepleasure=ප්‍රසුඛය
forerunner=අග්‍රේසරයා | ඉදිරියෙන් යන්නා | පූර්ව නිමිත්ත | පූර්වගාමීයා | පෙරටුව යන්නා
forerunners=පුරෝගාමීන් | පෙරසැරියන්
foresald=පූර්වෝක්ත
foresee=දැනගන්නවා
foreshadow=පෙරටු සේයාව | ලකුණු පහළ වෙනවා
foreshore=පෙර වෙරළ | පෙර වෙරළත | පෙරවෙරළ | වෙරළ අද්දර
foreshorten=කොටස් කොටට පෙනෙන සේ අඳිනවා
foreshortening=පූර්ව හුස්නය | පූර්වභ්‍රසනය
foresight=දූරදර්ශීභාවය | ප්‍රදෘෂ්ටිය | පූර්වදර්ශනය | පූර්වෙක්ෂණය | පෙර ඉක්සුම | පෙර දැක්ම
foreskin=ලිංගාග්‍ර චර්මය
forest=අටවිය | අඩවිය | අරණ | අරණ්‍යය | ආරණ්‍ය | කඩ | කැලය | කැලෑව | තෝප්පුව | දඩ | බැද්ද | බැදි | මුකලාන | මූකළන් | මූකළාන | රණ | ලැව් | වන | වනය | වනාන්තරය | හරන් | හිමය
forestage=පෙරටු වේදිකාව
forestall=ඉස්සර වෙනවා | කලින් වළක්වනවා
forestation=වන රෝපනය
forester=වනය ආරක්ෂක නිලධාරියා | වනවාසියා
forestry=කැලෑකම් | වන විද්‍යාව | වන සංවර්ධන විද්‍යාව | වනවිද්‍යාව
foretaste=කලින් රස විඳීම | පූර්වානුභවය | මඳක් අත්දැකීම
foretell=දිවස් කියනවා | ශාස්ත්‍ර කියනවා
forethought=දූරදර්ශීභාවය | ප්‍රවන්තාව
forever=සදහටම
forewarn=කලින් අවවාද කරනවා
forewold=වන වාටිය
foreword=ප්‍රස්තාවනාව | පෙරවදන | විඥප්තිය | සංඥාපනය
forfeit=අහිමිකරණය
forfeited=සින්න
forfeiture=අහිමි කිරීම
forgather=එක්‍රුස් වෙනවා
forge=ආචාරි පට්ටලය | කම්මල | කම්මල් ලිප | කුටරචනය කරනවා | බොරුවට තනනවා | වංචා කරනවා | ස්ථිරව ඉදිරියට යනවා | හැඩ තලනවා | හොරට තනනවා
forgeability=හැඩ තැලියාව
forgeable=හැඩතැළිය හැකි
forged=කූට | හොර
forgery=කූට කෘතිය | කූට ලේඛය | කූටරචනය | වංචාව | ව්‍යාජ ලේඛණ සෑදීම | ව්‍යාජ ලේඛන සෑදීම | හොර අත්සන | හොර අත්සන් තැබීම | හොර ලිපිය | හොරසන් තැබීම
forget=අතපසු කරනවා | අමතක කරනවා | අමතක වෙනවා | මගහරිනවා | සිහි නැති වෙනවා
forget-me-not=කුඩා නිල් මල් ඇති ශාකයක්
forgetful=අමතක කරන සුලු | අමතක වනසුලු | මතක නැති වන | ස්මෘතිහීන
forgetfulness=අමතක වන බව | අමතකවනසුලු බව
forgetting=අමතකවීම
forging=හැඩ තැලීම | හැඩ තැළීම | හැඩතැළීම
forgive=අනුකම්පා දක්වනවා | කමාකරනවා | සමාවෙනවා
forgiveness=ක්ෂමාව | දයාව
forgiving=අනුකම්පාසහගත | දයාන්විත
forgo=යමකින් වළකිනවා
forgone=පරිත්‍යක්ත
forgotten=අමතක
forigner=විජාති
fork=අතුවලට බෙදෙනවා | කරුව | ගෑරුප්පුව | දෙබල | දෙබළය | පටිකරුව | පෙරළනවා | මුල්ලුව
forked=දෙබල්
forlorn=අනාථ | කාලකණ්ණි
form=අඩංගු වෙනවා | අන්දම | අවස්ථාව | අළුව | ආකාරය | ආකෘති පත්‍රය | ආකෘතිපත්‍රය | ආකෘතිය | ආචාරය | ඇති කරගන්නවා | චාරිත්‍රය | තනනවා | තරම | නය | පිහිටුවනවා | පිළිවෙළ | පෝරමය | පෝර්මය | මූර්ති | රූ | රූප | රූපය | රූපාකාරය | ලතාව | විධි | විධිය | වෙනවා | සකස් කරනවා | සකස් වෙනවා | ස්වරූපය | සාදනවා | සැටි | සැටිය | සෑදෙනවා | හැඩගස්වනවා | හැඩය | හැඩයම
forma=ආකාරය | ආකෘතිය | රූපය
formal=අවශ්‍ය | ආකෘතික | උපචාර | උපචාරානුකූල | ඖෙපචාරික | රූපික | විධිගත | විධිමත් | වෛධ | හුදෙක් චාරිත්‍රානුකූල
formaldehyde=පෝමැල්ඩිහයිඩ්
formalin=පෝමලින් | ෆෝමලින්
formalism=ආකාරප්‍රාධාන්‍යවාදය | ආකෘතිවාදය | බාහිර භක්තිය | රූප ප්‍රධාන වාදය | රූපප්‍රධානවාදය | විධි වාදය | සණ්ඨාන වාදය
formality=උපචාරය | නියමය | නිරර්ථක චාරිත්‍රවිධිය | බාහිරාලංකාරය | විධිමත් භාවය | හෘදයංගම නොවූ ආචාරය
formalization=රූපීකරණය
formally=රූපාත්මකව
formant=සාධන්තය
format=ආකෘතිය | නිමැවුම | පොතක බාහිර රූපය | හැඩහුරුව
formation=ආකාරය | නිර්මාණය | භූමි සංස්ථානය | යෙදුම | වර්ගය | විලාසය | සකර | සමාජය | සැදිල්ල | සැදුම
formative=උද්භව | නිර්මානයට හේතුවන | හැඩ ගස්වන
formatting=ආකෘතිකරණය
formboard=රූ පුවරුව
forme=මුද්‍රණයට සැකසූ අකුරු පෙළ
formely=අතීතයෙහි | ඉස්සර | කලින්
former=ඉහතකී | පුරාණ | පුරිම | පූර්ව | පෙර | මුලින් කී තැනැත්තා | මුලින් කී දෙය | යට ගිය | හැඩකරය | හැඩමල | හිටපු
formerly=ඉස්සර | පෙරාතුව | වරක්
formica=*****මිකා
formication=නැලියුම | පිපීලායනය
formidable=දරුණු | බැරුම් | භයානක
forming=හැඩගාන හැඩගැසීම
formless=අරූප | අරූපී | නිරාකාර
forms=ආකාර රේඛා | හැඩයම් රේඛා
formula=නියමය | නියමිත වචනමාලාව | රීතිය | සංකේතය | සුත්‍රය | සූත්‍රය
formulae=සූත්‍ර
formulary=සූත්‍ර සංග්‍රහය
formulate=ක්‍රමවත්ව දක්වනවා | සූත්‍රණය කරනවා
formulated=සූත්‍රකෘත
formulation=සූත්‍රකරණය | සූත්‍රායනය
formulism=සූත්‍රවාදය
formwork=හැඩයම්
fornicate=මෛථුනයෙහි යෙදෙනවා
fornication=මෛථුනයෙහි යෙදීම | මෛථූනය
fornicator=මෛථුනයෙහි යෙදෙන අවිවාහක ස්ත්‍රී පුරුෂයින් | මෛථූනිකයා
fornix=ඡාපිකාව
forrimagnetism=පෙරිචුම්බකත්වය
forsake=අතරමං කරනවා | අත්හරිනවා | අත්හැර යනවා
forsaken=අත්හල | අනාථ
forseeability=පුර්වේක්ෂ්‍යතාව | පෙරඉක්සු බව
forsooth=නිසැකවම | සැබැවින්ම
forssilized=පාෂාණිභූත
forswear=දිවුරා අත්හරිනවා | නිදොස් බව කියනවා | බොරු දිවුරනවා
forsythia=කහමල් ඇති ශාකයක්
fort=කොටුව | කෝට්ටය | කෝට්ටේ | දුර්ගය | බලකොටුව
forte=අග්‍රිමය | විශේෂ සාමර්ථ්‍යය | ශබ්දය උස් කොට
forth=ඉදිරියට | පිටතට | සතරවෙනි
forthcoming=අනාගත
forthwith=එකෙනෙහි ම | දැන්ම | වහාම | සැණින්
fortieth=හතලිස්වෙනි
fortification=ආරක්ෂා සැලසීම
fortify=ආරක්ෂා සංවිධාන සලසනවා | බලවත් කරනවා | ශක්තිමත් කරනවා
fortissimo=මහ හන්
fortitude=ධෛර්යය | ධෛර්ය්‍යය | ස්ථිරභාවය
fortnight=පක්ෂය | සුමාන දෙකක්
fortnightly=අර්ධ මාසික | දෙසතියකට වරක්
fortran=‍ෆෝටෝන්
fortress=කොටුව | කෝට්ටය | කෝට්ටේ | පේතෘ | බලකොටුව | බළකොටුව | මහා දුර්ගය | විශාල බලකොටුව
fortuitous=අධිච්ච සමුප්පන්න | අහම්බෙන් සිදු වන | දෛවායත්ත | දෛවික | බලාපොරොත්තුවක් නැතිව | යදෘච්ඡ | යදෘච්ජක
fortunate=බහදුරු | භගවත් | භාග්‍යවත් | වාසනාවන්ත | ශුභ | සවාසන | සහේතුක | සිරිබර | සුභ
fortune=දෛවය | ධනය | පලාපල | භග | භාග්‍යය | ලැබීම | වාසනාව | විදි | සම්පත්ති | සම්පත්තිය | සවාසනා | සිරි | සිරිය | සෞභාග්‍යය | හේතු බලය | හේතුව
forty=සතළිස | සාළිස් | හතලිහ | හතළිස | හතළිහ
forum=උපචාරාලය | විනිශ්චයශාලාව | සමිය
forward=අප්‍රමාදී | ඉදිරි කාලය පිළිබඳ | ඉදිරියට | ඉදිරියෙහි | ඉදිරියෙහි වූ | ඉස්සරහ | උපකාර කරනවා | එළවනවා | කලින් | කලින් මේරූ | දියුණු කරනවා | ප්‍රගතිශීළී | ප්‍රගල්භ | පෙරමුණෙහි සිටින | බිය සැක නැති
forwardness=අනිසි මැදි වීම | බිය සැක නැතිකම
forwards=ඉදිරියට
forwn=ඔරවනවා
foss=පරිඛාව
fossa=ඛාතය | නිඛාතය | පොස්සාව | ලේණය
fosse=පරිඛාව
fossiferous=පාෂාණීය ධාතුධර
fossil=පාෂාණීය ධාතු | පොසිල
fossilised=පාෂාණිභූත
fossilize=ගල්වෙනවා
fossils=පාෂාණධාතු | පාෂාණි ධාතු | පාෂාණිධාතු | පොසිල
foster=ධෛර්යය දෙනවා | පිහිටාධාර වෙනවා | පිළිදැගුම් | පෝෂ්‍ය කරනවා | සිතෙහි තැන්පත් කරගන්නවා | හදා වඩා ගන්නවා
foster-child=හදාගත් දරුවා
fostering=පිළිදැගුම
fot=පය
foul=අතිශයින් අපිරිසුදු | අපවිත්‍ර කරනවා | කලහ ඇති කරගන්නවා | කැත | කැතකරනවා | දූෂිත | නින්දිත | නීතිවිරෝධී වූ ක්‍රියාව | පල් | පලුදු | පැටලෙනවා | පිළිකුල් වූ | පූති | සැපදායක නොවූ
foul-breath=කට ගඳ
foulard=පට ලේන්සුව
fouling=කාරම් බැඳීම | පරස් වීම | පරිදූෂණය කිරීම
foully=ඉතා නින්දිත ලෙස | දුෂ්ට ලෙස
foulness=කිලි
foulplay=දරුණු අපරාධය | ද්‍රෝහී වූ ක්‍රියාව
found=අත්තිවාරම් දමනවා | ආරම්භ කරනවා | පදනම් ලනවා | පිහිටනවා | පිහිටුවනවා | ලෝහ උණු කොට වාත්තු කරනවා | වීදුරු උණු කොට වාත්තු කරනවා | ස්ථාපනය කරනවා
foundation=අඩිතාලම | අත්තිවාරම | පදනම | ප්‍රතිෂ්ඨාපනය | ප්‍රතිෂ්ඨාව | සංස්ථාපනය
foundationer=ශිෂ්‍යත්වයක් ලබා සිටින්නා
founded=ප්‍රතිස්ථාපිත
founder=අමාරුවේ වැටෙනවා | ආදි කර්තෘ | ආදිකර්තෘ | කිඳෙනවා | නොන්ඩි වෙනවා | ප්‍රාරම්භකයා | මඩේ එරෙනවා | ලෝකුරුවා | ස්ථාපකයා | ස්ථාපනකරු
foundling=ඇහිඳගත් දරුවා | ත්‍යක්තාපත්‍යයා
foundress=ආදි කර්තෘවරිය
foundry=වාත්තු පොළ | වාත්තු මඩුව | වාත්තු වැඩපොල | වාත්තුමඩුව
fount=ආරම්භය | උල්පත | ජලාශය | ධාරා යන්ත්‍රය | මුද්‍රණාක්ෂර වර්ගය | වතුර මල
fountain=ආරම්භය | උල්පත | ඌල් | ජලාශය | ධාරා යන්ත්‍රය | බුබුළ | වතුර මල
four=චතු | සතර | සිව් | සිවු | හතර | හාර
four-fold=සිව් ගුණ
four-force=සිව්බලය
four-sided=සියුරැස් | සිවුරැස් | හතරැස්
four-sied=සීරැස්
four-vector=චතුර් දෛශිකය
fourchette=අංජලිකාව
fourfold=චතුර්විධ | සියුරඟ | සිවුරඟ
fourposter=වියන් ඇඳ
fourscore=අසූව
foursquare=ශක්තිමත් ලෙස පිහිටි | සම සතරැස්
fourteen=තුදුස | දහහතර | දාහතර
fourteenth=දහහතරවෙනි
fourth=සතරවන | සතරවැනි | සිවුවන
fovea=කූපය
fowl=කුකුළා | පක්ෂියා | සරණවියා | සැවුලා
fowler=පක්ෂිවැද්දා
fowling=පක්ෂි දඩයම
fox=නරියා | ශඨකපට තැනැත්තා | හිවලා
foxey=එළය වැඩි
foxy=කපටි | ප්‍රයෝගකාර
foy=සතොස
fracas=අඩදබරය | කලහය
fracticnating=විභාජක
fractile=භාගක
fraction=ඉතා කුඩා කොටස | ඛණ්ඩය | භාග ගණන | භාගය | භින්න භාගය | භින්නය
fractional=අසම්පූර්ණ | භාග | භාගික | භාගික ආසවනය | භිගික
fractionation=භාගීකරණය | විභාජනය
fractions=කැඩුණු කොටස් | භාග
fractious=කලහයට කැමැති | කිපෙන සුලු
fracture=කැඩුම | බිඳුම | බිඳෙනවා | භංගය | භග්නය
fractures=කැඩුම්බිදුම්
fradulent=වාංචනික
fragile=දුර්වල | පභංගුර | පහසුවෙන් බිඳෙන | බිඳෙනසුලු | භංගුර | භිදුර | සභංගුර
fragility=බිඳෙන සුළු ගතිය | බිඳෙනසුලු බව | භංගුරත්වය
fragment=අංශය | කැඩිය | කැඩුණු කැබෙල්ල | කැබැල්ල | කෑල්ල | කොටස | ඛණ්ඩය | භාගය | ශේෂය
fragmentary=අසම්පූර්ණ
fragmentation=කඩ කඩ වීම | කැබලි කිරීම | කැබැලි කිරීම | ඛණ්ඩනීකරණය
fragmenting=විඛණ්ඩනය
fragrance=ධූප | සුවඳ
fragrant=මනා සුවඳැති | සුගන්ධී
frail=දුර්වල | පහසුවෙන් වරදෙහි බැඳෙන | බෙලහීන
frailty=අස්ථිරභාවය | දුර්වලත්වය | වරදෙහි වැටෙනසුලු බව
frame=ආකාරය | ක්‍රමය | කූඩුව | තනනවා | මැස්ස | යොදනවා | රචනය කරනවා | රචනා විලාසය | රාමු කරනවා | රාමුව | රූපය | විට්ටම | සකස් කරනවා | සකස් වෙනවා | සදනවා | ස්වභාවය | සැකිල්ල | සැදෙනවා
frame-work=රාමු කට්ටුව
frames=කටින යන්ත්‍ර
framework=රාමුව | සැකිල්ල
framing=රාමු කිරීම | සැකිලි ලෑම
franc=ප්‍රංශ කාසියක්
franchise=අධිකාරිය | ඡන්ද බලය | ඡන්දය දීමේ බලය | පෞරාධිකාරය | වරය
francium=විකිරණශීලී ලෝහමය මූලද්‍රව්‍යයක්
franco=ප්‍රංශ | ප්‍රැන්කෝච
frand=මුද්‍රා
frangipani=අරලියා වැනි සුවඳැති මල් වර්ගයක්
franglais=ප්‍රංශ හා ඉංග්‍රීසි වචන මිශ්‍ර අපභ්‍රංශ භාෂාව
frank=අවංක | නිලහන | නිලහන යොදනවා | නොවළහා කථාකරන | මුද්‍රාව | සෘජු
frankfurter=දුම්ගසා පදම් කරන ලද ලිංගුස්
frankincense=කට්ටකුමංචල් | කට්ටකුමංජල් | කුන්දුරු
franklin=ඉඩම් හිමි ගොවියා
frankness=අකුටිලභාවය | අවංක භාවය
franktic=උමතු | නොඉවසිලිවන්ත | වියරු වැටුණු
frappe=අයිස් දමා ශීතළ කල මුද්‍රිකපානය
fraternal=එක එකා | එකකුසහොත් | භ්‍රාත්‍රීය | සහෝදර
fraternity=ගණය | නිකාය | සහකාර පිරිස | සහෝදර පිරිස | සහෝදරත්වය | සොහොවුරුව | සෞභ්‍රාත්‍රය
fraternize=සමාගම් පවත්වනවා
frato-cumulus=කඩ කැටි වලා
fratriside=සහෝදරයකු මරන්නා | සහෝදරයකු මැරීම | හ්‍රාතෘඝාතකයා
frau=විවාහක ජර්මන් කාන්තාව
fraud=දම්හ | ප්‍රයෝගය | ප්‍රෝඩාව | බොරුකාරයා | මගඩිය | මගෝඩිය | රැවටිලි | රැවටීම | වංචනිකයා | වංචාව | වඤ්චාව | හොරය
fraudulent=කපට | කූට | කෛරාටික | ප්‍රෝඩාකාරී | වංචන | වංචනික | වංචාකාරී | ශටකපට
fraudulently=මූණිච්චාවට
fraught=පිරුණු | සංයුක්ත | හරිත
fraulein=අවිවාහක ජර්මන් කාන්තාව
fray=අග ගෙවී යනවා | කෝලාහලය | නූල් අදිනවා | පොරය | සඩංගුව
frayed=අග ගෙවී ගිය
frazilisation=කඩ කඩ මිදීම
frazing=දාර මැදීම
frazzle=අබලන් | වෙහෙසට පත්
frcundity=සාමූහික
freak=පුදුම වූ දේ | විකාරය | විකෘත වූ දේ | විප්‍රකාර | විහිළුව | හිතුබුද්ධියේ ඇතිවන කල්පනාව
freakish=අද්භූත | විප්‍රකාර | හිතුබුද්ධියේ වෙනස් වන
freakle=පුල්ලිය
free=අබාධ | අබාධිත | අවංක | අවහිරයක් නැති | ගළවනවා | ගෙවීමක් නැති | නිදහස් | නිදහස් කරනවා | නිදැලි | නොමසුරු | නොමිලේ | මිදුණු | මුක්ත | මුදනවා | යෝජ්‍ය | වැඩෙහි යෙදුණු | විවේකී | ස්වාධීන | සිය කැමැත්තෙන් කරන | සේරි | සෛවරී
freeboard=නිදැලිය
freed=මිදිච්ච | මුක්ත
freedman=දාසභාවයෙන් මිදුණු තැනැත්තා
freedom=නගරයක මානනීය පෞරත්වය | නිදහස | නොමනා ප්‍රේමය | ස්වතන්ත්‍රතාව | ස්වාධීනත්වය | ස්වාධීනතාව | සාමාර්ථ්‍යය | සුචලනය
freehoid=නිදහස් අයිතිය | සින්නක්කරය
freelance=නොබැඳි
freely=එලවේසම් | නිකං | නිදහස් ලෙස | නිදැල්ලේ | සුවල ලෙස
freeman=නිදහස් පුරුෂයා | නිවහල් මිනිසා
freesia=සුවඳැති මල්ගසක්
freestone=නිදහස් ගල්
freethinker=නිදහස් මතධාරියා
freeway=අබාධ මාර්ගය
freewheel=එකත් රෝදය
freewill=ස්වච්ඡන්දය
freeze=අත්හිටවීම | අවුරනවා | ඇවිරීම | කැටි කරනවා | ගල් ගැසෙනවා | නිශ්චලනය | මිදෙනවා | මුදවනවා | සිතනය කරනවා
freezer=ශීතකරණය
freezing=ඉතා ශීතල | තැතිගන්වන | ශීත ජනක | හිමායනය
freight=ගැල් කුලිය | ගැල් කුලිය | ගැල්කුලිය | ගැල්බර | පටවන ලද බඩු | පරිවාහය | ප්‍රවාහණ කුලිය | ප්‍රවාහනය | බඩු පටවනවා
freighter=පරිවාහක නැව | බඩුනැව | බඩු නැව
freign-aid-grants=විදේශාධාර ප්‍රදාන
fremd=අන්‍ය | ජාතී | පර
french=ප්‍රංශ | ප්‍රංශයට අයත්
frenetic=උමතු | වියරු වැටුණ
frenzied=බොහෝ කලබල සහිත | වියරු වැටුණු
frenzy=ආවේශය | උන්මාදය | පිස්සුව | මහත් කලබලය | වියරුව
frequency=නිතර සිදු වීම | නිසැදිය | වාර ගණන | වාරගණන | සංඛ්‍යාත | සංඛ්‍යාතය
frequent=ගැවසෙනවා | නිතර ගැවසෙනවා | නිතර සිදුවන | බහුල | බහුලව කෙරෙන | වහවැටෙනවා | හොල්මන් කරනවා
frequentative=යඩන්ත ක්‍රියාව
frequented=සමාකීර්ණ
frequenting=යන එන
frequently=නිතර
fresco=බිතු සිතුවම
frescos=මණ්ඩෝදක
fresh=අමුතු | අලුත් | ඇල් | කඩිසර | නරක් නොවූ | නවීන | නැවුම් | නොපුරුදු | නොමැලවුණු | නොවියළි | ප්‍රාණවත් | ලුණු නැති | සැපදායක
freshen=අමු ගතියට පමුණුවනවා | අමු ගතියට පැමිණෙනවා | ටිකක් සැර වෙනවා | මිහිරි ගතියට පමුණුවනවා | මිහිරි ගතියට පැමිණෙනවා
fresher=ආධුනිකයා | නවකයා
freshet=ගංවතුර මුහුදට බැස යන දියපාර | හිම නිසා ගඟේ වැඩිවන ජලය
freshman=ආධුනිකයා | නවකයා
fresnel=ප්‍රෙනෙල්
fret=කාවැදීමෙන් ගෙවී යනවා | ගැටීමෙන් ගෙවී යනවා | ගෙවී යන්ට සලසනවා | නොරිස්සුම් ගතිය | ලෙල්ලම් වෙනවා | සිතෙහි ලෙල්ලම් ස්වභාවය
fret-saw=උල්කියත
fretful=ඉක්මණින් තරහ ඇවිස්සෙන | නොසන්සුන්
fretsaw=උල් කියත
fretting=ගෙවී යෑම
freudian=සිග්මන් ප්‍රොයිඩ්ගේ දර්ශනයට අයත්
freudianism=ප්‍රොයිඩ් වාදය
freudism=ප්‍රොයිඩ් වාදය
friable=පහසුවෙන් කුඩු බවට පත් කළ හැකි
friar=ශ්‍රමණයා
friary=තාපසාරාමය | මඨය
fribroma=පයිබ්‍රෝමාව
fricasse=බැදපු මස් දීසිය
fricative=උෂ්මන් අක්ෂරය
friction=එකට ඇතිල්ලීම | ගැටීම | ඝට්ටනය | ඝර්ෂණය | විරෝධය | සංඝර්ෂණය
friday=සිකුරාදා
fried=පුලුටු | බදින ලද
friend=එද්දලයා | පින්වතා | මිත්‍ර | මිත්‍රයා | මිතු | මිතුරා | මිතුරු | යහළුවා | යාළුවා | සකි | සග | සගයා | සච්ච | සබඳ | සහචරයා | සහල | සහළ | සහායකයා | සුහද | හාද | හාදයා | හිතෙෂියා
friendless=අනාථ
friendliness=සාදරය | හිතවත්භාවය
friendly=අනුකූල | කරුණාවන්ත | කුලුපග | මිත්‍ර | මිත්‍රවත් | යහළ | යහළු | යාළු | සබැඳි | සහචර | සහළ | හාද | හිතවත් | හිතෛෂී
friendship=මිත්‍රකම | මිත්‍රත්වය | මිත්‍රධර්මය | මිතුදම | මිතුරුදම | සන්ථවය | සබැඳියාව | සම්බන්ධය
frieze=බිත්ති හිස
frigate=ආරක්ෂක නැව
fright=තිගැස්සීම | භීතිය | හදිසියෙන් වන භය
frighten=ගැස්සෙනවා | බියකරනවා | භය ගන්වනවා
frightful=දරුණු | භයානක
frigid=උණුසුමක් නැති | උනන්දුවක් නැති | ශීතාධික
frigidaire=අයිස් පෙට්ටිය
frigidity=අධික ශීතලභාවය | උනන්දු නැති බව | නිර්මදතාව | ශීතකාමය
frigthtened=බියපත්
frill=අනවශ්‍ය අලංකාරය | නරුව | නෙරිය | රැල්ල | රැළි පටිය | රැළි වාටිය | ලොවිච්වය
fringe=අද්දර | අද්දරක් යොදනවා | ගැට්ට | තොංගලය | දාරය | දාවල්ල | වාටිය | වාටියක් යොදනවා
fringe-rural-urban=ග්‍රාමරික
frippery=කඩමලු | බොරු අලංකාරය
frisbee=එළිමහනේ ක්‍රීඩා කිරීමට ගන්නා ප්ලාස්ටික් කවපෙත්ත
frisk=උඩ පනිනවා | පෙම් කෙළිනවා
frisky=දඟකාර
frisson=උද්වේගකර ප්‍රීතිය
frit=අර්ධ විලීන ද්‍රව්‍යය
frith=ප්‍රිත් | පුනීල මෝය | විශාල මෝය | සමුද්‍රවංකය
fritter=අපතේ හරිනවා | කැබලි කොට කපනවා | නාස්ති කරනවා | බැදපු කෑමක්
frivolity=නිරර්ථක ක්‍රියාව | විහිළු තහළු කිරීම
frivolous=නිස්සාර | වැදගැම්මකට නැති | විරර්ථක ව්‍යාපාරයන්හි යෙදෙන | විහිළු
friz=කෙස් බොකුටු කරනවා | කෙස් වකුටු කරනවා
frizz=කෙස් බොකුටු කරනවා | කෙස් වකුටු කරනවා
frizzle=සුරු සුරු හඬ නගමින් බදිනවා
frock=ගවොම | ශාටකය
frog=උගුරේ සෙම හිරවීම | ගෙම්බා | ගෙමැයා | පිනුම් මාරුව | මණ්ඩුක | මැ | මැඩියා
frogman=රබර් ඇඳුමින් යුත් කිමිදුම්කරු
frolic=උසුළු විසුළු කිරීම | පෙම් කෙළීම | සෙල්ලම | සෙල්ලම් කරනවා
frolicsome=කෙළිදෙළෙහි නියැලි | සෙල්ලමට කැමති
from=පටන් | සිට
frond=කොක්ක | ගොක් අත්ත | පත්‍රය
frond-genus=පත්‍ර ගණය
frondose=පාත්‍රාකාර | සපත්‍ර
front=අභිමුඛය | ඉදිරි | ඉදිරි පාර්ශ්වය | ඉදිරිපස | ඉදිරිය | ඉස්සරහ | නලළ | පිහිටා තිබෙනවා | පෙර | පෙරටු | පෙරමුණ | මුණය | මුහුණ | මුහුණත | මූණත | මූණලා සිටිනවා | යුද පෙරමුණ | විරුද්ධ වෙනවා | හමු
frontages=ඉදිරිය
frontal=නලළට අයිති | ලලාට
frontier=දේශසීමාව | ප්‍රත්‍යන්ත | ප්‍රත්‍යන්ත දේශය | ප්‍රාන්තය | මායිම
frontispiece=ආමුඛ වත්‍රය | මුඛ වත්‍රය | මුඛවත්‍රය
frontlet=නලල් පටිය
frontogenesis=පෙරමුණු උපත
frontolysis=පෙරමුණු නැස්ම
frost=ආලේප කරනවා | තුෂාර | තුහින | තුහින සමය | බලාපොරොත්තු සුන්වීම | මිදුණු පිනි | හිමෙන් වසනවා
frostbite=අධික ශීතල නිසා හමේ ඇතිවන තුවාල
frosting=හිමැයීම
frosty=අතිශීතල | ලේදරාවක් නොදක්වන
froth=අධිකව කෝප වෙනවා | ප්‍රලාප | පෙණ | පෙන | පෙන දමනවා | පෙඳ
frother=පෙණකුරුව
frothing=පෙණ නැගීම
frothy=ප්‍රලාප සහිත | පෙන සහිත
frottage=පරිමර්ධනය
frotteur=මාර්ජකයා
froward=මුරණ්ඩු
frown=අප්‍රසන්නතාව දක්වනවා | බැම අකුළනවා | භ්‍රෑකුටිලය | රවනවා | රැවිල්ල | රැවීම | රැවුම
frowning=රැවීම
frowsty=පුස් බැඳුණ
frowzy=කිලුටු | දුර්ගන්ධ
frozen=කැටි ගැසුණු | මිදැවු | මිදුණු | ශීතකළ | සීතිකෘත | හිමායිත
fructescence=පල දරන කාලය | පල දැරිම
fructiferous=පලබර
fructification=ඵල දැරීම | බීජාණුකරය
fructify=දැරීමට සලසනවා | ඵල දරනවා
fructose=ප්‍රක්ටෝස් | පෘක්ටෝස් | ෆෲක්ටෝස්
frugal=චාම් | සකසුරුවම් වූ
frugality=අරපරික්සම | අරපරෙක්සම | අරපිරිමැස්ම | උප්පරවැට්ටිය | චාම්කම | පිරිමැස්ම
frui=බුක්ති විඳීම
fruit=ගෙඩිය | දැරීමට සලසනවා | පල | පලතුරු | පලවැල | ප්‍රයෝජනය | ඵල | ඵල දරනවා | ඵලය | ලාභය | විපාකය
fruitarinan=පලතුරු කා වත්වන්නා
fruiterer=පලතුරු වෙළෙන්දා
fruitful=අමෝඝ | පල දරන | පලවත් | ඵලදායක | ඵලදායී | භවික | සපල | සාරවත්
fruition=පලදැරීම | ඵලසම්පත්තිය | බලාපොරොත්තු ඉෂ්ට වීම
fruitless=අඵල | අසාර්ථක | නිරර්ථක | නිෂ්ඵල
fruitlet=ඵලිකාව
fruits=පලාපල | ඵලාඵල
fruity=ඵල ගන්ධික | ඵලරස ඇති
frump=වැරහැලිකාරිය
frustrate=නිෂ්ඵල කරනවා | භංග කරනවා | ව්‍යර්ථීකරණය කරනවා
frustrated=ව්‍යර්ථීකෘත
frustration=ඉච්ඡාභංගය | නිෂ්ඵල කිරීම | භංගත්වය | ව්‍යර්ථීකරණය
frustrum=ඡින්නකය
frustum=කේතු ඡින්නකය | ඡින්නකය
frutex=ගොමුව
fruticose=ගොමුවන්
fry=කුඩා මාළුවර්ග | පලහනවා | බදිනවා | බැදුම | බැදෙනවා
frying=වරි වරිය
fucaceous=පියුකස් වැනි
fuchsia=මල් ගසක්
fucosan=පියුකොසාන්
fucoxanthin=පියුකොසැන්තින්
fuddle=මත් කරනවා | මත් වෙනවා | වෙරි කරනවා | වෙරි වෙනවා
fudge=බොරු ප්‍රබන්ධ කරනවා | හෑල්ල
fuel=ඉන්ධන
fuelling=ඉන්ධන දැමීම | ඉන්ධන පිරවීම
fuels=ඉන්ධන
fufil=ඉටුකරනවා
fugacious=අවර | අස්ථිර | පලා යන
fugitive=ඉක්මණින් පහව යන | ක්ෂණික | පලා යන | පලායිත | පලායිතයා | භයින් පලා යන්නා | රහසින් පලා යන්නා
fugitometer=ලායනමානය
fugue=විස්මෘතික පලායනය | සංගීත විශේෂයක්
fuhrer=දුෂ්ට පාලකයා
ful=යුක්ත | සහිත
fulcrum=අඩය | උපස්තම්භය | ධරය
fulfil=ඉෂ්ට කරනවා | ක්‍රියාවෙහි යොදවනවා | සපුරනවා | සම්පූර්ණ කරනවා | සිද්ධ කරනවා | සිදු කරනවා
fulfill=ඉටු කරනවා | සම්පූර්ණ කරනවා
fulfilment=ඉෂ්ට කිරීම | පූරණය | සම්පූර්ණ කිරීම
fulgency=දීප්තිය
fulgent=ප්‍රභාවත්
fulguration=විද්‍යෝතනය
fuligineous=දුඹුල්වන්
fuliginose=දුඹුල්වන්
fuliginous=දුඹුල්වන්
full=අතිශයින් | අශේෂ | පරිපූර්ණ | පරිසමාප්ත | පිරි | පිරුණු | පීණ | පුණු | පුන් | පුර | පූර්ණ | විශාල | සංකට | සපිරි | සම්පූර්ණ ඉඩක් නැති | සම්පූර්ණයෙන් | ස්ථූල | සියලු ලෙසින් | සුපුන් | හරියටම
full-moon=පසළොස්වක | පුරහඳ | පුරාහඳ
full-stop=නැවතීමේ ලකුණ
fulldress=සම්පූර්ණ ඇඳුම් කට්ටලය
fuller=රෙදි අපුල්ලන්නා | වළ කටුව
fullering=ඇළි කැපීම | කාන්දු වැරීම
fullmoon=පුරා හඳ
fullmouthed=මහ හඬැති | ව්‍යක්ත
fullness=පූර්ණත්වය | සම්පූර්ණත්වය
fulls=තෙර වැටි
fullstop=තිත
fully=අතිශයින් | සම්පූර්ණයෙන් | හරියටම
fulmar=මුහුදු ලිහිණියෙක්
fulminate=ගර්ජනා කරනවා | ගුගුරනවා | පුපුරනවා
fulminating=ස්ඵෝටන
fulmination=ගිගිරීම
fulminatory=පුපුරන
fulness=සම්පූර්ණත්වය
fulsome=අත්‍යධික | නොමනා | පිළිකුල් උපදවන
fumarole=වාමුව
fumble=අතපත ගානවා | අදක්ෂ ලෙස කටයුතු කරනවා
fume=කෝපාවිෂ්ට වෙනවා | දුම් ගස්සනවා | දුම් දමනවා | දුමෙන් වේළනවා | නපුරු දුම | මහත් කෝපය | වාෂ්පය | වාෂ්පය නික්මෙනවා | විෂ ධූමය
fumes=දුමාරය
fumigant=ධූමකය | ධූමකරය
fumigation=දුම් ගැසීම | දුම්ගැස්සීම | ධූමකරණය | ධූමනය
fumigator=දුම් කුටීරය
fuming=සධූම
fump=පිම්ම
fun=කවටකම | පරිහාසය | ලෙල්ලම | විනෝදය | විහිළු | විහිළු තහළු | විහිළුව | සමච්චලය | සරදම | සෙල්ලම
function=උත්සවය | කම | ක්‍රියා කරනවා | ක්‍රියාව | කාර්ය | කාර්යය | කෘත්‍ය | කෘත්‍යය | කෘතිය | නියම වැඩ කරනවා | නිල දරා සිටිනවා | නිලය | ඵලය | වැදගත් රැස්වීම | වෘත්තිය | ශ්‍රිතය | ශ්‍රීතය | සාද | සිදු කරනවා
functional=ක්‍රියාකාරිත්වය පිළිබඳ වූ | කෘත්‍යත්මක | කෘත්‍යයාත්මක | ශ්‍රිතීය | ශ්‍රිතීයය
functionalism=කාර්යබද්ධ වාදය | කාර්යබද්ධවාදය | කෘත්‍යවාදය
functionality=ශ්‍රිතීයතාව
functionaries=නිලධාරීහු
functionary=අධිකාරී තැන | කාර්යකාරකයා | නිලධාරියා
functor=ශ්‍රීත සංකේතය
fund=අරමුදල | මුල් මුදල | රාශිය | සම්භාරය
fundament=මූල
fundamental=ආවශ්‍යක | ආවශ්‍යක කොටස | තත්ත්වය | ප්‍රධාන | මුලික | මූලධර්මය | මූලික | මෞලික
fundamentalism=මූලධර්මවාදය
fundamentalist=මූලධර්මවාදියා
funds=අරමුදල්
fundus=බුධිනය
funeral=අවමංගල්‍යය | අවමඟුල | අවමඟුල් පෙරහැර | ඉළවුව | උළව්ව | මළ ඉලව්ව | මළගම | වළහම | වළහම් | වළාම්
funereal=දුක්මුසු | ප්‍රීතියෙන් තොර වූ | ශෝකාත්මක
funfair=විවිධ ප්‍රසංගය
fungal=දිලීර
fungi=දිලීර | පුස්
fungible=ප්‍රතිමොජන | ප්‍රතිමොජ්‍ය
fungicide=දිලීර නාශකය
fungoid=දිලීර | දිලීරාකාර
fungold=හතු වැනි
fungues=දිලීර | පුස්
fungus=ගල්මල් | දිලීර | දිලීරය | දුඹුලු දිලීරය | පුස් | හතු වර්ග
funicle=කඹය | ඩිම්බ වෘන්තය | ලනුව
funicular=කඹ යොදන ලද
funiculus=ඩිම්බ වෘන්තය
funk=බියගුල්ලා | භය කරනවා | භය වෙනවා
funky=බියෙන් මිරිකුණු
funnel=කට පළල් නළය | කෙමිය | දුම් නළය | ප්‍රණාලය | පුනීලය
funny=පරිහාසක | විහිළු | සරදම් සහිත | හාස්‍ය උපදවන
funnybone=වැළමිටේ ඇටය
fur=කාරම් ඉවත් කරනවා | මල
furanose=පුරනෝස්
furbelow=ලොවිච්වය
furbish=අලුත්වැඩියා කරනවා | ඇතිල්ලීමෙන් ඔපදමනවා
furcate=අතු විහිදුණ | කරුබුන් | බෙදුණ
furiosus=උමතුවා
furious=කෝපාවිෂ්ට | දරුණු | වේගවත්
furl=අකුළා බඳිනවා | දවටනවා
furlong=පරලොම | පර්ලොම | හැතැප්ම කාල
furlough=කලකට නිවාඩුගැනීමේ අවසරය | විශ්‍රාමය
furnace=උදුන | ඌෂ්මකය
furnance=ඌෂ්මකය
furnish=පුරවනවා
furnishings=ගෙයි ඇති බඩු
furniture=ගෘහ උපකරණ | ගෘහ භාණ්ඩ | ගෘහභාණ්ඩ | බඩුමුට්ටු
furor=ඉතා බලවත් ආශාව | මහත් උනන්දුව | මහත් ප්‍රසාදය
furore=ඉතා බලවත් ආශාව | මහත් උනන්දුව | මහත් ප්‍රසාදය
furrier=ලෝම වෙළෙන්දා
furrow=පුරන් කොටනවා | රැළිගැසෙනවා | වැකරැල්ල | ශීතාව | හිවැල | හී හානවා | හීවිට
furrowed=ඇලි වැටුණු
furrowing=සෑරී යෑම
furry=කාරම් බැඳුණු | රෝම සහිත | ලොම් සහිත
furs=සිනිඳු මයිල්
further=ආධාර කරනවා | ඇරත් | තව | තවද | තවදුරට | වැඩිදුර | වැඩිපුර
furtherance=ආධාරය | වරස්ථිතිය | වැඩිදියුණු කිරීම
furthermore=ඇරත් | එපමණක්ද නොව | තවදුරට | තවදුරටත්
furtherst=ඉතා දුර වූ | දූරතම
furthest=ඉතා දුර වූ | දුරතම වූ
furtive=රහසින් කරන | හොරෙන්
furtum=සොරකම
fury=ඉතා තද කෝපය | උන්මාදය | ක්‍රෝධය | රෝෂය | රෞද්‍රභාවය | වියරුව
furze=ඉපල්
fuse=උණු කරනවා | උණු වෙනවා | ගිනිනූල | ගිනිනූලක් යොදනවා | විලයනය කරනවා | විලායකය | විලින වෙනවා | විලීන කරනවා | විලීන වෙනවා | සංයෝජනය කරනවා | සේව නූල | සේවනූල | හා කරනවා | හා වෙනවා
fused=විලීන | සංයුක්ත
fuselage=අහස් යාත්‍රාවේ රාමුව
fusibility=විලයනීයතාව
fusible=උණු කළ හැකි | උණු කළහැකි | උණුවෙන | වහා උණු වන | විලයනීය
fusiform=තර්කුරූපී
fusil=අත් තුවක්කුවර්ගයක්
fusileer=සැහැල්ලු අත්තුවක්කුව සහිත භටයා
fusillade=වෙඩිමුරය
fusiller=සැහැල්ලු අත්තුවක්කුව සහිත භටයා
fusion=උණු කිරීම | උණු වීම | විලයනය | සංකරය | සංයෝජනය | සම්පර්කය | සම්බන්ධ වීම | හා කිරීම | හා වීම | හාවීම
fuss=කලබල කරනවා | කලබල වෙනවා | කුලප්පුව
fussy=කලබල
fustian=දළ කපුපිළි වර්ගයක් | බොරු ආටෝප ඇති
fusty=පුස් ගඳ ඇති | පුස් බැඳුණු
futile=නිරර්ථක | වැඩකට නැති
futility=නිෂ්ඵලභාවය
future=අනාගත | අනාගතය | අපර | ඉදිරිය | පසු | භවිෂ්‍යත් | මතු | මතු ඇති වන | වෙන්නට යන | සම්පරාය | හෙට
futures=ඉදිරි | ඉදිරි ගණුදෙනු | ඉදිරි ගනුදෙනු
futurism=අනාගතවාදය | ඇතැම් වත්‍ර කලාකාරයන්ගේ විශේෂ කලා ක්‍රමයක්
futurist=අනාගතවාදියා
futuristic=ඇතැම් වත්‍ර කලාකාරයන්ගේ විශේෂ කලා ක්‍රමය අනුගමනය ක
futurity=අනාගතය | මතු විතය
futurology=අනාගතාවබෝධ විද්‍යාව
fuzz=ඉතා සිනිඳු කුඩු | ඉතා සිනිඳු කුඩුවලින් ගැවසුණු | ඉතා සිනිඳු මවිල් | ඉතා සිනිඳු මවිල්වලින් ගැවසුණු
fuzzy=බොකුටු වූ | සිනිඳු මවිල්වලින් ගැවසුණු
fx-officio=නිල බලයෙන්
fy=චී | තූ | වහ්
