g=ග්‍රැම | සංගීතයේ ස්වරයක්
g=ග්‍රැම | සංගීතයේ ස්වරයක්
g.a.=ගරාදි සරිය
g.l.=භූමි මට්ටම
g.n.p.=දළ ජාතික නිෂ්පාදනය | දළ ජාතික නිෂ්පාදිත | දළ ජාතික නිෂ්පාදිතය
gab=කත්තුව | නන් දෙඩවිල්ල | වාචාලකම
gabble=කටවාචල් කියනවා
gabbro=ගැබ්‍රෝව
gabelle=ගබෙල් බද්ද | ලුණු බද්ද
gaberdine=ගැබඩින් | ගැබන් | බුරුල්ව අඳින දිග කබාය
gabion=ගැබියම
gable=කුරිංවය | ගේබලය
gaby=දොඩමලු
gad=ඊතලයේ තුඩ | කුළින්න | කූඤ්ඤය | දෙයියනේ | යවුල | විනෝදයට නිකරුණේ ඇවිදිනවා | හෙල්ලේ තුඩ
gad-fly=ඇටමැස්සා
gadfly=ඇටමැස්සා
gadolinite=ගැඩොලිනයිට්
gadolinium=ගැඩොලිනිම්
gadroon=සැරසිලි වාටිය
gael=ස්කොට්ලන්තයේ කඳුකර වැසියා
gaelic=ස්කොට්ලන්තයේ කඳුකර වැසියා පිළිබඳ වූ | සෙල්ටික් භාෂාව
gaff=රුවල් දණ්ඩ
gaffer=කම්කරු පිරිසේ බාස් | තලත්තානියා | වෘද්ධ ගැමියා | සීයා
gag=මුකවාඩම | මුකවාඩම් බඳිනවා | රවටනවා
gaga=විකාර
gage=ඇපය | ඔට්ටම | ඔට්ටුව | ඔඩපනය | පොරොන්දුව | සටනට කැඳවීම
gager=ඩැහි ඇණය | ඩැහිය
gagger=ඩැහි ඇණය | ඩැහිය
gaggle=හංස රැළ
gaiety=උත්සවශ්‍රීය | ක්‍රීඩාපරවස බව | ප්‍රමෝදය
gaily=කෙළි සෙල්ලමින් යුක්තව | මහත් ප්‍රීතියෙන්
gain=කට්ටය | දිනනවා | දියුණුව | ප්‍රතිලාභය | ප්‍රයෝජනය | යහපත | ලාබය | ලාභය | වාසිය
gaine=පාදභාගය
gainful=වාසි ලැබෙන
gainings=ලාභ ප්‍රයෝජන
gainsay=නැත කියනවා | පටහැනිව කථා කරනවා
gait=ගමන | ගමන් ලීලාව | ගමන් විලාසය
gaiter=කෙණ්ඩා වැස්ම
gal=කෙල්ල | ගැලය | ගැලුම | සුන්දරී
gala=උත්සවය
gala-night=ප්‍රහර්ෂ රාත්‍රිය
galactan=ගැලැක්ටෑන්
galactase=ගැලැක්ටේස්
galactic=තාරකා මණ්ඩලයට අයත්
galactin=ගැලැක්ටින්
galactometer=ක්ෂීරපරීක්ෂකය | ගැලැක්ටෝමීටරය
galactose=ගැලැක්ටොස් | ගැලැක්ටෝස්
galantine=කුකුළු මස් ආදිය කපාකොටා තම්බා සිසිල් කොට තනාග
galaxy=ආකාශ ගංගාව | උත්කර්ෂවත් සමූහය | චක්‍රවාටය | තරු වැළ | තාරකා මණ්ඩලය | මන්දාකිණිය | මන්දාකිනිය
gale=චණ්ඩ මාරුතය | මාරුතය | සැර සුළඟ
galea=ගේලියාව | ශිරස්කය
galeate=පෙණැති | ශිරෂ්කාකාර | ශිරස්කාකාර
galena=ගැලීනා
gall=ක්‍රෝධ ඉපදීමට හේතුව | ගඩුව | පිත | පිළිල වර්ගයක් | බලවත් ක්‍රෝධය
gall-stone=අශ්මරී
gallant=කාමුක | නිර්භීත | රමණයා | වල්ලභයා | වීර | ශූර | සල්ලාලයා | ස්ත්‍රීන් කෙරෙහි ඇලුණු
gallantry=දාක්ෂිණ්‍යය | නිර්භීතකම | සල්ලාලකම
galleon=ස්පාඤ්ඤයේ විශාල රුවල් නැව
gallery=ගැලරිය | නෘත්‍යශාලාවක ගැලරිය | වත්‍ර ප්‍රදර්ශන ශාලාව | සක්මන
galley=හම්බාන
galliard=පැරණි නැටුම් විශේෂයක්
gallic=ප්‍රංස | ප්‍රංසයට අයත්
gallicism=ප්‍රංශ ආප්තෝපදේශය
galling=කටුක | ඛේදජනක
gallipot=තෙල් බඳුන
gallium=ගැල්ලියම් | මූලද්‍රව්‍යයක්
gallivant=සෙල්ලමෙහි යෙදී ඇවිදිනවා
gallnut=අරළු
gallon=ගැලුම
gallop=ඉක්මණින් ගමන් කරනවා | ඉක්මන් ගමන | නැටුමට යෝග්‍ය සංගීතය | පැන පැන දුවනවා | පිම්ම | පිම්මේ යනවා | වල්ගිතය | වැඩ කරනවා | ශීඝ්‍ර නැටුම් විශේෂයක්
galloping=වල්ගනය
gallows=එල්ලුම් ගස | එල්ලුම් ගහ | එල්ලුම්ගස | පෝරකය
galore=ඉතා බහුලව
galosh=වැසි කාල රබර් පාවහන්
galton=ගෝල්ටන් නලාව
galumph=කලබලයෙන් දුවනවා
galuntlets=බාකොපු
galvanic=ගැල්වානි
galvanism=ගැල්වානිස්මය
galvanize=ගැල්වනයිස් කරනවා | ගැල්වනවා | ගැල්වනී කරනවා | මහත් සේ උනන්දුකරවනවා | විදුලි ශක්තිය වද්දවනවා | විදුලි ශක්තියයොදනවා
galvanized=ගැල්වනයිස්
galvanizing=ගැල්වනී කිරීම
galvanochemistry=විද්‍යුත් රසායන විද්‍යාව
galvanograph=ගැල්වනොරේඛය
galvanometer=ගරල්වනොමීටරය | ගැල්වනෝමීටරය | ගැලිවනොමීටරය | විද්‍යුත්ශක්තිමාපකය
galvanometry=ගැල්වනොමිතිය
galvanoscope=ගැල්වනොස්කෝපය
galvanostegy=ගැල්වනොලේපය
galvanotactic=විද්‍යුත්සාර්වසර
galvanotaxis=ගැල්වනොසරණය | විද්‍යුත් සාර්වසරණය
galvanotropic=විද්‍යුතාවර්තී
galvanotropism=ගැල්වනොවර්තනය | විද්‍යුතාවර්තනය
galvinism=විදුලි ශක්තිය
gambit=පසුව ජය ලැබීම පිණිස මුලදී පාඩු විදීම | වෙස් ක්‍රීඩාව ආරම්භ කරන එක්තරා පිළිවෙළක්
gamble=සූදු කෙළිනවා | සූදුව
gambler=අක්ෂධූර්තයා | ධූර්තයා | සූදු කෙළින්නා | සූදුකාරයා
gambling=දූකෙළිය | සූදු කෙළීම | සූදුව | හූදුව
gamboge=ගැම්බෝජ දුම්මල | ගැම්බෝජ වර්ණය | ගැම්බෝජ් | ගොකටු | ගොරක මැලියම් | පඬු පාට
gambol=දුවපැන සෙල්ලම් කරනවා | පෙම් කෙළිනවා | පෙම් කෙළීම
gambusia=ගැම්බූසියා
game=අබලන් වූ | කපටකම | ක්‍රීඩාව | තරඟය | දඩමස් | දඩයම | ද්‍යුත | ධීරභාවයෙන් යුක්ත | නොන්ඩි | බලාපොරොත්තුව | වංචාව | විහිළුව | සරදම | සූදානම් | සූදු කෙළිනවා | සූදුව | සෙල්ලම
game-dealer=සූදු අන්තුවා
games=ක්‍රීඩා
gamesome=ක්‍රීඩාවෙහි ඇලුණු
gamester=සූදුකාරයා
gametangium=ගැමිටැන්‍ය | ජන්මාණුධානිය
gamete=ජන්මාණුව | මේරූ ජන්මානු සෛල
gametogenesis=ජන්මාණු ජනනය
gametophyte=ජන්මාණුශාකය
gamin=ඉබාගාතේ යන කොල්ලා
gamine=දඟකාර හැඩ කෙල්ල
gaming=සූදුව
gamma=ග්‍රීක හෝඩියේ අකුරක් | ගැමා
gammadion=ගැමා පූට්ටුව
gammagraph=ගැමාරේඛය
gammer=ආච්චි | මැහැල්ල
gammon=පිස්සු | බොරුව
gamogenesis=ජන්මාණු යෝග ජනනය
gamopetalous=බද්ධදල
gamophyllous=බද්ධපත්‍රී
gamosepalous=බද්ධමණිපත්‍රී
gamp=අඹරා කුඩේ
gamut=සර්වස්වය | ස්වර සප්තකය
gander=පාත්තයා
gandhism=ගාන්ධි වාදය
ganesh=ගණ
gang=කට්ටිය | කණ්ඩායම | කල්ලිය | ගොල්ල | යනවා | රංචුව | රැළ | සමූහය | හවුල | හැත්ත | හැතිකරය
gangagley=වැරදී යනවා
ganger=කට්ටි නායකයා | කම්කරු පිරිසේ කන්කානම
ganging=සමුළු ගැන්නීම
gangling=මනාව නොවැඩුණු | හීන්දෑරි
ganglion=ගණ්ඩුකය | ගැංග්ලියම | නහර ගැටය | ශිරාග්‍රන්ථිය
gangrene=ඔඩු දුවනවා | කෝථය
gangster=තක්කඩියා | මැරයා
gangue=ගැංගිය
gangway=ආසන අතර මාර්ගය | නැවට නගින බහින තරප්පුව | පෙත්මඟ
ganister=ගැනිස්ටර | ගැනිස්ටර්
ganja=කංසා | ගංජා | ගන්ජා
ganjah=ගංජා
gannet=විශාල මුහුදු කුරුල්ලෙක්
ganosis=නුදුලනය
gantry=දොඹකරේ මැස්ස | පීප්ප තබන මැස්ස | බාල්දි තබන මැස්ස | මැස්ස
gaol=දඟගේ | බන්ධනාගාරය | සිරගෙය | හිරගෙය | හිරගේ | හිරේ දමනවා
gaoler=බන්ධනාගාර භාරකරු | සිරගෙය බාරකරු | හිරගෙයි මුලැදෑනියා
gap=අන්තරය | කඩ | කඩුල්ල | කපල්ල | කපොල්ල | පරතරය | භේදය | විවරය | හිඩැස | හිදැස | හිදැස්ස
gap-gauge=ස්පර්ශක ආමානය
gape=ඇරී තිබෙනවා | ඈනුම | ඈනුම් අරිනවා | කට අයාගෙන සිටීම
garage=ගරාජය
garb=පළඳිනවා | පිටස්තර පෙනුම | වේශය
garbage=කසල | කසළ | කුණු කසළ | කුණුකසල | රොඩු | සංකාර
garble=තමන්ට වුවමනා දේ පමණක් තෝරා ගන්නවා
garden=ආරාමය | උද්‍යානය | උයන | කොටුව | කොරටුව | ගෘහෝද්‍යානය | ගෙඋයන | ගෙවත්ත | ගෙවුයන | පලතුරු වවනවා | මල් වවනවා | මල්වත්ත | වත්ත | වත්තේ වැඩ කරනවා | වනය
gardener=උයන්පල්ලා | වතුකාරයා
gardenia=ගාඩිනියා මල
gardening=ගෙවතු වගාව | වත්තෙහි වැඩ කිරීම
garfish=හෙල්ලය වැනි හොටක් ඇති මාළුවෙක්
gargantuan=අති විශාල | යෝධ
gargle=උගුර දෙවුම | උගුර සේදීමට යොදන බෙහෙත් වතුර | උගුර සෝදනවා
gargoyle=දියගිරිය | වතුර පිටවීමට යොදන නළය
garibaldi=මුද්‍රික ඵල අඩංගු විස්කෝතු විශේෂයක්
garigue=ගැරිග් | වනාන්තර
garish=අතිභූෂිත
garland=දම | දාමය | මල් මාලය | මල් මාලාව | මල්දම | මල්දමක් පළඳවනවා | මල්වඩම | මල්වැල | මාලා | මාලාව | වට පීල්ල | වඩම
garlic=එළලුහුනු | ලශුන | ලසුනු | සුදු ලූනු | සුදුලූනු | සුදුළුනු
garment=ඇඳුම | වස්ත්‍රය | සළු
garner=අටුව හෝ කොටුව | කොටුගුළ | ගබඩා කරනවා
garnet=රතු මැණික් වර්ගයක් | රබහ | රව්ව
garnish=අලංකාර කරනවා | සරසනවා
garnishing=අලංකාරෝපකරණ | භූෂණය
garniture=අලංකාරය | මණ්ඩනය
garotte=බෙල්ල මිරිකා මරනවා | බෙල්ල මිරිකා මැරීම
garret=අට්ටාලය | සී මැදුර
garrison=ආරක්ෂක පිරිසක් යොදනවා | ආරක්ෂක සේනා සහිත බලකොටුව | නගරාරක්ෂක හමුදාව | බලකොටුවේ ආරක්ෂක හමුදාව
garrotte=බෙල්ල මිරිකා මරනවා | බෙල්ල මිරිකා මැරීම
garrulity=කට වාචාලකම
garrulous=කටකාර | දොඩමලු | වාචාල
garrulousness=කට වාචාලකම
garter=ජංඝාබන්ධනිය | මේස් පටිය
garzone=අතවැසියා | අභ්‍යාසියා
gas=ගෑස් | වල්පල් දොඩනවා | වායු | වායුව | විෂවායු පතුරුවා හරිනවා | විෂවායුව
gas-filled=වායු පූර්ණ
gas-vacuole=වායු රික්තකය
gasconade=ආත්ම වර්ණනාව
gased=වායු වැද්දුණු
gaselier=ගෑස් වලින් දැල්වෙන ලාම්පු පොකුර
gaseous=වායු | වායුමය | වායුරූප
gases=වායු
gash=කෙටුම | කොටනවා | තුවාල කරනවා | තුවාලය
gasing=වායු වැද්දීම
gasket=ගැස්කට්ටුව | ගෑස් කට්ටුව | ගෑස්කටය | වාවුරුව
gasoleine=පෙට්‍රල්
gasolene=පෙට්‍රල්
gasoline=ගැසලීන්
gasometer=වායුමානය
gasometric=වායුමිතික
gasp=අමාරුවෙන් කතා කරනවා | අමාරුවෙන් හුස්ම ගැනීම | පණ අදිනවා
gassing=වාතැවීම | වායු නැඟීම | වායු සර්ජනය
gasterolichenes=ගස්ටෙරොලිකේනේස්
gasteromycetes=ගස්ටෙරොමිසේටේස්
gasterothalameae=ගස්ටෙරොතලමේ
gastrectomy=ජඨර විච්ඡේදනය
gastric=ආමාශය පිළිබඳ | ආමාශයික | ජඨර | ජඨරක | ජඨරී | ජඨරීය
gastrin=ගැස්ට්‍රින්
gastritis=ආමාශයේ දැවිල්ල | ජඨරදාහය
gastro-enteritis=ජඨර
gastro-enterostomy=ජඨරඅන්ත්‍ර ද්වාරණය
gastro-jejunostomy=ජඨර ශූන්‍යන්ත්‍රක ද්වාරණය
gastrocnemius=ප්‍රේෂ්ටා ජඨරකය
gastronome=ස්වාදුභක්ෂකයා
gastronomer=ස්වාදුභක්ෂකයා
gastronomist=ස්වාදුභක්ෂකයා
gastronomy=ස්වාදු භෝජනකලාව
gastrophile=ස්වාදුභක්ෂකයා
gastroscopy=ජඨරේක්ෂණය
gastrostomy=ජඨර ද්වාරණය
gastrotomy=ජඨර ඡේදනය
gastrula=ගැස්ටෲලාව
gate=අය | අයකිරීම | ඇතුල්වීමේ මාර්ගය | කඩුල්ල | කඩුලු | ගේට්ටු වසනවා | ගේට්ටුව | ගෝපුරය | ද්වාරය | දොර | දොරටු | දොරටුව | නළ දොර | ප්‍රතිහාර | ප්‍රවේශ ගාස්තුව | ප්‍රවේශය | මාරුතය | මුඛ | වාසල | වාසල්කඩ | වාහල
gate-keeper=ද්වාරිකයා | දෝවාරික
gateau=කේක් විශේෂයක්
gatekeeper=දොරටුපාල
gateway=තොරණ | ද්වාර මාලකය | ද්වාරය | දොරගඩ | වාහල්කඩ
gather=අවුලනවා | ඇඳුමේ රැල්ල | ඇහිඳිනවා | එකතැන් කරනවා | එකතැන් වෙනවා | එක් කරනවා | එක්කාසු කරනවා | කඩනවා | මුළු දෙනවා | රැලි කරනවා | රැලි දමනවා | රැස් කරනවා | රැස් වෙනවා | රැහි කනවා | රොක්වෙනවා | වටහා ගන්නවා | වැඩි කරනවා | වැඩි වෙනවා | හවුළනවා
gathered=උපවත | සංගත
gatherer=නෙලන්නා | රැස් කරන්නා
gathering=එකතුව | ගණ | පිටු එකතුව | පිරිස | රැඳීම | රැඳුම | රැස් කිරීම | රැස්වීම | සණ්ඨාපනය | සන්නිපාතය | සභාව | සම්භාර | සමූහය | සමෝධානය | සැරව සහිත ගඩුව
gating=කඩුලු ලෑම | කඩුලුවම
gatt=තීරුබදු හා වෙළඳාම පිළිබඳ පොදු සම්මුතිය | තීරුබදු හා වෙළෙඳාම පිළිබඳ පොදු සම්මුතිය
gauche=අදක්ෂ | අශෝභන | වමත්
gaucherie=අපරීක්ෂාකාරීත්වය | අශෝභනත්වය
gaucho=දකුණු ඇමෙරිකා ගොපල්ලා
gaud=ආයිත්තම | ප්‍රීත්‍යත්සවය
gaudiness=අතිභූෂණ්‍ය
gaudy=අතිභූෂිත | නොමනා අලංකාරයෙන් සැරසුණු
gauge=ආමානය | තරම | පරිමාණය | මාත්‍රාව | මාපන යන්ත්‍රය | මිනුම | මිනුම් ගන්නා උපකරණය | මිම්ම | වරක්කලය
gauger=ලේගරවල ඇති බිම ප්‍රමාණය මනින්නා
gauging=මැනීම
gaultherase=ගවුල්තෙරේස්
gaultherin=ගවුල්තෙරීන්
gaunt=කෘශ | කෙට්ටු | වෑරුණු
gauntlet=යකඩ අත්වැස්ම
gaur=ගවරා
gauss=ගවුසය | ගවුස් | චුම්බක ප්‍රේරණය මනින මිම්මක්
gauze=ඉතා සිහින් පිළි | කම්බි දැල් | දැල් රෙදි | නුදැල
gavanic=අතිශයින් උනන්දු සහිත | මහත් වේගවත්
gavel=වෙන්දේසිකරුගේ මිටිය | සභාපතිගේ මිටිය
gavotte=නැටුම් විශේෂයක්
gawk=මෝඩයා
gawky=නිවට | හැඩහුරුකමක් නැති
gay=උල්ලසිත | කෙළි සෙල්ලමින් යුත් | ප්‍රභාසම්පන්න | ප්‍රීතියෙන් කල් ගතකරන | විලාසවත්
gaze=නිරීක්ෂය | බද්ධ දෘෂ්ටිය | සනෑකමින් බලා සිටිනවා
gazebo=ගිම්හාන කුටිය
gazelle=කුරංගයා | මුව වර්ගයේ සතෙක්
gazette=ගැසට් කරනවා | ගැසට් පත්‍රය | ප්‍රවෘත්ති පත්‍රය
gazetteer=ප්‍රදේශ වර්ණනය
gazump=එකඟවීමට පසු මිල උස්සනවා
geanticline=මහා උඩු නැම්ම
gear=අවශ්‍ය උපකරණ | ආම්පන්න | එකිනෙකට ගැළපෙන දැතිරෝද | ගියරය | පන්න
gearing=ගියර එලවුම | ගියර් එළවුම | ගියරුම | තෝලනය
geat=දොර
gecko=හූණා | හූනා
geedy=ලෝල
geest=ගීස්ට්
geezer=සීයා
gehenna=නරකාදිය | වධබන්ධන සහිත ස්ථානය
geisha=විලාසිනී
geist=ජීවගුණය
geitonogamy=පසල් යෝගය
gel=ජෙලය
gel-coat=ජෙල්ලේපය
gelate=ජෙලීකෙරණය
gelatin=ජෙලටින් | සත්ත්ව ලාටු
gelatine=ජෙලටින් | සත්ත්ව ලාටු
gelatinize=ජෙලටිනි කරනවා | ජෙලිග් නයිට්
gelatinous=ජල්ලි වැනි | ජෙලටිනිය | ලාටු සහිත
gelation=ජෙලීකරණය
geld=කප්පාදු කරනවා
gelding=කර ඇඹීම
gelegnite=නයිට්‍රොග්ලිසරීන්
gelid=අතිශීත
gelignite=ගෙලිග්නයිට්
gem=අනර්ඝ වූ දේ | මණ | මණි | මාණික්‍යය | මැණ | මැණික | මැණික් ගරනවා | මැණික්වලින් සරසනවා | මිණ | මිණි | රතන | රත්න | රත්නය | රුවන | රුවන්
gem-form=ජෙම් ආකාරය
gemeinschaft=ජෙමයින්ෂාප්ට් | ප්‍රජාව
geminate=යුගල වශයෙන් පිළියෙල කරනවා
gemini=මිථුන | මිථුන රාශිය
geminous=ජෝඩු වශයෙන් ඇති
gemma=කෝෂ සංයුක්ත රූපය | ගෙමාව
gemmation=ගෙමාංකුරණය
gemmaux=ජෙම්මෝ
gemming=මැණික් ගැරීම
gemmule=ගෙමිත්ත
gemut=වත්තවේග අනුභූතිය
gen=ප්‍රවෘත්ති
gender=උපදවනවා | ලිංගභේදය | ලිංගය | ලිඟු
gene=ජාන | ජානය | ප්‍රවේණ්‍යණුව
genealogical=වංශය පිළිබඳ වූ | වංශාවලීය
genealogist=වංශාවලී විද්‍යාඥයා
genealogy=පෙළපත | වංශ පරම්පරාව | වංශය | වංශාවලිය
geneic=ප්‍රභවාත්මක
geneology=පෙළපත | වංශාවලිය
genera=ගණ
general=අනිශ්වත | ජනරාල්වරයා | ප්‍රධාන | පොදු | මහජන | මහා | සාකල්‍ය | සාධාරණ | සාමාන්‍ය | සාර්ව | සෙනෙවියා | සේනාධිපතියා
generalisation=ව්‍යාපනය | ව්‍යාප්තීකරණය | සාකල්‍යනය | සාකල්‍යීකරණය | සාධාරණය | සාධාරණීකරණය | සාමාන්‍යයීකරණය
generalise=සාකල්‍යනය කරනවා | සාධාරණ කරනවා
generalised=ව්‍යාප්තීකෘත | ව්‍යාපී | සාධාරිත | සාමාන්‍යකෘත
generalism=සාමාන්‍ය සිජාන්තය
generalissmo=ශ්‍රේෂ්ඨ සේනාධිපතියා | සෙනෙවිරද
generality=පොදු බව | ව්‍යාප්‍යතාව | වැඩි කොටස | සමානත්වය | සාකල්‍යතාව | සාධාරණත්වය
generalization=අනුගමනය | පොදු වශයෙන් සැලකීම | ව්‍යාපනය | ව්‍යාප්තීකරණය | සාධාරණීකරණය | සාමාන්‍යකරණය | සාමාන්‍යයීකරණය
generalize=පොදු බවට හරවනවා | පොදු වශයෙන් අවබෝධයක් ඇති කරගන්නවා
generalized=සාධාරික | සාමාන්‍යකෘත | සාමාන්‍යිත
generally=වැඩි වසයෙන් | සාමාන්‍යයෙන්
generate=ඇති කරනවා | උපදනවා | උපදවනවා | උපදිනවා | ජනනය | ජනනය කරනවා
generated=ජනිත
generating=උත්පාදනය | ජනත | ජනන
generation=උත්පාදනය | ජනනය | ජනනය වීම | පරපුර | පරම්පරාව | ප්‍රතිරූපය | ප්‍රවේණීය | සපපාතිකභාවය
generative=උත්පාදක | ජනක
generator=උත්පාදක | උත්පාදක යන්ත්‍රය | උත්පාදකයා | ජනකය | ජෙනරේටරය
generatrix=ජනිකය
generic=ගණීය | ජනනයීය | ජාතිගත | ප්‍රජාතීය | වර්ගයකට පොදු | වර්ගීය | සාමාන්‍ය
generical=ජාතිගත | වර්ගයකට පොදු | වර්ගීය | සාමාන්‍ය
generically=වර්ගයකට පොදුව
generosity=උදාරත්වය | නිර්ලෝභීබව | සුලභබව
generous=උදාර | ත්‍යාගශීලී | ත්‍යාගී | නිර්ලෝභ | නිර්ලෝභී | විපුල | සුලභ
genesis=උත්පත්ති කථාව | උත්පත්තිය | ජනනය | මූලාරම්භය | සම්භවය
genetic=උත්පාදය පිළිබඳ වූ | ජන්ම | ජාන | ප්‍රවේණි
genetical=උත්පාදය පිළිබඳ වූ
geneticist=ජාන විද්‍යාඥයා
genetics=උත්පාද විද්‍යාව | ජාන විද්‍යාව | ප්‍රවේණි විද්‍යාව
genial=ප්‍රසන්න | සැපදායක | සිනහ මුහුණින් යුත්
geniality=ප්‍රසන්නකම
genic=ජනක | ජානීය
geniculate=ජානුරූපී
genie=බහිරවයා
genii=ඉත දේවතාවෝ | ඉත භූතයෝ | බහිරවයෝ
genital=උත්පත්තිය පිළිබඳ වූ | ජනනේන්ද්‍රීය | ප්‍රජනක
genitalia=ලිංගේන්ද්‍රිය
genitals=ජනනේන්ද්‍රිය | රහස් අවයව
genitive=සම්බන්ධ විභක්තිය
genitor=ජනිතෘ
genius=අධිගෘහිත දේවතාවා | උත්කෘෂ්ට සහජ බුද්ධිය | උත්කෘෂ්ට සාමර්ථ්‍යය | ධීමතා | ප්‍රතිභාවන්තයා | බුද්ධිප්‍රභාව | විබුධයා | ශ්‍රේෂ්ඨ බුද්ධිමතා | සුධීමත්වය | සුධීමතා
genocide=ගණඝාතනය | ජනඝාතය | ජාති ඝාතනය | මහාජන සංහාරය | වර්ගඝාතය
genotype=ප්‍රවේණිදර්ශය
genotypic=ප්‍රවේණිදර්ශීය
genre=ප්‍රභේදය | රීතිය | වර්ගය | විභේදය | විශේෂය
gens=කුලය | ගෝත්‍රය
gent=පිරිමියා
genteel=ආචාරශීලී | කුලීන | වංශවතුන්ට යෝග්‍ය | ශිෂ්ට | ශෝභන
gentian=නිල් මල් ඇති කඳුකර පැළෑටියක්
gentianacease=ගෙන්ටියනාසේ
gentianine=ජෙන්ටියනින්
gentianose=ජෙන්ටියැනෝස්
gentile=අන්‍යජාතික | අන්‍යජාතිකයා | නොයුදෙව්වා | මිථ්‍යාලබ්ධික
gentility=දාක්ෂිණ්‍යය | වංශවත්භාවය | සභ්‍යතාව
gentiobiose=ජෙන්ටියොබයෝස්
gentle=ආචාරසම්පන්න | මෘදු | වංශවත් | සොමි
gentleman=කුලවතා | ගුණවතා | නම්බුකාරයා | පිරිමියා | මහතා | සත්පුරුෂයා
gentlemanly=ආචාරශීලී | ශිෂ්ඨ
gentleness=මෘදුබව
gently=අනුකම්පා සහිත | මෘදු ලෙස | සෙමින්
gentry=උදවිය | උසස් පෙළපතේ අය | මහත්වරු
genuflection=ජානුව | දන නැමීම | දනගසා වැඳීම
genuflexion=දන නැමීම | දනගසා වැඳීම
genuine=අමිශ්‍ර | අව්‍යාජ | අව්‍යාජය | ජන්මීය | නියම | නිර්ව්‍යාජ | නිර්ව්‍යාජය | සත්‍ය | සැබෑ | සොඳ | හැබෑ | හෘදයංගම
genuinely=නියම වශයෙන්
genuineness=අව්‍යාජබව
genus=ගණය | ජනුව | ජාතිය | වර්ගය
geo-anticline=මහා උඩු නැම්ම
geo-centric=භූ කේන්ද්‍රීය
geo-isotherm=භූ සමෝෂ්ණ රේඛාව
geo-morphology=භූ රූප විද්‍යාව
geo-syncline=භූ ද්‍රෝණිය
geocarpy=භූගතඵලනය
geocentric=භූකේන්ද්‍රගත | භූකේන්ද්‍රීක | භූකේන්ද්‍රීය
geochemistry=භූරසායන විද්‍යාව
geochronology=භූකාලානුක්‍රමය | භූකාලානුක්‍රමවේදය | භූතලාන්වය
geocryptophyte=භූගුප්තශාකය
geode=පළුද්දක් ඇති ස්ඵටිකය | යෝඩය
geodesic=භූමිති | භූමිතික | භූමිතිකය
geodesics=භූමිතිය
geodesist=භූමිති විද්‍යාඥයා
geodesy=භුමිතිය | භූමිති විද්‍යාව | භූමිතිය | භූමිතිවිද්‍යාව
geodetic=භූමිතික
geographer=භූගෝල විද්‍යාඥයා | භූගෝල ශාස්ත්‍රඥයා
geographic=භූගෝල ශාස්ත්‍රය පිළිබඳ වූ | භූගෝලීය
geographical=භූගෝල විද්‍යාත්මක | භූගෝලීය
geography=භූගෝල විද්‍යාව | භූගෝල ශාස්ත්‍රය | භූගෝලය | භූගෝලවිද්‍යාව
geoid=ජ්‍යාභය
geolatry=භුවන්දනය
geologic=භූ
geological=ආස්තරය | භූවිද්‍යාව පිළිබඳ වූ
geologist=භූ විද්‍යාඥයා | භූවිද්‍යාව පිළිබඳ ශාස්ත්‍රඥයා
geology=භූ විද්‍යාව | භූගර්භවිද්‍යාව | භූවිද්‍යාව
geomagnetism=භූ චුම්බකත්වය
geomancy=භූපේනය | භූමිවත්‍ර බලා පේන කීම
geomedecine=භූ වෛද්‍යුවිද්‍යාව
geometric=ගුණෝත්තර | ජ්‍යාමිතික
geometrical=ජ්‍යාමිතික
geometrician=ජ්‍යාමිතිය පිළිබඳ විශේෂඥයා
geometry=ජ්‍යාමිතිය | රේඛාගණිතය
geonasty=භූසන්නමනය
geophagy=භූභක්ෂණය
geophilae=භූකාමියෝ
geophilous=භූකාමී
geophone=ජ්‍යාහණනය
geophysical=භූ භෞතික
geophysical-prospecting=භූ භෞතික පිරිසෙවුම
geophysics=භූ භෞතික විද්‍යාව | භූ භෞතිකය | භූභෞතික විද්‍යාව
geophyte=භූශාකය
geopolitics=ජගත් රාජනීති | භූ දේශපාලන
georgette=ජෝජට් | ජෝර්ජට් නැමැති සිනිඳු රෙදි විශේෂයක්
georgian=ජෝර්ජ් රජවරුන්ගේ යුග | පෝයානු
georgic=කෘෂි කාව්‍යය
geotaxis=ගුරුත්වාවර්තනය
geothermometer=භූ උෂ්ණත්වමානය
geotropism=ගුරුත්වාවර්තනය
geranium=මල්ගස් වර්ගයක්
gerbil=කාන්තාරයේ වෙසෙන මූෂික වර්ගයේ සතෙක්
geriatrics=වයෝ විභාගය | වෘද්ධවකිත්සාව
germ=අංකුරය | ජීවාණු | ජීවාණුව | පටන්ගැන්ම | බීජය | මූලප්‍රකෘතිය | මොටෙයිය | රෝග බීජ | රෝගබීජය | වාණුව | විෂ බීජ | විෂ බීජය | සූක්ෂ්ම ජන්තුව
germ-cell=වාණු සෛලය
german=ඇවැස්ස | ජර්මන් ජාතිකයා | ජර්මන් භාෂාව | ජර්මනිය
german-measlea=ජරැමන් සරම්ප
germander=මිංචි පවුලේ පැළෑටියක්
germane=අදාළ වන | කිට්ටු නෑකම් ඇති | ප්‍රස්තුත | සම්බන්ධී
germicidal=විෂබීජනාශක
germicide=විෂබීජනාශකය
germinal=ජන්මාණුක | මූලාවස්ථාවෙහි වූ
germinate=ඉකිරි අදිනවා | කණු ඇදෙනවා | තවන් කරනවා | පැළ කරනවා | පැළ වෙනවා | හපුස්වනවා | හැප්සෙනවා
germinated=හපුන්
germination=ප්‍රරෝහණය | පැළ වීම
germinator=ප්‍රරෝහකය
germplasm=ජනකප්ලාස්මය
germs=ජනකයෝ
geronotogeous=පුරාණ ලෝකය
geronticide=ජරන්තඝාතනය
gerontocracy=ජරාතන්ත්‍රය
gerontology=ජරා විභාගය | ජරාවිභාගය | ජරාවේදය | වාර්ධකවේදය | වෘද්ධ විද්‍යාව
gerophoblia=ජරාභීතිකාව
gerund=භාවක්‍රියාපදය
gesellschaft=ගෙසල්ෂාප්ට් | සංගමය
gesso=ජෙස්සො තලය | පාට කිරීමට හා මූර්ති කලාවට භාවිත කරන ප්සම්
gessticulate=ඉඟි පානවා
gestalt=ගෙස්ටල්ට් | ගෙස්ටාල්ටය
gestapo=ජර්මනියේ නට්සීන්ගේ පොලිස් හමුදාව
gestate=කුසෙහි දරුවකු දරා සිටිනවා
gestation=ගර්භිණී අවස්ථාව | ගැබ් දැරීම | ගැබ්දැරීම
gesticulate=ඉඟිකරනවා | හස්ත මුද්‍රාවෙන් අදහස් පවසනවා
gesticulation=අංගවික්ෂේපය | අභිනය | ඉංගනය
gestroptosis=ජඨරපාතය
gesture=අංගහාරය | අභිනය | ඉංගිතය | ඉංගිතිය | ඉඟි මරනවා | ඉඟිය | හැසිරීම
get=අත්පත් කරගන්නවා | අල්ලාගන්නවා | පමුණුවනවා | පැමිණෙනවා | පෙළඹවාගන්නවා | ලබා දෙනවා | ලබාගන්නවා | ලැබෙනවා | වටහාගන්නවා | වෙනවා | සලසනවා | සොයාගන්නවා
get-together=සමිය
getter=අපහරණය
gettering=අපහාරකය
geum=කුඩා ගෙවතු පැළෑටියක්
gewgaw=කෙලිබඩුව
geyser=උණුදිය උල්පත | ගීසරය
ggenuine=සාත්වික
ghastly=දරුණු | භයානක | මිනියක් වැනි
ghat=ගඟේ පඩිපෙළ
ghats=ඝාත්
ghee=එළඟිතෙල් | ගිතෙල් | ඝත | ඝෘතය | දධිකර | නවනීත | සප්පි
gherkin=ගැටකැකිරි
ghetto=කුප්පායම | ගුම්බෑයම | යුදෙව් ජනාවාසය
ghost=අවතාරය | භූතයා | සොල්මන | හොල්මන
ghostliness=අවතාර වීම
ghostly=අවතාරයක් වැනි
ghoul=මළමිනී කන භූතයා | වේතාලයා
ghoulish=ඝෝර
giant=අතිවිශාල | දැවැන්ත | මානැසින්න | යෝධයා
gib=හිර පළුව
gibber=ප්‍රලාප | ප්‍රලාප දොඩනවා
gibberish=අනන්මනන් | ජල්පිතය | දෙඩවිල්ල | නොතේරෙන භාෂාව | පල් හෑලි
gibbet=තුනැසිය | ප්‍රසිද්ධියේ දොස් කියනවා
gibbon=ගිබන් වඳුරා
gibbose=සකුඹු
gibbosity=කුඹුව
gibbous=කුදු | කුබ්ජ | සකුඹු
gibe=අවඥාව | අවමන් කරනවා | උපහාසය | ඔච්චම | සමච්චල් කරනවා
giddiness=කරකැවිල්ල | කැරකිල්ල | හිස කරකැවිල්ල
giddy=තෝන්තු වූ | නොසැලකිල්ලෙන් ක්‍රියා කරන | විගඩම්කාර | හිස කරකැවිල්ල ඇතිකරවන | හිස කරකැවිල්ලෙන් පෙළෙන
gift=කුසලතාව | ත්‍යාගය | තෑග්ග | තෑගි වශයෙන් දෙනවා | තිළිණය | තුටු පඬුර=අවඥාව | අවමන් කරනවා | උපහාසය | ඔච්චම | සමච්චල් කරනවා
giddiness=කරකැවිල්ල | කැරකිල්ල | හිස කරකැවිල්ල | දැකුම | දීමන | දීමනාව | දීමේ අයිතිය | පරිතෝෂය | සහජ ශක්තිය
gifted=කුලතාපූර්ණ | ත්‍යාග කරන ලද | තෑගි කරන ලද | විශේෂයෙන් දක්ෂ | සහජ දක්ෂතාව | සුභග
gifts=තෑගි | සලක්කම්
gig=රේස් කරත්තය | සැහැල්ලු ඔරුව
gigacycles/sec=ගිගාචක්‍ර තත්පර
giganthropus=ගිගැන්ත්‍රෝපුස්
gigantic=අතිවිශාල | ඉතා බලගතු | යෝධ
gigantism=යෝධතනුකත්වය | යෝධතාව | යෝධබව | වෘහත්තාව
gigantopithecus=ගන්තෝපිතෙකුස් | යෝධවානරයා
giggle=මෝඩ ලෙස සිනාසෙනවා | මෝඩ සිනහව
giggling=මුකුළුව
gigolo=වැඩිමහලු කාන්තාවකගේ පෙම්වතා ලෙස සිටීමට ගෙවීමක් ලබන
gilbert=ගිල්බටය
gild=ඔපදමනවා | දොයිරාදු කරනවා | රත්තරන් ගානවා | රත්‍රන් ගෑම | ශ්‍රේණිය | සංඝය
gilded=රන් ආලේපිත
gilding=ස්වර්ණාලේපනය | ස්වර්ණාලේපය
gill=තැල්ල | ද්‍රව මැනීමේ මිම්මක් | හුංඩු බාගය
gill-fungus=තැලි දිලීර
gillie=ආවතේව කාරයා
gilly=දඩයමේදී හෝ මසුන් ඇල්ලීමේදී ආවතේව කාරයා
gillyflower=ලවංග සුවඳැති මල
gilt=ඔපදැමූ | දොයිරාදු | රත්‍රන් ගානලද | ස්වර්ණාලේපය
gilt-edged=ඉතා සුදුසු | ඉස්තරම් | රන්ගෙවි
gimbal=ම්බල
gimbals=ම්බල
gimcrack=කෙළිබඩුව
gimlet=අත් අවගාරය | තොරපනය | බුරුම කටුව | බුරුමය
gimmick=කපටිකම | වංචනික ක්‍රියාව
gimmicks=දෘෂ්ටි ප්‍රයෝග | ප්‍රයෝග | සුකුරුත්තං
gimp=සේද නූල් හා කම්බි එකටෙක බැඳ සාදන බිළීපිත්ත
gin=ඇටවලින් වෙන් කරනවා | උගුල | කපු කපනවා | ජම්බාරය | නුව
gingelly=තල
ginger=ඉඟුරු | ඉඟුරු සහිත | දුඹුරු වර්ණ | පොළඹවනවා | සිඟුරු | හිඟුරු
gingerly=ඉතා පරිස්සමින්
gingham=කපු පිළි ජාතියක්
gingiva=වේලා
gingivitis=දත්මුල් ඉදිමීම | වේලාදාහය
gingle=රහු
ginglymus=කෝරසන්ධිය
ginham=ගින්හැම්
ginkgo=ගසක්
ginning=ඇට ඇරීම | පුළුන්වල ඇට ඇරීම
ginseng=චීනයේ ඖෂධීය පැලෑටියක්
giornata=ජොර්නාතාව
giotteschi=ජොත්තේශිකයෝ
giottesques=ජොත්තේශිකයෝ
gipsy=අහිගුන්ඨිකයා
giraffe=රා
gird=ඔතනවා | කැසපට ගසනවා | පළඳවනවා | වට කරනවා | වටේ බඳිනවා | සමච්චල් කරනවා
girder=ගේඩරය | බාල්කය | මහාබාල්කය
girdle=කැසපට | දාමය | බඩවැස්ම | බඳපටිය | මිණිමෙවුල | මෙවුල | මේඛලා | මේඛලාදාමය | මේඛලාව | හවඩිය
girdling=පොතු වළලු ගැසීම
girl=කුමරිය | කුමාරිය | කෙල්ල | ගැටිස්සී | ගෑනු ළමයා | දැරිය | නවයුවතිය | පැටික්කි | බාලිකාව | මානවිකාව | යුවතිය | ළදැරිය | ළමිස්සී
girl-hood=කුමාරි අවස්ථාව
girlhood=කන්‍යාසමය | දැරිබව
girlie=පැටික්කී
girlish=බාලිකාවකගේ වැනි
giro=ගයිරෝව
girt=වට කරනලද | වට ප්‍රමාණය | වටේ බඳිනලද
girth=පරිණාහය | බඳපටිය | වට පමාණය | වට ප්‍රමාණය | වටය
gisant=ඔත් පිළිරුව
gist=භාවය | සාරාංශය
git=අඥානයා | දොර
give=ඇදීම | ඇන්න දෙනවා | කැ යනවා | කැඩෙනවා | දෙනවා | බුරුල
given=එක්තරා | දුන් | දෙනලද | නියමිත
giver=දෙන්නා
giving=දීම
giycoside=ග්ලයිකොසයිඩ්
gizzard=ගොර
glabella=ග්ලබෙල්ලා
glaber=සිනිඳු
glabrous=සිනිඳු
glace=ඔප දමනලද | ශීතල කවනලද | සීනි තැවරූ
glacial=ග්ලැසියර | හෛම
glaciated=ග්ලැසියර ඛාදිත
glaciation=ග්ලැසියර ඛාදනය | ග්ලැසීයරාණය | හිමතලායම
glacier=ග්ලැසියරය | ප්‍රතිව්‍යාප්ත නිධිය | හිම නදිය | හිම සංහතිය
glaciology=ග්ලැසියර විද්‍යාව
glacis=බලකොටුවේ පිටත බෑවුම | මඳ බෑවුම
glad=ප්ර්රීතිමත් | ප්‍රසන්න | සතුටු | සන්තෝෂජනක
gladden=සතුටු කරනවා
glade=පිටිය | වනයෙහි එළිමහන් ප්‍රදේශය | වනාන්තරය
gladeye=කාමුක බැල්ම
gladiate=අසිපත් හැඩ
gladiator=කඩුගත් මල්ලවයා
gladiatorial=කඩු ගත්
gladiolus=කඩුවක් මෙන් පත්‍ර ඇති මල් ගසක් | ළයැටතලය
gladly=සන්තෝෂයෙන්
gladness=සතුට
gladrags=ඉස්තරම් ඇඳුම්
gladsome=ප්‍රීතිමත් | සතුටුදායක
glair=බිත්තර සුදුමදය
glamorous=අලංකාරවත් | වශී කරන
glamour=මනමෝහනය | මෝහනය | වශීකරණය | ව්‍යාජ අලංකාරය
glamourous=මනමෝහන | සාලංකාර
glance=ඇදට විත් හැපීම | ඉක්මන් බැල්ම | ක්ෂණ දීප්තිය | දිස්න වැටෙනවා | බැල්ම හෙළනවා | යන්තමින් සඳහන් කරනවා | හදිසි බැල්ම
gland=කුද්දටිය | ග්‍රන්ථිය | ග්‍රන්ථීය | බූසිය
glanders=අශ්වයින්ට සෑදෙන බෝවන රෝගයක්
glandiferous=ග්‍රන්ථීධර
glandiform=ග්‍රන්ථීරූපී
glandular=ග්‍රන්ථි පිළිබඳ | ග්‍රන්ථීමය
glandule=ක්ෂුද්‍ර ග්‍රන්ථිය
glare=අතිශයින් බැබළෙනවා | එළිකණ | කෝපයෙන් හෙළන බැල්ම | දිදුල | බලවත් දීප්තිය | රවා බලනවා
glaring=කාටත් පෙනෙන | දිදුලන | ප්‍රදීප්ත | බරපතළ
glasnost=ග්ලාස්නොස්ත් | විවෘතත්වය
glass=කණ්ණාඩිය | කදා | කදාමිණ | කාචය | කැඩපත | විදුර | විදුරු | වීදුරු | වීදුරු භාජනය | වීදුරුව | වීදුරුවලින් තනනලද
glasscloth=වීදුරු බඩු මදින රෙදි
glasses=කණ්ණාඩි කුට්ටම
glasspaper=වැලි කඩදාසිය
glassy=වීදුරු වැනි
glaucescent=නීලහරිත
glaucoma=නීලකාචය
glaucous=අළු සහිත | නීලහරිත
glaxy=චක්‍රවාටය
glaze=ඔප දමනවා | ඔපය | දිස්න දැමීම | දිස්න මිශ්‍රණය | වීදුරු අල්ලනවා | වීදුරු දමනවා | වීදුරු සමාන ඔපය
glazed=ඔප දැමූ
glazer=ඔපදමන්නා
glazier=වීදුරු සවිකරන්නා
glazing=ඔපලනවා | දිස්න ලෑම
gleam=ක්ෂණික දීප්තිය | දිලිසෙනවා | දිස්නය | මන්දප්‍රභාව | රශ්මි විහිදෙනවා | රශ්මිය | විනිවිද පෙනෙන කාන්තිය
glean=ඇහිඳ ගන්නවා
gleaner=ඇහිඳ ගන්නා
gleaning=ඇහිඳ ගැනීම | උඤ්ඡාචර්ය්‍යය | තැන්තැන්වලින් එකතු කිරීම
gleanings=අවුලාගත් තොරතුරු
gleba=ගිලිබාව
glebe=දේවස්ථානයට වෙන් කරනලද බිම
glee=ගණගායනය | ප්‍රමෝදය | සන්තෝෂය
gleeful=ප්‍රමුදිත
gleeman=ගණගායකයා
glen=කඳුරු නිම්නය | දෙණිය
glengarry=කැප් තොප්පි විශේෂයක්
gliadin=ග්ලැයඩින්
glian=ග්ලැයන්
glib=චපල කථා ඇති | මුඛර
glibness=මුඛරිකම
glide=ගලා යාම | ලිස්සනවා | ලිස්සා යාම | ලිස්සී යනවා
glider=සැහැල්ලු ගුවන් යානය
gliding=නිසර්පණය
gliding-growth=විසර්පණ වර්ධනය
glim=පහන
glimmer=ක්ෂුද්‍රදීප්තිය | දිස්නය | මන්දාලෝකය | යන්තමින් බැබළෙනවා
glimmering=නොපැහැදිලි දර්ශනය | යන්තමින් ඇඟවීම
glimpse=ක්ෂණික දර්ශනය | ක්ෂණිකව බලනවා | යාන්තමට බලනවා
glint=ක්ෂණික දීප්තිය | දිලිසෙනවා | දිස්නය | විටින් විට බැබළෙනවා
glissade=කඳු නැඟීමේදී දෙපයින් පහළට ලිස්සනවා
glisten=දිලිසෙනවා | දිස්න වැටෙනවා
glitter=කාන්තිය | දිලිසෙනවා | දීප්තිය | බැබළෙනවා | ලෙළ දෙනවා
glittering=උජ්ජ්වලිත | කාන්තිමත් | කාන්තිමත් | ජ්වලන | ජෝතිමත් | දිදුල
gloaming=අඳුරු වැටෙන වේලාව | සන්ධ්‍යාලෝකය
gloat=අනුන්ගේ දුකේදී උදම් වෙනවා
gloating=දුෂ්ට සේ බලාසිටින
global=ලෝකව්‍යාප්ත | වට | වර්තුල
globate=ගෝලාකාර | බුබ්බුලාකාර
globe=ආදර්ශ ගෝලය | ගෝලය | ගෝලාකාර පෘථිවි සිතියම | ගෝලෝව | පෘථිවිය | භූගෝලය | ලෝකගෝලය | වර්තනය | වර්තිකාව | වර්තුලය
globoid=ගෝලාංශුව | ගෝලාකාර
globose=ගෝලාකාර
globular=ගෝලාකාර | සුවට
globule=කුඩා ගෝලය | ගුළිකාව | ගෝලිකාව | බින්දුව | වර්තුලිකාව
globulin=ග්ලොබියුලින් | ශාක හා සත්ව පටකවල ඇති ප්‍රෝටීන
globulose=ගෝලිකාකාර
globus=වර්තුලය
glochid=කොකු කෙන්ද
glochideous=කොකු කෙඳි සහිත
glockenspiel=මිටියකින් හඬවන්නා වූ සීනුපෙළ
glomerate=පිණ්ඩාකාර | පිණ්ඩිත | පිණ්ඩිභූත
glomerule=ගුච්ඡිකාව
glomeruliferous=ගුච්ඡිකාධර
glomerulose=ගුච්ඡිකාමය
glomerulus=ගුච්ඡිකාව
gloom=අන්ධකාරය | ඇඳිරිය | තිමිර | දොම්නස | සෝකය
gloominess=අඳුරුබව | දොම්නස | බීරුම
gloomy=අන්ධකාර | අඳුරු සහිත | ඛේදසහගත
glorify=අත්‍යන්තයෙන් වර්ණනා කරනවා | උත්කර්ෂයට පමුණුවනවා | ගෞරව සම්මාන කරනවා
glorious=ඉසුරුමත් | කීර්තිමත් | තේජාන්විත | මහානුභාවසම්පන්න | යශෝධර | ශ්‍රීමත් | ශ්‍රේෂ්ඨ
glory=ඉසුරු | උත්කර්ෂය | ඓශ්චර්ය | කීර්තිය | තේජස | පාරට්ටු කරගන්නවා | මහත් අලංකාරය | මහිමය | යශ | යසස | ශ්‍රී විභූතිය | සම්මානය
glosary=අකාරාදිය
gloss=ඔප දමනවා | ඔපමට්ටම් | ඔපය | ගැටපදය | ටිප්පණිය | ටීකාව | දිලිසුම | දිස්නය | පිට ඔපය | රැවටිල්ල | විස්තර කරනවා
glossal=හ්වා
glossary=ගැටපද විවරණය | පදමාලාව | වචනාවලිය | වාංමාලාව | ශබ්දමාලාව | ශබ්දසංග්‍රහය
glossator=ටීකාකාරයා
glossina=ග්ලොසිනා
glossitis=හ්වාදාහය
glossolalia=හ්වලාලනය
glossopodium=ජීහ්වපාදය
glossy=ඔප ඇති | සිලුටු
glottal=කණ්ඨජ
glottis=විඛාසකය | ශ්වාස මුඛය | ශ්වාසනාලයෙහි මුල
glottochronology=භාෂාකාලානුක්‍රමවේදය
gloup=සියන්වල
glove=අත්මේස් | අත්වැස්ම | බාහුජාලය
gloves=අත් කොපු | අත් මේස්
glow=අලු | ඇවිල ගන්නවා | උණුසුම් බව දැනෙනවා | උනන්දුව | දිලියුම | දිලිසීම | දිලිසෙනවා | දිළියුම | දීප්තිය | පැහැය
glow-lamp=දිලියුම් පහන
glow-worm=ඉන්ද්‍රගෝප | ඉන්ද්‍රගෝපක
glower=රවාබලනවා
glowing=උත්කර්ෂවත් | ජ්වලිත
gloxinia=සීනුවක හැඩ ගත් මල් ඇති ගසක්
glucase=ග්ලුකේස්
glucinum=ග්ලූසිනිම්
glucose=ග්ලුකෝස් | ග්ලූකෝස්
glucoside=ග්ලුකොසයිඩ්
glue=අලවනවා | ග්ලු | ග්ලූ | මැලියම්
glueing=ග්ලූ ගා ඇලවීම | ග්ලූ ගෑම
gluey=ඇලෙන
gluing=ග්ලූ ගෑම
glum=දුර්මුඛ | නොසතුටු මුහුණු ඇති
glumaceous=ග්ලුමාකාර | තුෂාකාර
glume=ග්ලුමය | තුෂය
glut=අතිමාත්‍රය | අධික ලෙස කනවා | අධිකත්වය | ගලටිය | ගොඩගහනවා
glutamate=ආහාර රසගැන්වීමට යොදන ද්‍රව්‍යයක්
glutamine=ග්ලුටැමයින්
gluten=ග්ලුටන් | ධාන්‍ය නිර්ය්‍යාසය
glutenin=ග්ලුටෙනින්
glutin=ග්ලුටින්
glutinous=ඇලෙන | ඇලෙනසුලු
glutting=ඇහිරීම
glutton=කෑදරයා | බඩ ජහරියා
gluttonous=අලජ්ජී | කෑදර | කෑඹල | මජර
gluttony=කෑදරකම
glycerin=ග්ලිසරීන් | ග්ලීසරීන්
glycerine=ග්ලිසරින් | ග්ලිසරීන්
glycerol=ග්ලිසරොල්
glycerophosphate=ග්ලිසරොපොස්පේට්
glycine=ග්ලයිසීන්
glycodrupose=ග්ලයිකොඩෲපෝස්
glycogen=ග්ලයිකොජන් | ග්ලයිකෝජන්
glycoin=ග්ලයිසිරයිසින්
glycol=ග්ලයිකොල්
glycolignose=ග්ලයිකොලිග්නෝස්
glycolysis=ග්ලයිකොච්ඡේදනය | ග්ලයිකොලිසිය
glycoside=ග්ලයිකොසයිඩ්
glycosuria=ග්ලූකෝස් මූත්‍රතාව | ග්ලූකෝස්‍යරියා
glycyrrhizin=ග්ලයිසිරයිසින්
glyoxalase=ග්ලයොක්සලේස්
glyptic=මිණියම
glyptogenesis=ගිරිහායනය
gnash=දත්කනවා | දත්මිටිකනවා
gnat=කුඩා මදුරුවා | හෝහපුටුවා
gnathic=හනු
gnaw=කාවදිනවා | දුක් දෙනවා | පීඩා කරනවා | ලෑටිගානවා
gneiss=කළු ගල් | කළුගල් වර්ගයක් | නයිස් පාෂාණ
gnome=බහිරවයා
gnomic=ස්මෘති පාඨ
gnomon=ඡායා දණ්ඩ | ඡායාදණ්ඩ
gnosiology=ඥානවේදය
gnosis=ඥානය | ලෝකෝත්තරඥානය
gnosticism=ඥානවාදය
gnu=මුව වර්ගයක්
go=උනන්දුව | ක්‍රියා කරනවා | ගත වෙනවා | ගමන් කරනවා | තිබෙනවා | දහ් | නැති වෙනවා | පවතිනවා | යනවා | යාම | වැඩේ | වෙනවා | සිටිනවා
go-between=ජෝඩුකරන්නා | තැරැවුකාරයා
go-devil=යක් ගුලිය
go-to=වෙත යන්න
goad=අංකුසය | උනන්දු කරනවා | කෙවිට | කෙවිටෙන් අනිනවා | පොළඹවනවා | ශූල | සංකු | සෘණිය | සෙණ්ඩුව | හකුස්ස | හෙණ්ඩුව | හෙණ්ඩුවෙන් අනිනවා | හෙන්ඩුව
goal=අභිමතාර්ථය | අරමුණ | ඉෂ්ටාර්ථය | කෙරවළ | කෙළවර | දිනුම් කනුව | නිෂ්ඨාව | පරමාර්ථය | බලාපොරොත්තුව
goat=අජ | එළුවා | ඒළකයා | මේෂ
goatherd=අජපාල
gob=කෙළපිඩ
gobbet=පොතකින් උපුටාගත් කොටස
gobble=තලුගසමින් කනවා
gobbledegook=අදක්ෂ නිලධාරියා
goblet=ගුරුලේත්තුව | දබරාව | පූකුරුව | ලබුකැටය | ශරාව
goblet-shaped=කලස් හැඩ
goblin=ප්‍රේතයා | පිශාචයා | පීශාචයා | වේතාලයා
goby=කුඩා මත්ස්‍යයෙක්
god=අමර | ඊශ්වර | දෙයියා | දෙවියන්වහන්සේ | දෙවියා | දේවතාවා
god-building=ඊශ්වර සංකල්ප නිවයනය | දේවසංකල්පය ගොඩනැංවීම
god-king=සුරනිඳු | සුරිඳු
goddess=දෙව් දූ
godfather=ඇපකාර පියා | පඤ්ඤා
godforsaken=ආස්වාදයක් නැති | පිළිසරණක් නැති
godhead=ඊශ්වරත්වය | ඊශ්වරතාව | දේවත්වය | දේවතාවා
godless=නාස්තික | භක්තියක් නැති
godlessness=දේව භක්තියක් නොමැතිකම
godly=ධාර්මික | භක්තිමත්
godmother=මඤ්ඤා
godown=කෙඩෙංගුව | ගබඩාව | ගුදම | ගුදම්
gods=දෙවි දේවතාවෝ
godsend=දේවකරුණාව
godwit=වක් වූ හොටක් ඇති පක්ෂියෙක්
goegeous=අතිශය | ඉතා අලංකාරවත් | මනහර | සමුජ්වලිත
goggle=ඇස් කරකවනවා | ඇස් කරකැවෙනවා
goggles=ආරක්ෂක කන්නාඩි | ඇස්මුවාව
going=අනාගතාර්ථාචී පදයක් | ගමන | ගමන් මාර්ගය | යාම
goitre=උගුරේ ගෙඩිය | කණ්ඨමාලය | කණ්ඩමාලය | ගණ්ඩමාලය | ගලගණ්ඩය | වායි ගෙඩිය
golconda=මහා රත්නාකරය
gold=ඉතා අගනා වස්තුව | කසුන් | කාඤ්චන | ජාතරූප | ධනය | ර | රං | රත්‍රන් | රන් | රන්කාසි | රන්වන් | සවර්ණ | ස්වර්ණ | ස්වර්ණමය | සුවණ්ණ | හිරඤ්ඤ | හිරණ්‍ය | හෙම් | හේම
golden=අත්කෘෂ්ට | කඤ්චන | කනක | කනා | කාඤ්චන | මහඟු | රනින් කරන ලද | ස්වර්ණමය | ස්වර්ණවර්ණ
golder=ග්‍රාහකය
goldfever=රත්‍රන් හෑරීමට ඇති පිස්සුව
goldfield=රත්‍රන් ලැබෙන ප්‍රදේශය
goldfinch=කුරුලු වර්ගයක්
goldfish=රන් මත්ස්‍යයා
goldsmith=තුලාර | රන්කරු | රන්කරුවා
goldsmiths=රන්කරුවෝ
golf=ගොල් ක්‍රීඩාව
golliwog=විරූපී බෝනික්කා
golly=ඇයි දෙයියනේ
gonad=ගොනැඩය | ප්‍රජනනේන්ද්‍රිය | සෘෂ්ට්‍යංගය
gonadotrophin=ගොනැඩොට්‍රොපින්
gonagium=ගොනැන්‍ය
gondola=අහස් යාත්‍රාවෙහි බක්කිය | වැනීසියේ ඔරු වර්ගයක්
gondolier=ඔරුකාරයා
gondwanaland=ගොන්ද්වානාලන්තය
gone=ගත | ගිය | ගොස් | චුත | නරක් වූ | පසු වූ | බලාපොරොත්තු රහිත
gonfalon=දණ්ඩක ආධාරයෙන් එල්ලන දැන්වීම
gong=ගහීරිකාව | ඝනය | යමේරුකාව
gonidangium=ගොනිඩැන්‍ය | ගොනීඩිධානිය
gonidium=ගොනීඩිය
gonimia=ගොනීමිය
gonimic=ගොනීමි
gonimium=ගොනීමිය
gonimoblast=ගොනිමොබ්ලාස්ටය
goniometer=ගෝනියොමීටරය | ගෝනියෝමීටරය | තලකෝණමානය
gonitangium=ගොනිඩැන්‍ය | ගොනීඩිධානිය
gonococcus=ගොනොකුකුසයා
gonorrhea=උපදංශය | කුණු ලෙඩ | ප්‍රමේහය
gonorrhoea=උපදංශය | ගොනොරියාව | ගොනෝරියාව | ප්‍රමේහය | පූයාමේහය | සෘෂ්ට්‍යංගරීතය
good=ඇති තරම් | ඉටු | ඉෂ්ට | කරුණාවන්ත | කල්‍යාණ | ගුණවත් | තරමක | දක්ෂ | නඳ | ප්‍රයෝජනය | භද්‍ර | යහපත | යහපත් | සං | සාදු | සාධු | සු | සුදුසු | සුභ | සොඳ | සොඳුරු | හිතවත් | හූදී | හොඳ
goodly=ප්‍රමාණයක වූ | යස | වටිනා | ශෝභන | සෑහෙන
goodness=යහපත්කම | යහපත්බව | සත්පුරුෂභාවය | සාධුත්වය
goods=ද්‍රව්‍ය | දේපළ |  | බඩු | බඩු බාහිරාදිය | බඩුබාහිර | බඩුමුට්ටු | භාණ්ඩ
goodstrain=බඩු කෝච්වය
goodwill=කීර්ති නාමය | කීර්තිනාමය | යශෝ නාමය | හොඳ හිත
goof=තකතිරුවා | මෝඩයා
google=Google නම් සෙවුම් යන්ත්‍රය
googly=පන්දු යවන ක්‍රමයක්
goon=අඥානයා
goosander=දැති සහිත හොටක් ඇති තාරාවා
goose=පාත්තයා
gopher=මූෂික වර්ගයේ සතෙක්
gore=ඇඳුම් පළල් කිරීමට තුන්හුලස් කෑලි යොදනවා | උල් වූ යමකින් අනිනවා | කැටි ගැසුණු ලේ | ගෝල කීලය
gorge=අධික ලෙස බඩ පුරා කවනවා | උගුර | කුරුබිලිය | ගලය | ගිල දමනවා | දුර්ග මාර්ගය | දොරුව
gorgeous=ඉතා අලංකාර | ප්‍රභාවත්
gorgeousness=නපුරු දෘෂ්ටි ඇත්තා | මනහරබව
gorgon=නපුරු දෘෂ්ටි ඇත්තා
gorilla=මහා වානරයා
gormandize=කෑදර ලෙස කනවා
gormandizer=බඩජහරියා
gorminable=ප්‍රරෝහණිය | ප්‍රරෝහ්‍ය
gormless=අනවබෝධයෙන් යුත් | මෝඩ
gorse=කටු සහිත පැලෑටියක්
gory=කැටි ගැසුණු ලේ සහිත
gosh=විස්මය දනවන පදයක්
goshawk=කුඩා පියාපත් ඇති විශාල පක්ෂියෙක්
gosling=පාත්ත පැටියා
gospel=අනුශාසනය | ක්‍රිස්තුස් වහන්සේගේ ධර්මය | ශුභාරංවය
gospeller=දේවවාක්‍ය කියවන්නා
gossamer=ඉතා සිනිඳු මකුළුදැල්
gossip=කට කතාව | කටකථා | කටවාචාල | කටවාචාලයා | කඩුලු කතා | කදේ දානවා | කයිය | ප්‍රලාප | ප්‍රලාප දොඩනවා | සපදූප | සපාදූප | සපාදූප කියනවා | සපාදූපා
got=අත්පත් කරගත්තා | අල්ලාගත්තා | උනා | පැමිණුනා | පැමුණුනා | පෙළඹවාගත්තා | ලබා ගත්තා | ලබා දුන්නා | ලැබුනා | වටහාගත්තා | සැලසුවා | සොයාගත්තා
goth=කලා ශිල්පයන් වනසන්නා
gothic=අශිෂ්ට | ගොත් වර්ගයට අයත් | ගොතික්
gouache=ගෝවේ ශිල්පක්‍රමය | මැලියම් හා පැණි යොදා ඔපවත් කරන ලද දියසායමින්
gouda=පැතලි වටකුරු කේජු
gouge=ගවුය | ගෝජ් කටුව | බොකු නියන | බොකු නියනෙන් හාරනවා
goulash=ව්‍යංජනය
gourd=අලාබු | ලබු කබල | වට්ටක්කා
gourds=අලාබු වර්ග | අලාබුජ
gourmand=කෑදරයා | බහුභක්ෂකයා
gourmet=රසඥයා
gout=පාදශෝථය | රක්තවාතය | වාතරක්තය | වාදම
gouty=වාතරක්ත
govern=ආණ්ඩු කරනවා | නියම කරනවා | පාලනය කරනවා | බල පවත්වනවා | මැඩපවත්වනවා | රජ කරනවා | රජයනවා | රට කරනවා | රටකනවා | රාජ්‍ය පාලනය කරනවා | හසුරුවනවා
governance=පාලනය
governess=ගුරුවරිය
government=ආංඩුව | ආණ්ඩුච | ආණ්ඩුව | ප්‍රජාපාලනය | පාලනය | රජය | රාජ්‍යය
governmental=ආණ්ඩුව පිළිබඳ
governor=අධිපතියා | ආණ්ඩුකාර තැන | ආණ්ඩුකාරයා | ප්‍රධානයා | පාලකය | පාලකයා | යාමකය | සංයාමකය
governor-general=අග්‍රාණ්ඩුකාර තුමා
gown=ගවුම
goy=යුදෙව් නොවන අයෙකුට කියන පදය
gr=ග්‍රේන්
grab=උලුපුව | ඩැහැ ගන්නවා | ඩැහැ ගැනීම | පැහැර ගන්නවා | පැහැර ගැනීම | බලාත්කාරයෙන් අල්ලනවා | හදිසියෙන් අල්ලනවා
graben=කිඳාව
grace=අනුග්‍රහය | අනුග්‍රහය දක්වනවා | අලංකාර කරනවා | අලංකාරය | කරුණාව | ප්‍රසාදය | ලාලිත්‍යය | වරප්‍රසාදය | ශිෂ්ටත්වය | ශෝභනත්වය | සමාව | සහන කාලය | ස්තුතිය
graceful=මනෝඥ | සුන්දර
gracefulness=ලාලිත්‍යය
graceless=අවිනීත
gracilis=තනුකය
gracious=කරුණාහරිත | දයාන්විත | දේව කරුණාව සහිත | සිත්කලු
graciousness=සිත්කලු බව
grad=ග්‍රේඩය
gradatae=ග්‍රඩාටේ
gradate=අනුක්‍රමික
gradation=ක්‍රමණය | ක්‍රමාන්වය | ප්‍රමාණය | වර්ග කිරීම | ශ්‍රේණි ගතකිරීම | ශ්‍රේණිභාවය
grade=ක්‍රමපදය | ග්‍රාදිය | ග්‍රේඩය | තරාතිරම | පංක්තිය | ප්‍රමාණය | පියගැට | බෑවුම | වර්ගය | ශ්‍රේණිය | සරණිය | සරණීය | සෑදිල්ල | සේණිය
graded=වර්ග කළ
grader=අනුක්‍රමකය | සමකුරුව
gradient=අනුක්‍රමණය | අවනතිය | බෑවුම | බෑවුමේ ප්‍රමාණය
gradienter=අනුක්‍රමකය | ඇලකරය
grading=වර්ග කිරීම | වර්ග මිශ්‍රණය | ශ්‍රෙණිගත කිරීම | ශ්‍රේණිගත කිරීම | සමකිරීම | සරණි කිරීම
gradiometer=අනුක්‍රමණ මානය | අනුක්‍රමණමානය
gradometer=අනුක්‍රමණ මානය
gradual=අඩියෙන් අඩියට වූ | ක්‍රමානුකූල | ක්‍රමික
gradualism=ක්‍රමානුකූලව අදහස් වෙනස් කිරීම
gradually=අනුක්‍රමයෙන් | ටිකින් ටික
graduand=උපාධි අපේක්ෂක
graduate=උපාදිධාරී | උපාධිධරයා | ක්‍රමාංකනය කරනවා | ක්‍රමාංකනය කිරීම | නියම කරනවා | ප්‍රණයනය | ප්‍රණයනයකිරීම | විශ්වවිද්‍යාලයක උපාධියක් ලබනවා
graduated=අංකිත | ක්‍රමාංකිත | ප්‍රණිත
graduation=උපාධියක් ලැබීම | ක්‍රමාංකනය | ක්‍රමාංකය | ප්‍රණයනය
graduator=ක්‍රමකයා
graffiti=කුරුටු ගී | කුරුටු ලිපි | කුරුටු වත්‍ර | පවුරු ලිපිය
grafiti=කුරුටු ලිපි
graft=අයුතු ලාභ ප්‍රයෝජන සැලසීම | අල්ලස | පනයම | පාස්සනවා | පිරිද්දීම | බද්ධය | රිකිලි බද්ධය
grafted=පුරුද්දන ලද | බද්ධ කරන ලද
grafting=බද්ධය | ශාඛාබද්ධය
grain=ඇබිත්ත | කණස | කණිකාව | කනිකාව | කැටිය | ග්‍රේන් | ධාන්‍ය | ධාන්‍ය කණිකාව | ධාන්‍ය බීජය | ප්‍රකෘති ස්වභාවය | මංචාඩියෙන් හතරෙන් පංගුව | මරුව | ලීයෙහි ආකාරයට තීන්ත ගානවා | වයිරම | වෛරම
grain-tax=සස්බද්ද
grains=ධාන්‍ය
grallatorial=දික් පා ඇති පක්ෂීන්ට සබැඳි
gram=කඩල | කොණ් කඩල | ග්‍රැම | ග්‍රැම්
gram-atom=ග්‍රැම් පරමාණුව
gram-calorie=ග්‍රැම් කැලරිය
gram-equivalent=ග්‍රැම් සමකය
gram-ion=ග්‍රැම් අයනය
gram-molecule=ග්‍රැම් අණුව
gramian=ග්‍රැමියානුව
graminaceous=තෘණ
graminicolous=තෘණරුහ
graminivorous=තෘණභක්ෂක
graminology=තෘණ විද්‍යාව
grammar=ව්‍යාකරණ | ව්‍යාකරණ ග්‍රන්ථය | ව්‍යාකරණ ශාස්ත්‍රය | වියරණ | වෙය්‍යාකරණ | ශබ්දනීතිය | ශබ්දවිද්‍යාව | ශබ්දශාස්ත්‍රය | ශබ්දානුශාසනය | සදදහම
grammarian=ව්‍යාකරණඥයා | ශාබ්දිකයා
grammatical=ව්‍යාකරණය පිළිබඳ | ව්‍යාකරණානුකූල | වෛයාකරණ
gramme=ග්‍රෑම | ග්‍රෑම්
gramophone=කතා පෙට්ටිය | ග්‍රැමපෝනය | ග්‍රැමෆෝනය | ශබ්ද වාහිනිය
grampus=තලපතා
grana=පංජර කණිකා
granade=අත්බෝම්බය
granadilla=වැල් දොඩම්
granary=අටුව | කෝෂ්ඨාගාරය | ධාන්‍යාගාරය | පත්තායම | බිස්ස | බිසි
grand=උදාර | ගරුගම්භීර | ප්‍රධාන | විශාල | විශිෂ්ට
grand-daughter=මිනිපිරිය | මිනිබිරිය
grand-father=මුත්තා
grand-mother=ආච්චි
grandather=සීයා
grandee=වංශාධිපතියා
grandeur=ඓශ්චර්ය්‍යය | මහිමය | විභූතිය
grandfather=පිතාමහ | මිති
grandiloquence=වගාඩම්බරය
grandiloquent=ගර්විත වචන ඇති | වගාඩම්බරයෙන් යුත්
grandiose=මහත් ලෙස පෙනෙන
grandmal=ග්‍රාන්ඩ්මාල්
grandmother=ආත්තා | ආතා | මිත්තණිය
grandson=නප්තෘ | මුනුපුරා
grange=ග්‍රාමීය නිවාසය
graniferous=ධාන්‍ය නිපදවන
graninifolious=තෘණපත්‍රී
granit=ග්‍රැනිට් පාෂාණ
granite=කළුගල් | ග්‍රැනිට් | ග්‍රැනයිට් | ග්‍රැනිට්
granivorous=ධාන්‍යවලින් වත් වන
granny=ආච්චි
grano=ග්‍රැනෝ
granolithic=ග්‍රැනෝලිතික්
grant=අවසර දෙනවා | ආධාර මුදල | ඉඩදෙනවා | ඒත්තු ගන්නවා | දීම | දීමනාව | දීමනාව පිළිබඳ ලියවිල්ල | දෙනවා | ප්‍රතිපාදනය | ප්‍රදානය | ප්‍රදානය කරනවා | පිරිනැමීම | සන්නස
grantee=ප්‍රදානලාභියා | ලැබුම් කාරයා
grantor=දීමනා කාරයා | දීමනාකරු | ප්‍රදායකයා
grants-in-aid=ආධාර දීමනා
granula=කැටිත්ත
granular=කණිකාමය | කැටිති | කුඩා කැටවලින් යුක්ත
granulate=කණිකාමය | කැට සෑදෙනවා | මඳක් රළු
granulated=කැට කළ | කැට ගැහුණු | කැට වුණු | කැටැයුණු | මඳක් රළු
granulation=කැට ගැසීම
granulator=කැටිතිකුරුව
granule=ඉතා කුඩා ඇටය | ඉතා කුඩා කැටය | කැටිත්ත
granuliferous=කණිකාධර
grape=මිදි | මුද්දරප්පලම් | මුද්‍රික ඵලය | මුද්‍රිකා | රසාල
grapes=මිදි | මුද්‍රීකඵල
graph=ප්‍රස්තාරය | රේඛය | රේඛා සටහන | රේඛාවත්‍ර | විහ්නිතය
graphic=ග්‍රාපික | ප්‍රස්තාර | ප්‍රස්තාරික | විත්‍රණ | සූවත්‍රිත
graphical=ග්‍රාපිකරූපී | ග්‍රාපිකාකාර | ග්‍රාපිකාකාරික | ප්‍රස්තාරික
graphics=ග්‍රාපික | ප්‍රස්තාරික ක්‍රම | වත්‍රක
graphite=ග්‍රුපයිට් | මිනිරන් | මීරන් | වෙල්ල
graphology=අත්අකුරු අධ්‍යයනය කර චරිත ලක්ෂණ කීම | ලේඛන පරීක්ෂාව | ලේඛන විද්‍යාව
graphomania=ලේඛනෝන්මාදය
graphopathology=ලේඛව්‍යාධි වේදය
graphorrhea=ලේඛන ස්‍රාවය | වැල්වටාරම
graphosphasm=ලේඛ හ්‍රාසය
graphs=ප්‍රස්තාර
grapnal=කුඩා නැංගුරම
grapnel=ඇවුළුම් කොක්ක
grappel=ඇවුළුම් කොක්ක
grapple=ඇවුළුම් කොක්ක | බදාගන්නවා | විශාල කොක්ක
grasp=අත්වැල | අල්ලා ගැනීම | අවබෝධය | ග්‍රහණය | ග්‍රහනය කරනවා | බදනවා | බඳනවා | වටහා ගන්නවා
grasping=ගිජු | ලෝභී
grass=තණ | තණ පිඩලිවලින් වසනවා | තණකොළ | තණබිම | තිණ | තෘණ | තෘණ වර්ග | වදුරු
grass-hopper=තණගිරවා | පලාගිරවා
grasses=තණ | තෘණ
grasshopper=තණකොළ පෙත්තා
grassland=තණ බිම | තණබිම | තෘණභූමිය | පොතන | පොතාන
grassy=තණ වැනි | තණ සහිත
grate=කූඩු කරනවා | ගරාදිය | ගිනිමැස්ස | පෙරන්ගානවා
grateer=පෙරන්ගෑමට හෝ සීරීමට යොදන උපකරණය
grateful=කළගුණ දන්නා | කෘතඥ | ප්‍රසන්න | ප්‍රිය උපදවන
graticule=චුල්ලිකාව | ජාලිකාව
gratification=අල්ලස | පරිතුෂ්ටිය | පරිතෝෂය | ප්‍රදාපිතය | ප්‍රසාදය | පිනවීම | සන්තෝෂය | සන්තෝසම
gratifing=තුෂ්ටිජනක | සැප එළවන
gratify=පිනවනවා | සතුටු කරනවා
gratifying=සුඛාවහ
grating=කණට අමිහිරි | ග්‍රේටිම | ග්‍රේටිම් | ග්‍රේටීම | පීරිගෑම
gratis=ගෙවීම් රහිතව | නොමිලයේ | නොමිලේ
gratitude=කළගුණ | කළගුණ සැලකීම | කෘතගුණය | කෘතඥතාව | කෙළෙහිගුණ | පරෝපකාරය | ප්‍රත්‍යපකාරය | ළෙහිගුණය
gratuitous=නිකරුණේ වූ | නිමිල | නිර්මූල්‍ය | නොමිලයේ වූ
gratuity=ත්‍යාගය | පරිතෝෂය | පාරිතෝෂකය | පාරිතෝෂික මුදල | පාරිතෝෂිකය
gravamen=ප්‍රධාන චෝදනාව | මුඛ්‍යාංගය
grave=අනුදාත්ත | කැටයම් කරනවා | ගම්භීර | ගාම්භීර | නෙළනවා | බරපතළ | බලතර | බැරුම් | මරණය | මිනීවළ | සන්සුන් | සොහොන
gravel=අශ්මරී | බොරඵ | බොරලු | බොරළු | බොරළු දමනවා | ශර්කරා
graven=කාවැදුණු | කැටයම් කරන ලද
graver=උත්කීරක | උත්කීරකය | කැටයම් කටුව
gravestone=සොහොන් කළ තැන දක්වන ගල
gravet=කඩවත
graveyard=සොහොන් බිම
gravid=ගර්භනී
gravimeter=ගුරුත්වමානය | ගුරුත්වාකර්ෂණය මනින උපකරණය
gravimetric=ගුරුත්වමිතික | භාරමිතික
gravimetry=බර මැනීමේ ශාස්ත්‍රය | භාරමිතිය
graving=නැවේ පතුළ ශුද්ධ කිරීම
graviperception=ගුරුත්වසංඥනනය
gravitate=ආකර්ෂණය වෙනවා
gravitating=ගුරුත්වාකර්ෂක
gravitation=ඇදීයාම | ගුරුත්වාකර්ෂණ | ගුරුත්වාකර්ෂණය
gravitational=ගුරුත්වාකර්ෂණ | ගූරුත්වාකර්ෂණ
gravitative=ගුරුත්වාකර්ෂ
gravitattion=ආකර්ෂණය
gravity=ගුරුත්වය | ගුරුත්වාකර්ෂණ ශක්තිය | බර | බැරුම්කම | වැදගත්කම | සන්සුන් බව
gravure=ඡායා උත්කීරණය | ඡායා උත්කීරිතය
gravy=ඉස්ම | හොද්ද | හොදි
gray=අඳුරුවන් | අළුපාට | ධූසර | පැසුණු | මලින | මහලු
graybeard=මහල්ලා
grayhound=හුළං බල්ලා
grayish=මඳක් අළුවන්
grayling=මිරිදිය මත්ස්‍යයෙක්
graymatter=මොලය
graywack=ග්‍රෝවාක
graze=ඇහිඳ කනවා | උළා කනවා | තණ කනවා | තණ කවනවා | තොලුගානවා | යන්තම් ගැටීම | යන්තම් ගෑවීගෙන යනවා | යන්තම් හැපීගෙන යනවා
grazer=විකිණීමට ගවයන් ඇති කරන්නා
grazing=ආස්පර්ශ | තණබිම | විකිණීමට ගවයන් ඇතිකිරීම
grease=ආවසා | ග්‍රීස් | තෙල් | තෙල් ගල්වනවා | ලිහිස්සි තෙල්
greasers=ග්‍රීස් පුඩු
greasing=ග්‍රීස් ගැසීම
greasy=චාටුකාර | තෙල් සහිත
great=අලි | උග්‍ර | උතුම් | උදාර | උරු | උසස් | ඌරු | ගුණවත් | ප්‍රධාන | ප්‍රභූ | බලවත් | බොහෝ | මහත | මහත් | මහා | මහාත්ම | යස | රාජ්‍ය | ලොකු | වැදගත් | විශාල | සෙට
greater=ඉමා | වැඩිතර | විශාලතර
greatly=අතිශයින් | එමට | බොහෝ සේ
greatness=උසස් බව | මහත | මහත්වය | මහිමය | විශාලත්වය
greaves=ජංඝාත්‍රාණය
grecian=ග්‍රීක
greece=යවන
greed=ඈලියාව | ගිජුකම | තණ්හාව | ලොබ | ලොල්ල | ලෝබ | ලෝබය | ලෝභ | ලෝභකම | ලෝභය
greediness=කෑදරකම | තණ්හාව
greedy=කෑදර | කෑඹල | ගිජු | පෙරේත | බඩගැති | බඩජාරි | මත්සර | රුව | ලොල් | ලෝබ | ලෝභී
greek=අන්ඩර දෙමළ | කැත වචන | ග්‍රීකයා | ග්‍රීසියට අයත් | නොතේරෙන දේ | යවන | යවනයා | යොන්
green=අමු ද්‍රව්‍ය භාණ්ඩ | අමුභාණ්ඩ | අලුත් | කොළ | කොළ පාට | කොළපාට වූ | තණ සහිත බිම | නිවට | නුපුරුදු | නොපැසුණු | නොමේරු | පච්ච | පලා වර්ණය | පලාවන් | පිට්ටනිය | මෝඩ | ශ්‍යාම | හරිත | ළපටි | ළපටිකම
greenbacks=ග්‍රීන් බැක්
greenery=අලංකාර තුරුලිය
greengage=පලතුරු වර්ගයක්
greenish=කොළපාටට හුරු
greenness=අමු ගතිය | ළපටිකම
greenockite=ග්‍රීනකයිට්
greenroom=නේපථ්‍ය ශාලාව
greens=කොළ සහිත එළවලු වර්ග | පලා වර්ග
greensand=ග්‍රීන් සෑන්ඩ්
greenwood=වසන්ත වනය
greet=අමතනවා | ආචාර කරනවා | ආචාර කරනවා
greeting=අභිනන්දනය | ආචාර කිරීම | ආචාරය | ආමන්ත්‍රණය
greetings=අභිවාදනය | ආචාරය | ශුභාශිංසනය | සතුටු සාමීව | සල්ලාප | සුපැතුම්
gregale=ග්‍රීගේල් සුළඟ
gregarious=යූථචාරී | රංචු ගැසුණු | රැළවැසි | සමුහවාසී | සමූහවාසී
gregariousness=යූථ චරත්වය | යූථචාරිත්වය | සාමුහිකත්වය
gregarrious=එක්‍රැස් වීමට ප්‍රිය | යූථචාරී
gremlin=පිශාචයා | මළප්‍රේතයා
grenade=කුඩා බෝම්බය
grenadier=පාබළ හමුදාවේ භටයා
grey=අඳුරුවන් | අමු රෙදි | අළු | අළු පැහැය | අළුපාට | ධූසර | පැසුණු | මලින | මහලු
grey-haired=තඹවිටි
grey-sickness=සෝන්දු මාන්දු
greylag=යුරෝපීය පාත්තයා
grid=කොටු සැලැස්ම | චුල්ලිකාව | ජාලකය | රේසියෝ යන්ත්‍රයේ කොටසක් | ලෝහ රාමුව
griddle=කේක් ආදිය පිසීමට ගන්නා වටකුරු යකඩ තහඩුව
gridiron=අලුත්වැඩියා කරන නැවක් රඳවන මැස්ස | ගරාදි
grief=කනගාටුව | කම්පාව | ඛෙදය | ඛේදය | තැවුල | දුක | දුක් | දුක්ඛ | දුහ්ඛය | විෂාදය | ශෝකය | සෝකය
grievance=අයුත්ත | දුක් ගැනවිල්ල | දුග්ගැනවිල්ල | නෝක්කඩුව | මැසිවිල්ල
grieve=බඩ දනවා | ශෝක වෙනවා | ශෝකය ඇති කරනවා | සිත් වේදනා කරනවා | සෝක කරනවා
grievous=දරුණු | බරපතළ | බලතම
griffon=සුනඛ විශේෂයක්
grike=පරිඛාව
grill=අතිශය උෂ්ණයෙන් පෙළනවා | උළුවහු | ජාල මාර්ගය | දැල් කවුළුව | මල් ලෑල්ල | යමැස්ස | වධ කරනවා
grillage=යමැසි අත්තිවාරම
grille=උළුවහු | මල් ලෑල්ල
grilling=අධික සන්තාපය ඇති | අනුකම්පා විරහිත | මහත් දුක් දෙන
grilse=කුඩා සැමන් මත්ස්‍යයා
grim=උග්‍ර | ක්‍රෑර | දරුණු | භයානක | සැර පරුස
grimace=මුඛ විකෘතිය | මුහුණ පුලුටු කරනවා | විළිස්සීම
grimaldi=ග්‍රීමල්දි
grimaldiens=ග්‍රිමල්දියානුවෝ
grime=දැළිකුණු ආදිය
grimness=භයානකකම
grimy=කුණු වැකුණු
grin=නියවනවා | නියවීම | විරවනවා | විරිත්තනවා | විරිස්සනවා | විරුවනවා | විලිත්තනවා
grind=අප්‍රිය කටයුත්ත | අමාරු කටයුත්ත | අඹරනවා | ඇඹරෙනවා | උගන්වනවා | ඔප දමනවා | කරකවනවා | කුඩු කරනවා | මඩිනවා | මදිනවා | මහත් සේ පෙළනවා | වෙහෙසී කරන පාඩම | සුණුවිසුණු කරනවා | හණ ගානවා | හඹරනවා
grinder=අඹරන්නා | ඇඹරුම් ගල | ගිනිගල් යන්ත්‍රය | දාගල | නිමදින්නා | නිමැදුම් යත | භක්කේ දත
grinding=කුඩු කිරීම | නිමැදීම | මුවාත් කිරීම
grindstone=ගනිගල | දාගල | නිමදුම් ගල | වතුර ගල
grindstonr=දාරගල
grip=අත් බෑගය | ගැම්ම | ඩැහැගන්නවා | දැඩිකොට අල්ලා ගන්නවා | දියල්ලුව | දෘඩ ග්‍රහණය | බන්ධනය | බැඳුම | මනා අවබෝධය | මිට
gripe=තදින් අල්ලනවා | දෘඩ ග්‍රහණය | පීඩා කරනවා | පීඩාව | බඩ රිදවනවා | බඩ රිදෙනවා | බඩේ කැක්කුම | මිට
gripes=බඩේ රිදුම
grippe=ප්‍රතිශ්‍යාරෝගය
grisaille=ඒක වර්ණිකාව
grisly=ඉතා අවලක්ෂණ | භයානක | රෞද්‍ර
grist=අඹරනු ලබන ධාන්‍ය | භෝගය
gristle=තරුණාස්ථි | මෘදු ඇට
grit=අධිෂ්ඨානය | කැටිති | ධෛර්ය්‍යය | රළු වැලි | රොඩු | වැලි කැට | වැලි ගල් කැට | වැලිගල් කැට
gritter=රළුවැලි අතුරනය
gritting=රළුවැලි ඇතිරීම
gritty=බොරළු සහිත
grity=ධෛර්ය්‍යසම්පන්න
grizzled=අළු පාට ඇති
grizzly=අළු පාට ඇති | අළු පාට වලහා
grmmar=සද හතර
groan=කෙඳිරි ගානවා | කෙඳිරිය | ගොරවනවා
groat=පැරණි රිදී කාසියක්
groats=පොතු අරින ලද ධාන්‍ය වර්ගයක්
grocer=සිල්ලර වෙළෙන්දා
groceries=සිල්ලර බඩු
grocery=සිල්ලර බඩු කඩය | සිල්ලරකඩය
grog=ඇල්වතුර මුසු මද්‍යුපානය
groggy=වෙරි වූ
grogram=රළු සේද පිළි
groin=ඉකිළිය | කටිය | ඛාදන නිවාරකය | බෝක්කු සන්ධිය
grommet=ගිරිවර
groom=අස්ගොවුවා | කුදිර කාරයා | ජේත්තු කරනවා
groomsman=මනමාලයාගේ යහළුවා
groove=ඇලි කපනවා | ඇලිය | ඇළිය | කට්ටය | කූල | තට්ටුව | දාරය | පීල්ල | පීලි සාදනවා | පුරුද්ද | පුලුක්කුව | පොටලියනවා | හාරන ලද ඉර | හීවිට
grooving=ඇලි වැටීම | ඉරි ගිල්වීම | කට්ට දැමීම | පුලුක් ගෑම | සෑරී යෑම
grope=සොයාගන්නට වෑයම් කරනවා
grosgrain=කැරලි සහිත සේද
gross=අශික්ෂිත | ඖදාරික | ග්‍රෝසය | ගොරෝසු | ඝන | තරබාරු | දළ | දළ්හ | දැඩි | දුසින් දොළහ | බරපතළ | මුළු | සම්පූර්ණ | සළාරික | සාකල්‍යය
grosse=අන්තිම කැමති මුල්පත | අන්තිම කැමැති මුල්පත | ගොරසය
grossly=අධික ලෙස
grossness=අශිෂ්ටත්වය | ස්ථූලත්වය
grossuline=ග්‍රෝසියුලීන්
grotesque=අපරූපී | අස්වාභාවික | විකෘතරූපි | විකෘතරූපී | විකෘතාකාර | හාස්‍යජනක
grotto=කන්දරය | ගුහාව
grouch=කේන්තිකාරයා | කේන්තිය
ground=කාරණය | කුඩු කරන ලද | තලය | පතුළ | පදනම | ප්‍රතිෂ්ඨාව | ප්‍රදේශය | පිට්ටනිය | පිටිය | පුහුණු කරනවා | පොළොව | බිම | බිම සිටවනවා | බිම් ගැන්නීම | භූමිය | මූලවර්ණය | විෂය | හේතුව
grounded=පදනමක් ඇති | පුහුණු කරන ලද | බිම් ගැන්නූ
grounding=බිම් ගැන්නීම | මූලික පුහුණුව
groundless=අමූල | අමූලික | අහේතුක
groundling=නාට්‍යලෝලයා
groundplan=බිම් සැලැස්ම
grounds=ක්‍රීඩාභූමිය | පාදය | මණ්ඩි
group=කට්ටළය | කට්ටිය | කණ්ඩායම | කල්ලිය | කාණ්ඩය | කාය | කැල | ගණ | ගණය | ගොල්ල | නඩය | පංක්තිය | පන්තිය | පිරිස | පිල | පෙළ | මණ්ඩලය | මුළ | මුළු | යාය | යූථය | රැල | රැස | රැහැ | රිළු | වර්ග කරනවා | වර්ග වෙනවා | වර්ගය | වින්‍යාසය | සමවාය | සමුදාය | සමුදාව | සමුහය | සමූහ කරනවා | සමූහ වෙනවා | සමූහය | හවුල
grouping=පංක්ති වශයෙන් බෙදීම | වින්‍යාසය | සමූහනය
groupment=සමුහිතය | සමූහිතය
groupoid=සමූහාභ | සමූහාභය
grouse=නෝක්කාඩු කියනවා | නෝක්කාඩුව
grout=දියර බදාම | දියර බදාම කවනවා | හුණු බදාම කා වද්දනවා
grouting=දියර බදාම කැවීම
groution=දියර කැවීම
groutnick=යා කට්ටය
grove=අරඹ | උපවනය | ගස් ගොන්න
grovel=බිම වැතිරෙනවා
grovelling=අධම | නිවට
grow=ලියලනවා | වවනවා | වැඩි වෙනවා | වැඩෙනවා | වැවෙනවා | සැදෙනවා | සිටුවනවා | හටගන්නවා | හැදෙනවා | හෙවෙනවා
growing=වැඩෙන | වැවෙන
growl=ගෙරවීම | ගොරවනවා | තරහ ඇඟවීම
growler=ග්‍රව්ලය
growling=ගෙරවීම
grown=රුහ | වැඩුණු | වැවුණු | විරූළ්භ | සඤ්ජාත
growth=දියුණුව | පරිණාමය | මස් දලුව | වර්ධනය | වාද්ධිය | වාසිය | වැම | වැවිල්ල | විරූහනය
groyne=කටිය | ඛාදන වාරකය | මූදු බැම්ම
groynes=ඛාදන වාරක
grub=ඉහඳ පණුවා | කනවා | කම්බි පණුවා | කම්මැලියා | කෑම | දළඹුවා | පැංචා | පිළවා | හාරා මුල් උදුරනවා
grubby=කුණු තැවරුණු
grudge=අමනාපයෙන් දෙනවා | ඊර්ෂ්‍යා කරනවා | එදිරිවාදිකම | කුඩුකේඩුකම් කරනවා | කෝණ්තරය
gruel=කැඳ | තඩිබෑම | බරපතළ දඬුවම | යාගු | හුළුකැන්
gruelling=වෙහෙසකර
gruesome=බිහිසුණු | භයානක
gruff=කර්කශ | රළු
grumble=අවලාද කියනවා | අවලාදය | අසන්තෝෂය | කෙඳිරීම | කොඳුරනවා | ගෙරවීම | නාහෙන් අඬනවා | මැසිවිලි කියනවා
grumbling=අවලාදය | අසන්තෝෂය | ඈයාව | කන් කෙඳිරිය | කෙඳිරීම | ගෙරවීම
grummet=ගිරිචර වොෂරය | ගිරිවර
grumpy=අවලාද කියන | නොඉවසිලිවන්ත | වහා කිපෙන
grunt=අමනාපය ප්‍රකාශ කරනවා
gruyere=කේජු විශේෂයක්
guage=ආමානය
guana=ගොයා | තලගොයා
guano=කුරුළු බෙටි | ගුවානෝ පෝර
guaranine=ගුවාරනින්
guarantee=ඇප කාරයා | ඇප පත්‍රය | ඇප වෙනවා | ඇපකරු | ඇපකාර | ඇපය | ඇපවීම | ඇපවෙනවා | තරයනවා | තැරැයුම | ප්‍රතිඥාව | පොරොන්දුව | වග කියනවා | වගකියනවා | වගකීම | වගබලා ගන්නවා | සහතික කරනවා | සහතිකය
guarantor=ඇප කරු | ඇප කාරයා | ඇපකරු | තරයුවා | සහතික කරු | සහතිකකරු
guaranty=ඇප ඔප්පුව | සහතිකය
guard=අරක්ගන්නවා | ආරක්ෂකයා | ආරක්ෂා කරනවා | ආරක්ෂාව | ආවරණය කරනවා | ඔර්ලෝසු මාලය | කාවල | ගුප්තිකයා | නියාමක | බලා ගන්නවා | මුර | මුර කණ්ඩායම | මුර කරනවා | මුර කිරීම | මුරකාරයා | මුරකාවල | රක | රක්ෂය | රකිනවා | රකින්නා | රැකවල | රැකවල් | රැක්ම
guard-post=කඩවත
guarded=ආරක්ෂිත | පරෙස්සම් සහිත | සංවුතය | සාවධාන
guardian=ආරක්ෂකයා | භාරකරු | භාරකාරයා | රක්ෂකයා | රැකබලාගන්නා
guardian-ad-litem=නඩු භාරකරු
guardianship=පාලනය | බාරකාරකම | භාරකාරත්වය
guardin=භාරකරු
guardsman=රාජ්‍යාරක්ෂක භටයා
guardstone=මරගල | මුරගල
guava=පේර
gubbins=යන්ත්‍රයක කොටසක්
gubernator=ගොවුනුරුවා
gubernatorial=ආණ්ඩුකාරයා සම්බන්ධ
gudermanian=ගුඩමේනියානුව
gudgeon=ගජනය | නිවටයා | පහසුවෙන් රැවටෙන්නා
guerdon=තෑග්ග | පාරිතෝෂිකය
guerilla=ගරිල්ලා
guernica=ගෙර්නිකා
guernsey=කිරි එළදෙනුන් වර්ගයක්
guerrilla=ගරිල්ලා
guess=අනුමාන කරනවා | අනුමානය | ඌහනය | ඌහනය කරනවා | සැක කරනවා
guessing=දූසමාන
guest=අතිථි | අමුත්තා | ආගන්තුකයා | එද්දලයා
guff=හිස් කථා
guffaw=අට්ටභාසය | කොක්හඬලනවා | මහත් ශබ්දයෙන් සිනහවීම
guidance=අනුශාසනය | අනුශාසනාව | මග පෙන්වීම | මාර්ගෝපදේශකත්වය | සංනයනය
guide=උපදේශකයා | කැඳවාගෙන යනවා | නියමුව | නියාමක | පාලනය කරනවා | මග පෙන්වනවා | මඟපෙන්වනවා | මාර්ග විස්තරය | මාර්ගදේශකයා | මාර්ගෝපදේශක | මිම්ම | හසුරුවනවා
guideline=මාර්ග නිර්දේශය
guidelines=මාර්ගසූචක
guiding=නියෙමීම
guild=ශ්‍රේණිය | ශිල්ප ශ්‍රේණිය | සංඝය
guildsman=ශ්‍රේණිකයා
guile=කපටකම | දඟය | වංචාව
guileful=කපටි | මායාවී | වංක
guilloche=දාම පූට්ටුව
guillotine=ගිලටිනය | ගිලටිම | ගිලටීන් සමාප්තිය | යන්ත්‍රයෙන් හිස ගසාදමනවා | විවාදච්ඡෙදනය | ශිරස්ඡේදකය
guilt=අපරාධය | වද්‍යුතාව | වරද | වරදකාරිත්වය | සාවද්‍යුතාව | සාවද්‍යුය
guiltless=නිර්දෝෂ
guilty=වරදකාර | වරදකාරී | සාපරාධ
guinea=ගිනි | ගිනිය
guipure=ඇම්බ්‍රොයිඩර් කිරීමේදී යා කරන ලද රේන්ද
guise=ආකාරය | ඇඳුම | පිටත පෙනුම | රැවටිල්ල | වේශය
guitar=කින්නාරම | ගිටාරය | තූර්ය්‍ය භාණ්ඩයක් | සිතාරය
gulch=ගැඹුරු පටු ගල්කුළු නිම්නය
gulf=ආගාධය | පාතාලය | බොක්ක | මහත් භේදය | විශාල මුහුදු බොක්ක | සමුද්‍රවංකය
gull=නිවටයා | ප්‍රයෝගය | මුහුදු ලිහිණියා | රවටනවා
gullet=උගුර | ගල නාළය | ගල මඟ | ගලකය
gulleting=ගල බේරීම
gulley=ගලිය
gullible=පහසුවෙන් රැවටෙන | වහාරැවටෙන
gully=ඇගිලිය | ගලිය | පීල්ල
gulp=අමාරුවෙන් ගිලිනවා | ඉක්මනින් ගිලිනවා | කටපුරා එකක් | ගිලීම | ගිලීමට කරන ප්‍රයත්නය
gum=ගල් අඟුරු සුනු | මැලියම | මැලියම් | මැලියමින් අලවනවා | ලහටු | ලා | ලාටු | විදුරුමස | විදුරුමහ
gumlac=රට දුම්මල
gumma=ගමාව
gummata=ගමා
gummer=අඟුරු සුනු ඉවත් කරනය | අඟුරු සුනු ඉවත් කරන්නා
gumming=ඇලෙනසුලු
gummings=ගල් අඟුරු සුනු
gummy=ලාටු සහිත
gumption=නුවණ | ස්ථානෝවත ප්‍රඥාව
gumptious=නුවණ ඇති
gun=කටපුංචා | තුවක්කුව | විදුනාව
gun-metal=තුවක්කු ලෝහය
gunite=ගනයිට්
gunman=තුවක්කු අතින් ගත්තැනැත්තා | වෙඩික්කාරයා | වෙඩිකාරයා
gunmen=තුවක්කුකරු
gunmetal=කාලතුවක්කු ලෝකඩ
gunnel=ඔරුකහ
gunner=කාලතුවක්කු කාරයා
gunnery=කාලතුවක්කු පිළිබඳ ශාස්ත්‍රය
gunny=ගෝනි රෙදි | ගෝනිය
gunpowder=වෙඩි බෙහෙත්
gunwale=ඔරුකහ
guppy=කුඩා මාලුවෙක්
gurgle=ගරගර ගානවා | ගරගර ශබ්දය
gurkha=නේපාල භටයා
gurnard=විශාල හිසක් ඇති මුහුදු මාලුවෙක්
guru=ගුරුවරයා
gush=අධික උනන්දුව | අධික ළැදිකම් දක්වනවා | ගළනවා | වේගයෙන් ගලා යනවා | වේගයෙන් ගලා යාම
gusset=කසැලි තහඩුව | කසැලි රුකුල
gust=රසාස්වාදනය | වේගයෙන් නගින දුම | වේගයෙන් වැටෙන වැස්ස | සුළං පහර | හදිසි කෝපය
gustation=රසයනය
gustatory=රසේන්ද්‍රිය පිළිබඳ වූ
gustiness=සුළං පහර ඇතිවීම
gusty=කෝප වූ
gut=අතුණ | ආන්තය | ඉතා පටු පාර | තත | දුනු ලණුව | දුනු ලනුව | බඩවැල | බඩවැල් ඉවත් කරනවා | විනාශ කරනවා | වීණාතන්ත්‍රි
guto=අභිරුවය | මහත් උනන්දුව
guttal=කඳුතුව
guttameter=බිංදුදමානය
guttation=බින්දුදය
gutted=බඩවැල් ඉවත් කළ | සම්පූර්ණයෙන් විනාශ වූ
gutter=අගල | ඉතා දුක්ඛිත විතය | කාණුව | ප්‍රණාලිකාව | ප්‍රණාලිය | පිහිල්ල | පීල්ල
guttural=කණ්ඨජ | කණ්ඨජාක්ෂරය | බොටුවෙහි උපන්
guy=පඹයා | පැන යනවා | වැර රැහැන
guzzle=කට ගණනක් බොනවා | ගිජු ලෙස කනවා
gym=ක්‍රීඩා මණ්ඩලය | ව්‍යායාම් ශාලාව | සරඹ ශාලාව
gymanastics=චීනාඩි
gymkhana=විශාල ක්‍රීඩාභූමිය
gymnasium=ක්‍රීඩා මණ්ඩලය | ගෘහස්ථක්‍රීඩාංගණය | ජවසරඹහල | ව්‍යායාම් ශාලාව | සරඹ ශාලාව | සරඹහල
gymnast=සරඹයෙහි දක්ෂයා
gymnastic=සරඹ පිළිබඳ වූ
gymnastics=ජවසරඹ | සරඹ ක්‍රීඩා
gymnocarpic=විවෘතඵලීන
gymnodinium=ම්නෝඩිනියම
gymnosophist=දිගම්බරයා | නග්න තාපසයා | නිගන්ඨයා
gymnosperm=විවෘත බීජකය | විවෘතබීජකය
gymnospermae=ගිම්නොස්පෙර්මේ
gymnospermous=විවෘතබීජක
gynaeceum=මලක ස්ත්‍රී කොටස්
gynaecium=ජායාංගය
gynaecocracy=නාරිතන්ත්‍ර
gynaecological=නාරීයවේදික
gynaecology=නාරිවේදය | නාරීයවේදය | ස්ත්‍රී රෝග විද්‍යාව | ස්ත්‍රී චිකිත්සාව | ස්ත්‍රීරෝග විනිශ්චය
gynandrophore=පුංජායාංගීධරය
gynandrous=පුංජායාංගී
gynobasic=ජායාංගපාදී
gynocracy=නාරිතන්ත්‍ර
gynodimorphism=ජායාද්විරූපතාව
gynodioecious=ජයාද්විගෘහික
gynodioecism=ජායාද්විගෘහිකතාව
gynoecism=ජායාගෘහිකතාව
gynoecium=ජායාංගය
gynomonoecious=ජායෛකගෘහික
gynomonoeism=ජායෛකගෘහිකතාව
gynophore=ජායාංගධරය
gynosporangium=ගයිනොස්පොරන්ගිය
gynostegium=උභයාංග ස්තම්භය | ගයිනොස්ටෙගිය | රේණු මුකුට
gynostemium=උභයාංගස්තම්භය
gypnotic=ස්වාපක
gypsiologist=අහිගුණ්ඨික වේදියා
gypsum=කිරිමැටි වැනි ද්‍රව්‍යයක් | ජීප්සම් | ප්සම්
gypsy=අහිකුණ්ටකයා | අහිගුණ්ඨිකයා | අහිගුන්ඨිකයා
gypsy-lore=අහිගුණිඨික ශ්‍රැතිය
gypsyology=අහිගුණ්ඨික වේදය
gyrate=මණ්ඩලාකාර | වටේට යනවා
gyration=භ්‍රමණය | විභමණය | විභ්‍රමණ | විභ්‍රමණය | විභ්‍රමණය වෙනවා
gyrator=විභ්‍රමකය
gyratory=වටේට යන
gyrfalcon=විශාල උකුස්සා
gyrocompass=විභ්‍රම මාලිමාව | විභ්‍රමණ මාලිමාව
gyromancy=කවපේනය
gyroscope=විභ්‍රමණේක්ෂය | විභ්‍රමේක්ෂය
gyrostat=විභ්‍රම ස්ථිතිකය | විභ්‍රමස්ථිතිකය | විභ්‍රමස්ථීතිත්‍රය
gyrostatics=විභ්‍රම ස්ථිති විද්‍යාව | විභ්‍රමස්ථීතිකය
