h=එච් හැඩය ඇති යකඩ බාල්කය
h=එච් හැඩය ඇති යකඩ බාල්කය
h-bomb=ජලකර බෝම්බය
h.f.=උච්ච සංඛ්‍යාත | උච්ච සංඛ්‍යාතය
h.n.c=උසස් ජාතික සහතිකය
h.n.d.=උසස් ජාතික ඩිප්ලෝමාව
h.p.=අධි පීඩන | අශ්ව ජවය | කුලී සින්නක්කරය
h.t.=අතිශක්මතාව
h.u.c.r.=ප්‍රයෝජනවත් අධිකතම සම්පීඩන අනුපාතය
ha=පුදුමය ඇඟවීමේ නිපාතයක් | සතුට ඇඟවීමේ නිපාතයක් | සැකය ඇඟවීමේ නිපාතයක්
ha!ah!=ඔහෝ
habble=කොරගසනවා
habenula=හබ නුලාව
haberdasher=තොරම්බල් කාරයා
haberdashery=තොරොම්බල් බඩු
habiliment=ඇඳුම | වස්ත්‍රය
habit=ඇබ්බැහිය | පරිචය | පරිචීතය | පරිවතය | පුරුද්ද | විලාසය | ස්වභාවය | හැසිරීම
habit-deterioration=පරිචය හානිය
habit-disorganization=පරිචය විසංවිධානය
habit-formation=පරිචය සාධනය
habit-interference=පරිචය ඝට්ටනය
habitability=නිවාසස්‍යය | වාසයෝග්‍යතාව
habitable=වාසයට සුදුසු
habitant=වැසියා
habitat=ගෝචරස්ථානය | ජන්මභූමිය | වාසභූමිය | වාසස්ථානය
habitatio=නිවසනය
habitation=නිවාසය | වාසය | වාසස්ථානය
habitd=පරිචාරය
habitual=ඇබ්බබැහියා | ඇබ්බැහි | නිත්‍ය | පරිවත | පරිවන්න | පරිවන්නයා | පුරුද්දෙන් ඇතිකරගත් | පුරුදු | සිරිත් ලෙස වූ
habitually=ඇබ්බැහියෙන් | පරිවන්න වශයෙන්
habituate=පුරුදු කරනවා
habituation=ඇබ්බැහිය | පරිචයනය
habitude=පුරුදු ක්‍රියාව
habitue=ගුල්ලා
haboob=හබුබ් සුළඟ
hachure=කඩ ඉරි
hachures=පොකුරු ඉරි | සේයා ඉරි
hachuring=පොකුරු ඉරි ලෑම | සේයා ඉරි ඇඳීම
hacienda=හසියෙන්දාව
hack=කපනවා | කහිනවා | කුලී අශ්වයා | කොටනවා | ගල්කටුව | පෙති ගහනවා
hack-saw=දුනුකියත
hackery=තනි ගොන් කරත්තය | තිරික්කලය
hacking=සැසීම
hackle=ප්‍රශ්න ඇසීමෙන් වෙහෙසනවා | පෙති ගසනවා | හන පීරන පනාව
hackneed=කසි කබල්
hackney=කුලී අශ්වයා | කුලී අශ්වරථය
hackneyed=සුලභ
hacksaw=ලෝහ කියත
haddock=මත්ස්‍ය වර්ගයක්
hade=විභේද කෝණය
hades=නිරය | පාතාල ලෝකය | පාතාලය | රසාතලය | හේඩිස් රජු
hadj=මක්කමට යන වන්දනා ගමන
hadji=මක්කමට ගිය වන්දනාකරුවන්ට ලැබෙන ගෞරව නාමය
hadrocentric=උභය ප්ලෝයමීය
hadromal=දාරුක | හඩ්‍රෝම
hadromase=හැඩ්‍රොමේස්
hadrome=දාරුකය | හඩ්‍රෝම | හයිඩ්‍රෝම
haecceity=ඉදංතාව
haemal=ලේවලට සම්බන්ධ
haematein=හීමටෙයින්
haematemesis=රක්තචර්දනය
haematinic=රක්තකාරක
haematite=රෙික් ඔක්සයිඩ් අඩංගු ලෝහ නිධිය | හීමටයිට් | හෙමටයිට්
haematochrome=හීමැටොක්‍රෝම්
haematocolpos=රක්තකංචුව
haematocytometer=රක්තාණුමානය | හිමැටොසයිටමානය
haematology=රක්තවේදය
haematoma=රක්තමාව
haematometra=රක්ත මාතෘකය
haematoxylin=හීමැටොක්සිලින්
haematrosalpinx=රක්තකාහලිකාව
haematuria=රක්තමූත්‍රතාව
haemoconcentration=රක්තසාන්ද්‍රණය
haemoglobia=හිමොග්ලොබින්
haemoglobin=රක්තරංගය | හීමොග්ලොබින්
haemophilia=රක්තකාමතාව | රක්තකාම්‍යය | හෙමොපිලියාව
haemoplastin=හීමොප්ලාස්ටින්
haemopoiesis=රක්ත ශෘෂ්ඨිය
haemoptysis=රක්ත කාසය | රක්තකාසය
haemorrhage=කිලිමාලය | රක්තගරණය | රක්තපාතය | ලේ යාම
haemorrhage,capillary=කෘශලක රක්තපාතය
haemorrhage,venous=ශෛරික රක්තපාතය
haemorrhoid=රක්තරීතාභය | හෙමොරොයිඩ්
haemorrhoids=අර්ශස්
haemosstatic=රක්ත ස්ථිතකය
haff=හාපුව
hag=මැහැල්ල
haggard=වෑරුණු
haggle=කේවල් කරනවා | කේවෙල් කරනවා
haggling=කේවල් කරනවා | කේවෙල් කරනවා
hagiology=සාත්තුවරයන් පිළිබඳ තොරතුරු
haiku=හයිකු
hail=ආචාර කරනවා | ආචාරය | ආමන්ත්‍රණය | ගල් වැස්ස | ගල් වැසි වසිනවා | වැටෙනවා | ශබ්ද නගා අඬගසනවා | ස්වස්ති | සැරද | හිම කැට වැස්ස | හිමකැට | හිමකැට වැස්ස
hail-stone=හිම කැටය
hailstone=හිමවැහි කැට
hair=ඉසකෙස් | කෙසර | කෙස් | කෙස්ස | කේශ | කේශර | කොණ්ඩය | බූව | මයිල් | මුහුළස | රෝම | රෝඹුව | ලොම් | ලොමු | ලෝම | වාල | ශිරෝරුහ | සිරෝරුහ | හිසකෙස් | හිසකේ
hair-pin=කූර | කොණ්ඩ කටුව
hairdresser=කරණවෑමියා
hairknot=මුහුළ
hairpin=කොණ්ඩා කටුව | හර්නලය
hairs=කේශර | බුව | රෝම
hairy=කේශාකාර | බු සහිත | සලෝම
hajji=මක්කමට ගිය වන්දනාකරුවන්ට ලැබෙන ගෞරව නාමය
hake=මුහුදු මාලුවෙක්
halberd=කෙටේරිය | පොරෝතලයක් සහිත හෙල්ල
halberd-shaped=කුන්තාකාර
halberdier=පොරෝතලයක් වැනි අවිගත් භටයා
halbert-shaped=කුන්තාකාර
halc=ප්‍රභා මණ්ඩලය
halcyon=දිය පිළිහුඩුවා | නිශ්චල | ශාන්ත
hale=ඇදගෙන යනවා | නිරෝගී | සවි ශක්ති ඇති
half=අඩ | අඩක් | අර්ධ | අර්ධය | අසම්පූර්ණ | අසම්පූර්ණ ලෙස | ඉරුව | දෙකෙන් පංගුව | පංගුව | පලුව | පළුව | පියලි | බාග | බාගය | බාගෙට | බෑ | බෑය | භාගය | සමහර
half-breed=දෙමුහුම
half-closed=අඩවල්
half-day=එක්වරුව
half-duplex=අර්ධ ද්විපථ
half-invariant=අර්ධ අවිචලකය
half-mast=අඩකුඹ
half-nasal=සඤ්ඤකය
half-plane=අර්ධතලය
half-share=අඳය
half-tide=අඩ උදම
half-title=කෙටි ග්‍රන්ථනාමය
half-width=අඩ පුළුල | අඩපුළුල
half-yearly=අර්ධ වාර්ෂික | අර්ධ වාර්ෂිකව
halfdone=අඩාළ
halfpenny=පැන්සබාගය
halftone=අර්ධ තාන
halibut=මත්ස්‍ය වර්ගයක්
halide=හේලයිඩ්
halitosis=දුර්ගන්ධ ශ්වාසය
halitus=කටින් පිට කරන හුස්ම
hall=ධනපතියකුගේ විශාල මන්දිරය | මඩුව | මණ්ඩපය | රඟහල | ලොකු කාමරය | වංශවතකුගේ විශාල මන්දිරය | විශ්වවිද්‍යාලයක පොදු ශාලාව | විශ්වවිද්‍යාලයක භෝජන ශාලාව | ශාලාව | සල | සල් | සාල | සාලය | සාලාව | සැල | සැල් | හල | හල්
hallelujah=දේවස්තෝත්‍රය
halliard=කුඹ ගසේ රුවල් හා කොඩි ඇදීමට ඇති කඹය | මුහුදු යාත්‍රාවක රුවල් පාලනය කරන ලනුව
hallmark=තථ්‍යාංකය | තථ්‍යාඩ්කය | ප්‍රමුද්‍රාව
hallo=ඒ‍යි
halloo=අඬගසනවා | දඩයමේදී කරන හඬ ගැසීම | සයි | හෝයි
hallow=පවිත්‍රභාවයට පමුණවනවා
hallowmas=සියලු සාත්තුවරයන්ගේ දිනය
hallucination=ඉන්ද්‍රජාලය | භ්‍රාන්තිය | මායාව | මුළාව | ව්‍යාජ දර්ශනය | ව්‍යාමෝහය
hallucinatory=මායා
hallucinesis=භ්‍රාන්තාබාධය
hallucinogen=භාන්තිජානකය
halo=අංශු මාලාව | කේතුමාලාව | පරිවේශය | ප්‍රබා මණ්ඩලය | ප්‍රභා මණ්ඩලය | ප්‍රභාමණ්ඩලය | බ්‍යාමප්‍රභා මණ්ඩලය | රංසි මාලාව | රශ්මි කදම්බය | රැස් වළල්ල | රැස්වළල්ල | ව්‍යාමප්‍රභා
halochromism=ලවණ වර්ණකතාව
halogen=හැලජන්
halophilous=ලවණකාමී
halophobe=ලවණාපගය
halophyte=ලවණ ශාකය | ලවණශාකය
halophytic=ලවණ ශාකීය
halophytism=ලවණශාකතාව
halosere=ලවණ සංශ්‍රෙණිය
hals=හල් වංශය | හල් වංශිකයෝ
halt=ඇණහිටවනවා | ඇන හිටිනවා | කොර | නවතනවා | නවත්වන්න | නවතිනවා | නැවතීම | නැවතුම | නැවතුම් පොළ | නොණ්ඩි | නොණ්ඩි ගසනවා | නොණ්ඩිය | විරාමය
halter=කණ්ඨපාශය | බාන
halve=දෙකට බෙදනවා | දෙපළු කරනවා
halved=අඩාල
halving=පළු මූට්ටු කිරීම | බාගෙට කැපීම
halyard=කඹ | කුඹ ගසේ රුවල් හා කොඩි ඇදීමට ඇති කඹය | මුහුදු යාත්‍රාවක රුවල් පාලනය කරන ලනුව
ham=ආධුනිකයා | කලවෙහි පිටිපස | රමකයා | වල්ලූර | සක්තිතන්ත්‍රය
hamada=හමදාව
hamate=වකුටු | ශ්‍රැණ්‍යායිතය
hamiltonian=හැමිල්ටෝනියානුව
hamitic=පුරාණ අප්‍රිකානු භාෂාවක්
hamlet=කුඩා ගම | කුඩාගම
hammer=තඩිබානවා | තළනවා | මිටිය | මිටියම් කරනවා | මිටියෙන් ගහනවා | මිටියෙන් තළනවා | යකුළ
hammering=තැළීම | මිටි පහර දීම
hammerman=මිටි ලන්නා
hammock=එල්ලන ඇඳ | තොටිල්ල
hamose=වකුටු
hamous=වකුටු
hamper=අවහිර කරනවා | කදමල්ල | ලොකු කූඩය | ලොකු පැස | වළකනවා
hamster=කුඩා සතෙක්
hamstring=කලවේ නහරය | ක්‍රියාකාරීත්වය නැති කරනවා
hamulus=වලිශය
hanamichi=හනමිවය
hand=අඟල් හතරේ ප්‍රමාණය | අත | අත්අකුරු | අත්සන | උදවු කරනවා | කම්කරුවා | කර | ක්‍රියා කිරීම | දිශාව | පොරොන්දුව | බුජ | ශිල්පියා | හත් | හත්ථ | හස්තය
hand-axe=අත්පොරව
hand-bill=අත් පත්‍රිකාව | අත්පත | ප්‍රචාරක පත්‍රය
hand-cart=අත්කරත්තය
hand-maid=මෙහෙකාරී
hand-maiden=මෙහෙකාරී
hand-money=අත්තිකාරම් මුදල
hand-net=අතංගුව
hand-over=පවරනවා | භාර දෙනවා
hand-pump=අත් පොම්පය
hand-rail=අත්වැල
hand-saw=අත්කියත
hand-shake=අතට අත දෙනවා
hand-work=අත්වැඩ
handbill=අත්පත | අත්පත්‍රිකාව
handbook=අත්පොත | ගුරුපොත
handcuff=සංඛලා
handcuffs=මාංචු
handedness=අත් හුරුව
handful=අතලොස්ස | අතළොස්ස | අසුර | අහුර | පුට | මිට
handicap=අමාරු කරනවා | ප්‍රතිබන්ධනය | බාධා කරනවා | බාධාව
handicapped=අංග විකල | අඩුවාසි
handicraft=අත්කම් | අත්වැඩ | ගෘහ කර්මාන්තය | දක්ෂ ශිල්පය | හස්ත කර්මාන්ත | හස්ත කර්මාන්තය | හස්තකර්මාන්ත
handicrafts=අත්කම් | හස්ත කර්මාන්ත
handicraftsman=ශිල්පියා
handily=දක්ෂ ලෙස | පහසුවෙන්
handiness=දක්ෂකම | පහසුව
handing=අත් මාරු කිරීම
handiwork=යහපත් අත් වැඩ
handkerchief=අත් ලේන්සුව | ලේන්සුව
handle=අත | අතගහනවා | අතගා බලනවා | අතට ගන්නවා | අල්ලුව | කයිපුඩිය | කෛපුඩිය | පාලනය කරනවා | පාවිච්ව කරනවා | මිට | වාසිය | වැල් අත | හසුරුවනවා
handling=කරසන | පරිහරණය
handout=දීමනාව
handrest=අත් ඇන්ද
handsome=අභිරූප | ආරෝහ පරිණාහ සම්පන්න | ඉතා සතුටුදායක | උදාර | කඩවසම් | මනහර | රූප සම්පන්න | විපුල
handwriting=අත් අකුරු | අත්අකුරු
handy=දක්ෂ | පහසු | ලඟ පිහිටි | හපන්
handyman=නොයෙක් විධියේ වැඩෙහි දක්ෂ තැනැත්තා
handywork=යමෙකුගේ ක්‍රියාවෙන් ඇතිවන ප්‍රතිඵලය
hang=අදහස | උඩක සවිකරනවා | එල්ලනවා | එල්ලා තබනවා | එල්ලා මරනවා | එල්ලා වැටෙනවා | එල්ලී තිබෙන ක්‍රමය | එල්ලෙනවා | ඔලඹනවා | ක්‍රියා පිළවෙළ | තේරුම | බිත්තියෙහි අලවනවා | මිටි අල්ලන විලාසය | සරසනවා
hangar=අහස්‍යාත්‍රාංගනය
hanger=එල්ලනය | එල්ලුම | එල්ලෙන බෙයාරිම | බෝලකූඩුව | හැංගරය
hangers=එල්ලුම් දඬු
hangfire=පමා පිපිරුම
hanging=ආලම්බ | එල්ලා මැරීම | එල්ලීම | එල්ලෙන | ප්‍රලම්බ
hangman=අලුගෝසුවා | අළුගොසුවා | වධකයා
hank=නූල් මල | නූල්මල
hanker=ආශා කරනවා
hankering=ලොල්බව
hanky=අත් ලේන්සුව
hansard=මන්ත්‍රී මණ්ඩල වාර්තා සංග්‍රහය | හැන්සාඩ් වාර්තාව
hansom=රෝද දෙකේ අශ්ව රථය
hansomcab=රෝද දෙකේ අශ්ව රථය
hap=අහම්බය | සිදු වෙනවා
haphazard=අහම්බෙන් ඇති වන
hapiness=මුදිතා
hapless=අවාසනාවන්ත
haplobiont=ඓකවකය
haplobiontic=ඓකවක
haplochilus=හැප්ලෝකයිලස්
haplochlamydeous=ඓකපරිපුෂ්පී
haploid=ඒකගුණ | ඒකගුණකය
haplont=ඓකයා
haplophase=ඒකගුණකලාව
haplostele=සරලස්ථුණය
haplostemonous=ඓකරේණුක
haplotype=ඓකදර්ශය
haplotypic=ඓකදර්ශීය
haply=ඇතැම් විට
happen=අහම්බෙන් වෙනවා | පලදෙනවා | වෙනවා | සිදු වෙනවා
happened=වුණු | වූ | සිද්ධ
happening=සිද්ධිය
happenings=සිද්ධි | සිද්ධි රංග
happily=ප්‍රීතියෙන් | පුලා | යෙහෙන් | සතුටින් | සැපවත් ලෙස | සිත් සේ
happiness=කලණ | තිළි | තිළී | තුෂ්ටිය | තුස | ප්‍රීතිය | වාසනාව | සතුට | සැප | සැපත | සුඛය | සෙත්
happy=ඉතා යෝග්‍ය | කුල්මත් | තුටු | තුෂ්ට | තුස්නා | තෘප්තකර | ප්‍රිතිමත් | මුදිත | වාසනාවන්ත | සතුටු | සැප | සැපවත් | සුඛිත
haptaphore=ස්පර්ශකධරය
hapteron=සංචාරකය
haptics=ත්වච | ස්පර්ශ
haptometer=ස්පර්ශමානකය
haptonasty=ස්පර්ශසන්නමනය
haptotropism=ස්පර්ශාවර්තනය
haptotype=ස්පර්ශදර්ශය
harangue=දෙසා බෑම | හඬනගා දේශනා කරනවා
harass=අඩන්තේට්ටම් කරනවා | අතිශයින් හිරිහැර කරනවා | ලෙල්ලම් කරනවා | වද දෙනවා | වදේ දෙනවා | හිරිහැර කරනවා
harassment=දුකින් පෙලීම | වදය | හිරිහැර කිරීම
harbinger=අග්‍රදූතයා | පණිවුඩ කාරයා | පූර්වනිමිත්ත
harbour=ආරක්ෂා සලසා දෙනවා | ආරක්ෂාස්ථානය | ආශ්‍රය | නැව්තොට | රැකවරණය දෙනවා | වරාය | වරායට පැමිණෙනවා | සිතෙහි පදිංවි කරගන්නවා
harbourage=ආරක්ෂාව
hard=අප්‍රසන්න | අමාරු | අමාරුවෙන් | ඇට්ටර | කඨින | කඨෝර | කර්කශ | ක්‍රෑර | ඛර | ගන | ගාඩ | ඝන | තද | තදබල | තදින් | තිර | දැඩි | දිඩ | දුරවබෝධ | දුෂ්කර | දෘඩ | පරුෂ | බරපතළ | රොළු | ලෝබ | වැරෙන් | ස්තබ්ධ | සැර | හයිය | හරකං
hard-boiled=කට්ට
hardback=ඝනකවරපොත
hardboard=හාඩ් බෝඩ් | හාඩ්බෝඩ්
hardboiled=කිසි දයාවක් නැති
harden=කැටි කරනවා | කැටි වෙනවා | ඝන කරනවා | ඝන වෙනවා | තද කරනවා | තද වෙනවා | දැඩි කරනවා | දැඩි වෙනවා
hardenability=දැඩියම් ගතිය
hardener=දැඩිකරුව
hardening=දැඩි කිරීම | දැඩියම
hardenite=හාඩනයිට්
hardie=කිණිහිරි කටුව
hardihood=ගරුසරු නැති බව
hardiness=දැඩිකම | ශක්තිය
hardness=තදබව | දැඩි බව | දැඩිබව | දැඩියාව | ප්‍රසංවාදී
hardpan=කඨෝර ස්තරය | දැඩි තට්ටුව
hardship=අමාරුව | පීඩාව
hardware=දෘඩාංග | පරියන්ත්‍රණ | ලොහො බඩු | ලෝහ බඩු | ලෝහ භාණ්ඩ | ලෝහභාණ්ඩ
hardwater=කඨින ජලය
hardwood=දැඩිදැව | හරය | හරය ඇති ලීය
hardy=අමාරුවෙන් | තද ලෙස | දැඩි | ධෛර්ය්‍යවත් | යන්තම් | ලෙහෙසියෙන් වැවෙන | ශක්තිමත් | සවිබල ඇති
hare=ශශ | සස | සාවා | හා | හාවා
harelip=බෙදුණු තොල | හා තොල
harem=අන්තහ්පුරය | ඇතොවුර | ශුජාන්තය
haricot=බෝංව විශේෂයක්
hark=අසනු | ඇහුම්කන් දෙනවා
harlequin=කෝනංගියා | බහුබූතයා
harlequinade=බහුබූත සෙල්ලම
harlot=ගණිකාව | වෙසඟන | වේශ්‍යාව | වෛශ්‍යාව
harlotry=වේසාකම | වෛශ්‍යාකම
harm=අනර්ථය | අපක්‍රියාව | අපකාර | අවැඩ | උපද්‍රවය | නපුර | පාඩුව | පීඩාව | රිටුදොස | වරද | සෝලිය | හදිය | හානිය | හිංසාව
harmattan=හාර්මටන්
harmful=අනර්ථ | අනර්ථකාරී | අවැඩ | අවැඩ සහිත | හානිකර | හිංසාකාර
harmless=අහිංසක | උපද්‍රව රහිත
harmonic=අනුවර්තිය | අනුවර්තී | අනුවර්තී විශ්ලේෂණය | ඒකතාන | ප්‍රසංවාදය | ප්‍රසංවාදී | සමස්වර | හරාත්මක
harmonica=නළා විශේෂයක්
harmonics=නාද ශාස්ත්‍රය | ප්‍රසංවාදය
harmonious=අනුකුල | අවිරෝධී | එකමුතු | සුමිහිරි | සුස්වර
harmonium=තූර්ය භාණ්ඩ විශේෂයක් | වාද්‍යු මංජුසාව | හාමෝනියම
harmonization=එකමුතු වීම
harmonize=එකමුතු කරනවා | එකමුතු වෙනවා
harmony=අනුවර්තිය | අවිරෝධය | ආනුරූප්‍යය | එකඟකම | එකමුතුකම | ප්‍රංසවාදය | ප්‍රසංවාදය | බුහුතත | සංගතිය | සංගීතය | සංවාදය | සමගිය | සමස්වරත්වය | ස්වරමාධූර්යය | සුසංයෝගය | සුසංවාදය
harness=අශ්ව ඇඳුම | අශ්වයා ඇඳුමෙන් සරසනවා | අශ්වයාගේ සන්නාහය | අසරුවාගේ සන්නාහය | කම්බි එකමුතුව | පොරොදුව | සන්නද්ධ වෙනවා
harp=මට්ටම් අන්තරය | වීණා වාදනය කරනවා | වීණා විශේෂයක්
harper=විණාව වාදනය කරන්නා
harpist=විණාව වාදනය කරන්නා
harpoon=ඇවුලුම් බිලිය | ඇවුලුම් බිළිය | මණ්ඩාව | හාපූනය
harpsichord=අනුන්ගේ වස්තුව සූරාගෙන කන්නා
harpy=ගරුජා | නපුරු කුම්මැහි අකාරුණික ස්ත්‍රිය
harquebus=පැරණි තුවක්කු වර්ගයක්
harridan=වෘජ වේශ්‍යාව
harrier=දඩයමෙහි යොදන කුඩා බලු වර්ගයක්
harrow=අතිශයින් සිත් රිදවනවා | කූරුගානවා | දැතිපෝරුව | බිම නඟනවා | මඩ කරනවා | මඩවනවා
harrowing=අතිශය ඛේදජනක | මැඩවිල්ල | ළය පැළෙන
harry=කොල්ලකනවා | වනසනවා | විලුම්පනය කරනවා
harsh=අමිහිරි | කටුක | කර | කරදර | කර්කශ | කුරිරු | කොරොස් | පරුෂ | ඵරුෂ | රළු
harshness=කර්කශකම | කර්කශතාව
hart=පස් වසරට වැඩි ගෝනා
hartebeeste=වක් වූ අං ඇති අප්‍රිකානු මුව විශේෂයක්
haruspication=මළමුවපේනය
harvest=අස්වැන්න | අස්වැන්න නෙලනවා | අස්වැන්න ලබාගන්නා කාලය | කන්න | ගොයම | පලදාව | ප්‍රතිඵලය | භවබෝග | ශස්‍යකාලය | සරු දැක්ම
harvest-moon=බිනර පුන් සඳ
harvester=ගොයම් කපන්නා
hash=අවුල | කැබලි කරනවා | පූරකය | හත්මාලුව
hasheesh=ගංජා
hashish=කංසා | ගංජා
hasidism=හැසිඩම්වාදය
hasp=පත්ත
hassle=ආරවුල | කලහය
hassock=කුලිච්චම
hastate=කුන්තාකාර
haste=ඉක්මන | ඉක්මන් කරනවා | ඉක්මන් වෙනවා | කඩිනම | කඩිනම් කරනවා | කඩිනම් වෙනවා | කඩිමුඩිය | තදියම | දඩිබිඩිය
hasten=ඉක්මන් කරනවා | ඉක්මන් වෙනවා | කඩිනම් කරනවා | කඩිනම් වෙනවා
hastily=අපරීක්ෂාකාරීව | ඉක්මනින්
hastiness=ඉක්මන්කම
hasty=ඉක්මන් | කඩිමුඩියේ කරන ලද | වහා කිපෙන
hat=තොප්පිය | ශිරස්කය | හිස්වැස්ම
hatch=කුමන්ත්‍රණය කරනවා | දෙබෑ දොරක යටි පළුව | බිජු රකිනවා | බිත්තර රකිනවා | සියුම් ඉරි යොදනවා | සොරොව්ව
hatchery=මසුන් බෝකරන තැන
hatchet=අත් පොරොව | කුඨාරය | කෙටේරිය
hatchet-shaped=කෙටේරි හැඩ
hatchetman=කුලියට මිනී මරන්නා
hatching=ඉරි දැමීම | කඩරේඛනය
hate=එදිරිය | ක්‍රෝධය | ද්වේෂ කරනවා | ද්වේෂය | පිළිකුල් කරනවා | මහත් පිළිකුල | වෛර කරනවා | වෛරය
hateful=වෛරය ඇති කරන
hatered=බද්ධ වෛරය
hather=එක්තැන් කරනවා
hatred=ආඝාත | ආඝාතය | ද්වේෂය | විප්‍රතිසාරය | වෛරය
hatter=තොප්පි සාදන්නා | විකුණන්නා
hauberk=කවචය
haudah=රනිහිලිගෙය
haughtiness=අභිමානය | උදාරම්කම
haughty=අහංකාර | උජාරු | ගර්විත
haul=ඇදුම
haulage=ඇඳුම් කුලිය | බරැදීම | බැරැදීම
haulier=බරබඩු අදින්නා | බැරැදුම්කරු
haunch=කෝලය
haunches=කටිප්‍රදේශය | තට්ටම
haunt=ඉදිරිපත් වෙනවා | තිප්පළ | තිප්පොළ | නිතර ගැවසෙන ඉඩම | නිතර ගැවසෙනවා | නිත්‍යාශ්‍රය | හොල්මන් කරනවා
haunted=අමනුෂ්‍ය පරිගෘහිත | හොල්මන් සහිත
haunting=නිතරම සිහිවන | හොල්මන් කරනවා
haustorium=ශෝෂකය
haustus=බොනුව
hauteur=උද්ධච්චභාවය | උදාරම
have=අත්කරගන්නවා | අවශ්‍යව පවතිනවා | ඇතිව තිබෙනවා | ඇතිව සිටිනවා | තියෙනවා | දක්වනවා | යමෙකුට තිබෙනවා | සිටිනවා
haven=ක්ෂේමස්ථානය | නැව්තොට | වරාය
haver=අදිමදි කරනවා | තීරණයකට නොපැමිණ සිටිනවා
haversack=ඔලගුව
haversine=අඩවිපරිසයිනය
having=ඇති
havit=පුරුද්ද
havoc=මහත් විනාශය | සංහාරය
haw=ඇණහිටවමින් කතා කරනවා
hawk=උකුස්සා | බදාම ලෑල්ල | ලිහිණියා | විකිණීමට ගෙන යනවා
hawker=කක්ෂපුට වාණිජ | කාරනවා | කුට්ලයා | චාරික වෙළෙන්දා | තොරොම්බල් කාරයා | පොට්ටනිකාරයා | සාර්ථික | සේරිවාණිජ
hawkeyed=තියුණු ඇස් ඇති | තීක්ෂණ දෘෂ්ටි ඇති
hawpinch=පක්ෂියෙක්
hawser=ගල් කඹය | නැංගුරම් කඹය
hawthorn=ගස් වර්ගයක්
haxahedron=ෂට්තලය
haxobarbitone=හෙක්සොබාබිටෝන්
hay=පිදුරු | වියලි තණ
hayfork=දැතිගොයියාව
hayloft=පිදුරු මැස්ස
haywire=නියම පාලනයක් නැති
hazard=අනුමාන කාරණය | උපද්‍රවය | උවදුර | දෛවයෝගය | සැකය
hazardous=ඉතා සැකසහිත | උපද්‍රව සහිත
hazards=උවදුරු
haze=තුනී මීදුම | නොපැහැදිලි බව | පටලය | හීන් මීදුම
hazel=කුඩා ගෙඩි සහිත පඳුර | ලා දුඹුරුපාට වූ
haziness=නොපැහැදිලිබව
hazy=නොපැහැදිලි | සියුම් මීදුම ඇති
hcmiform=අර්ධවක්‍රිකය
he=ඌ | එයා | ඒ | ඒකා | ඔහු | හෙතෙම | හේ
head=අධිපති | ආරම්භ ස්ථානය | ඉදිරි කොටස | ඉස | ඉස් | ඉහ | ඔළුගෙඩිය | ඔළුව | කුඩිම්බිය | කුඩුම්බිය | ඥානය | තැනැත්තා | ප්‍රධාන | ප්‍රධාන අංගය | ප්‍රධානයා | ප්‍රධානව කරනවා | ප්‍රධානව කරවනවා | ප්‍රධානියා | බඳ | මස්තක | මාතෘකාව | මුල | මූලික | මොලය | යොදය | වර්ගය | විතය | ශිඛා | ශිර | ශිරස් | ශිරහ් | ශිර්ෂකය | ශීර්ෂ | ශීර්ෂකය | ශීර්ෂය | ස්ථානය | සිර | සිරස | සිරස් | සිස් | හිස | හිස වැනි දේ | හිස්
head-dress=සිරස්පත
head-rest=ශිරෝ වේශය | හිස රැඳවුම
head-side=ඉහ ඉද්දර
headache=ඉරුවාරදය | ඉස කැක්කුම | ඉසරදය | හිසරදය
headband=උෂ්ණීෂය | නළල්පට | සිරස්පටිය
header=ඔළු ගල | පළමුව හිස වැදෙන සේ වතුරට පැනීම | ශීර්ෂකය | හෙඩිම
headframe=ඉස් රාමුව
headgear=ඉස්පන්න
heading=ඉස | පෙරටුව | පෙරැටිය | මාතෘකාව | ශීර්ෂනාමය | ශීර්ෂය | හෙඩිම
headland=තුඩුව | දේශ තුඩුව
headlight=ඉදිරිපස ප්‍රධාන පහන
headline=ශිරස්තලය | ශීර්ෂ පාඨය | සිරස් තලය | සිරස්තලය
headlong=මහත් වේගයෙන් | මුණින්
headman=ප්‍රධානියා | මුලාදෑනියා | මුළාදෑනියා | රාළ | රාළහාමි
headpuarters=කේන්දරය | කේන්ද්‍රය
headquarters=ප්‍රධාන කාර්යාලය | මධ්‍යස්ථානය | මූල ස්ථානය | මූලස්ථානය
headress=හිස් පලඳනාව
headsheave=ඉස් කට්ට කප්පිය
headship=අධිපතිකම | ප්‍රධානත්වය
headsman=හිස ගසා දමන්නා
headstock=ලොකු ගුලු ඇණය
headwater=උඩු ගහ | උඩු දිය
headworks=මා වැඩ
heady=ඉස වදින | මත් කරන | මුරණ්ඩු
heal=කර බඳ | ගුණවෙනවා | සුව කරනවා | සුව වෙනවා
healds=පුඩුවැල්
healer=රෝග සුව කරන්නා
healing=උපශමනය | උපශමය
health=සනීප | සනීපය | ස්වස්ථතාව | ස්වාස්ථ්‍යය | සැපය | සුඛ | සුව | සුවය | සෞඛ්‍යය | සෞම්‍ය
healthful=සනීපය ගෙන දෙන
healthiness=පහසුව
healthy=ආරෝග්‍ය | නිර්ව්‍යාධි | නිරෝගී | නීරෝගී | යහපත් | සැපදායක | සුඛිත | සුවපත් | හිතකර
heap=අට්ටිය | කන්දාව | කැටි කරනවා | කැටි වෙනවා | ගුම්බය | ගොඩ | ගොඩගසනවා | ගොනුව | පටවනවා | මැළ | රාශිය | රැස | රැස් කරනවා | රැහැ | සංචය | සඤ්චය | සමුච්චය | ස්කන්ධ | සිල්වාරම් | සුඟු
hear=අසනවා | අහනවා | ඇසෙනවා | ඇහුම්කන් දෙනවා | කනේ වැටෙනවා | දැනගන්ට තිබෙනවා
heard=ශ්‍රැත
hearing=අසා සිටිනවා | ඇසීම | නඩු විභාගය | විභාග කිරීම | ශ්‍රවණය | ශ්‍රවනය | සවන
hearken=ඕනෑකමින් අසා සිටිනවා
hearsay=අනුශ්‍රැතිය | ප්‍රවාදක | ශ්‍රැතිමාත්‍රය
hearse=අවමඟුල් රථය | මිනී ගෙනයනරිය | මිනීරථය | ශවයානය
heart=අධිෂ්ඨානය | අරටුව | ධෛර්ය්‍යය | පරමාර්ථය | ප්‍රේමය | මැද කොටස | ලය | සතන් | සන්තානය | සිත | හද | හදවත | හරය | හිද | හෘත් | හෘදය | හෘදයවස්තුව | ළ | ළපැත්ත | ළය | ළැම
hearten=ධෛර්යමත් කරනවා | ධෛර්යමත් වෙනවා
heartful=අවංක | හෘදයංගම
hearth=උදුන | ගෙදර | ලිප | ළිප
hearth-stone=ලිග්ගල
hearthrug=ලිප් දැල
hearting=මද ලෑම
heartland=හදබිම
heartless=අනුකම්පාව නැති
heartwhole=ප්‍රේම බන්ධනයට ඇතුළත් නොවූ
heartwood=අරටුව
hearty=අඩුපාඩුවක් නැති | අවංක | උනන්දු | බලවත්
heat=අවුස්සනවා | උණුසුම | උණූ කරනවා | උණූසුම | උෂ්ණය | ඌෂ්ණය | ඌෂ්ම | කකාරනවා | ග්‍රීෂ්මය | ගිනියම | ගිනියම් කරනවා | ගිම | ගිමන | ඝර්ම | ඩාහය | තරඟය | තවනවා | තව්වනවා | තා | තාපය | තෙද | නිදාඝය | පරිතාපය | රත් කරනවා | රත් වෙනවා | රස්නය | විදාහ | වේගය | සන්තාපනය
heat-regulator=තාපනියාමකය | තාපපාලකය
heated=කෝපයෙන් යුත් | රත් වූ | වේගවත්
heater=තාපකය
heath=කනත්ත | හෙදර් දෙනිය
heathemish=අශිෂ්ට
heathen=අශිෂ්ටයා | ක්‍රිස්තු ලබ්ධිය නොඅදහන්නා | ම්ලේච්ඡයා | මිථ්‍යා දෘෂ්ටිකයා | මිථ්‍යාදෘෂ්ටිකයා | මිසදිටුවා
heathendom=මිථ්‍යාදෘෂ්ටීන් වසන රටවල් | මිසදිටු දේශය
heathenism=මිථ්‍යදෘෂ්ටිය | මිථ්‍යාදෘෂ්ටිය | මිථ්‍යාදෘෂ්ටිවාදය | මිසදිටුව
heather=කුඩා ගස් වර්ගයක්
heating=තාපනය | තැපීම
heatwave=හදිසියෙන් ඇතිවන අධික ග්‍රීෂ්මය
heave=අමාරුවෙන් හුස්ම හෙළනවා | උස් පහත් වීම | ඔක්කාර කරනවා | බර ඉසිලීම | මහත් ප්‍රයත්නය | විභේද රීටුම | වීසිකරනවා | සුසුම් සෑම | හූල්ලනවා
heaven=අහස | තිදස | තුසිත | තුසී | දිව්‍යලෝකය | දෙව්ලොව | සග | ස්වර්ග | ස්වර්ග ලෝකය | ස්වර්ගය | සුගති | සුරපුර
heavenborn=දිව්‍ය
heavenly=ආකාශගත | දිව්‍ය | දිව්‍යමය | දේව
heaviness=අමාරුකම | බරකම | මුග්ධත්වය
heavy=අදක්ෂ | අධික | අමාරු | අලස | උනන්දු නැති | ගරු | ගොරොක් | දුෂ්කර | බර | බරපතළ | බහුල | බැර | බැරුම් | විශාල | සාටෝප
hebdomadal=සතිපතා සිදුවන
hebephrenia=යෞවන විමනස්‍යය
hebotic=යෞවන
hebraist=හීබ්‍රෑ භාෂාවේ අතිදක්ෂයා
hebrew=යුදෙව් | යුදෙව් භාෂාව | යුදෙව්වා
hecatomb=ශතගෝබලිය
hecistotherm=අවමෝෂ්ණකය
heck=නූල් බෙත්ම
heckly=ප්‍රශ්න ඇසීමෙන් වෙහෙසනවා
hectare=හක්ටාර | හෙක්ටයාරය | හෙක්ටාරය
hectic=උණ සහිත | කලබල සහිත
hectogram=හෙක්ටොග්‍රෑම
hectogramme=හෙක්ටොග්‍රෑම
hectograph=පිටපත් ගුණක යන්ත්‍රය
hectolitre=හෙක්ටොලීටරය
hectometer=හෙක්ටොමීටරය
hectometre=හෙක්ටොමීටරය
hector=තර්ජනයෙන් බය ගන්වනවා
hedge=කොටු කරනවා | බඩ වැටිය | බඩවැටිය | වැට | වැට බඳිනවා
hedgehog=ඉත්තෑවා
hedgerow=පැළඉණි වැට | බඩවැටිය
hedging=ඉදිරි රැකුම | ප්‍රාවීරණය
hedonic=සුඛ පරම | සුඛ විෂයක | සුඛපරම
hedonics=ස්වාදනික විද්‍යාව
hedonism=ආස්වාද වාදය | ස්වාද වාදය | සුඛ පරමවාදය | සුඛපරම වාදය | සුඛපරමවාදය
hedonist=සුඛ පරමවාදියා
heebie-jeebies=ච්ත්තාපර
heed=අවධානය | ඇහුම්කන් දෙනවා | කල්පනාවට ගන්නවා | තකනවා | පරෙස්සම | සලකනවා | සැලකිල්ල
heedful=අප්‍රමාද | සාවධාන
heedless=අනවධාන | අපරීක්ෂාකාරී
heedlessness=අප්‍රවේසම
heel=අඩිය | අඩියක් යොදනවා | ඇලය | පස්ස | විලුම | විලුඹ | විළුඹ | විළුඹෙන් ගසනවා
heft=බර
hefty=තඩි | ප්‍රබල | විශාල | ශක්තිමත්
hegalian=හෙගලියානු
hegalianism=හෙගලියානුවාදය
hegemony=ආධිපත්‍යය | රාජ්‍යන්තරනායකයා
hegher=උත්තර
hegira=මුස්ලිම් වර්ෂයේ මුල
heifer=නෑම්බි | වැස්සී
heigh=ආ
height=අග්‍රස්ථානය | ආරෝහය | ඉහළ | උස | උස් බව | උස් ස්ථානය | කෙළවර | මුදුන
heighten=අධිකත්වයට පමුණුවනවා | උච්චනය | වැඩි කරනවා | වැඩිකොට දක්වනවා
heighting=උස ගැනීම
heinous=අතිදුෂ්ට | ඉතා දරුණු | සාහසික
heir=උරුමක්කාරයා | හිමිකාරයා
heiress=උරුමක්කාරිය | උරුමක්කාරී
heirloom=දයස්වය දා | පාරම්පරික වස්තුව
heirship=උරුමක්කාරභාවය | උරුමත්වය
hejira=මුස්ලිම් වර්ෂයේ මුල
hekistotherm=අවමෝෂ්ණ | අවමෝෂ්ණකය
hekistothermic=අවමෝෂ්ණක
helianthine=හෙලියැන්තයින්
helical=සර්පිලාන | හෙලික්සීය
helichrysin=හෙලික්‍රයිසින්
heliciform=සර්පිලාභ
helicity=හෙලික්සතාව
helicoid=සර්පිලාභ | හෙලික්සාභය
helicopter=හෙලිකොප්ටර යානාව
helio-zincography=සූර්ය සින්ක් මුද්‍රණය
heliocentre=සූර්ය කේන්ද්‍රය
heliograph=ඡායාවත්‍රය | සූර්යතාප දර්ශකය | හේලි රේඛය | හේලියෝග්‍රාපය
heliolatry=ඉරු දෙවියන් ඇඳහීම | සූර්ය වන්දනය
heliometer=සුර්යතාපමානය | හේලියෝමීටරය
helionasty=සෞර සන්නමනය
heliophilous=සෞරකාමී
heliophobic=සෞරාපග
heliophyte=සෞරශාකය
helioscope=සූර්ය දර්ශකය | හේලියෝස්කෝප්
heliostat=හෙලිස්ථාපය | හේලිස්ථාපය
heliotrope=ආලෝක කදාව | සූර්යකමල
heliotroper=හේලියෝට්‍රෝපය
heliotropism=සෞරාවර්තනය
helium=හිලියම් | හීලියම්
helix=කුණ්ඩලය | කොම්බුව | සර්පිල | සර්පිලය | හෙලික්සය | හෙලික්සිය
hell=අපාය | අවා | දුගතිය | නරකය | නරකාදිය | නරකාවාටය | නිරය
helladic=නිරය | හැලඩික
hellenic=ග්‍රීක | ග්‍රීසියට අයත් | හෙලනික
hellenism=හෙලනික වාදය | හෙලනිකවාදය
hellenistic=හෙලනිස්තික
hellish=අතිඝෝර | අපා | ඉතා නපුරු
helm=ආරක්ෂක තොප්පිය | පාලකස්ථානය | පාලනය | ශිරස්කය | සුක්කානම
helmet=ආරක්ෂක තොප්පිය | ශිරෂ්කය | ශිරස්කය | ශීර්ෂකය | සිරස්කය
helminthes=හෙල්මින්ත්ස්
helminthoid=පණු වැනි
helmsman=පාලකයා | සුක්කානම ක්‍රියාවෙහි යොදවන්නා
helophyte=වගුරුශාකය
helot=දාසයා | වාලා
helotism=අන්‍යෙන්‍යතාව
helotry=දාසගණයා | දාසභාවය
help=අනුග්‍රහය | ඇප උපකාර | උදව් කරනවා | උදව්ව | උදවු කරනවා | උපකාරය | උපස්තමභක වෙනවා | නොකර සිටිනවා | ප්‍රතිකාරය | පිළිසරණ | මෙහෙකරුවා | යමකින් වැළකී සිටීම | වළක්වනවා | සහාය | සහාය වෙනවා | සහායකයා | හොඳ කරනවා
helpful=ඉවහල් | උපකාරී | උපස්තම්භක | ප්‍රයෝජනවත්
helpfulness=අර්ථචරියාව
helping=උපකාරක | පංගුව | සහකාර
helpless=අනාථ | අපිළිසරණ | අසරණ | බලයක් නැති
helplessness=අසරණ බව
helpmeet=සහායකයා
helve=ආයුධයක මිට | කෙටි මිට
helvite=හෙල්වයිට්
hem=කංසා | නාරටිය | වාටි මහනවා | වාටිය | හූමිටි තියනවා | හූමිටි ශබ්දය
hematachometer=රක්තවේගමානය
hematin=හෙමටින්
hematite=හීමටයිට් | හෙමටයිට්
hematology=රුධිර විද්‍යාව
hematophobia=රක්ත භීතිකාව
hemeralopia=දිවා අන්ධතාව | වාසර තිමිරය | වාසරතිමිරය
hemi=අඩ | අර්ධ
hemicellulose=හෙමිසෙලියුලෝස්
hemicolloid=අර්ධ කලිලය
hemicryptophyte=භුතලශාකය
hemicyclic=අර්ධචක්‍රිය
hemicylindrical=අඩසිලින්ඩරාකාර
hemihedral=අර්ධතල
hemiopia=අර්ධාන්ධතාව | පක්ෂාන්ධතාව
hemiparesis=පක්ෂාඝාතය
hemiplegia=අර්ධ ඝාතය | අර්ධඝාතය | පක්ෂාඝාතය
hemipterous=එක්තරා කෘමි කොට්ඨාසයකට අයත්
hemipuccinia=හෙමිපුක්සිනියා
hemisection=අර්ධ ඛණ්ඩනය
hemisotonic=රුධිර සමාභිසාරක
hemisphere=අර්ධගෝලය | භූගෝලාර්ධ සිතියම | භූගෝලාර්ධය
hemispherical=අර්ධගෝලාකාර | අර්ධගෝලීය
hemistich=ශ්ලෝකාර්ධය
hemitone=අර්ධතානය
hemlock=විෂ ගස් වර්ගයක්
hemolysis=රුධිරජාරණය
hemomallous=සංවක්‍ර
hemorrhage=කිලිමාලය | රක්තපාතය | ලේ යාම
hemorrhoids=අර්ශස්
hemostatic=රක්තස්ථීතික
hemp=කංසා | කංසා පැලය | කන්සා | කිත්තන් | ගන්ජා | නියඳ | නියඳ හණ | සණ | සාණ | සෙල්ගාර | හණ | හන
hempen=කංසා වලින් සාදන ලද
hen=කිකිළී | කිරිල්ලී
hen-bird=කිරිල්ලී
henbane=පැළෑටි විශේෂයක් | හෙන්බේන්
hence=එනිසා | පිටව යනු | මෙතැන් සිට | මෙයින් | මෙහි සිට | මේ නිසා
henceforth=මින් ඉදිරියට | මින් මතු
henchman=අනුවරයා | ගෝලයා | හෙන්චා
henge=ප්‍රාග් හෛතිහාසික ස්මාරකය
henna=නියපොතු රතු කිරීමට යොදන ද්‍රව්‍යයක්
henotheism=සමේශ්වරවාදය
henry=හෙන්‍රිය
heortology=සමනවේදය
hepatic=අක්මාව පිළිබඳ | යකෘත් | යාකෘතික
hepatics=අක්මාශාක
hepatitis=අක්මාවේ සෑදෙන රෝගයක් | යකෘත්දාහය | යකෘත්ප්‍රදාහය | සෙංගමාලය
hepatization=යකෘත්භවනය
hepatoscopy=අක්මාපේනය
heperin=හෙපරින්
heptad=සප්තකය
heptagon=සප්තභුජය | සප්ත්‍රාස්‍රය | සප්තාස්‍රය | හත් පට්ටම
heptahedron=සප්තාංශඝනය
heptamerous=සප්තාංක
heptameter=සත්මත් විරිත
heptarch=සත් කොන්
heptavalent=සත්සංයුජ
heptode=සප්තෝඩය
heptoxide=හෙප්ටොක්සයිඩ්
her=ඇගේ | ඈ | හර් ක්‍රීඩාව
herald=අග්‍රෙසරයා | කලින් දැනුම් දෙන්නා | කැඳවාගෙන එනවා | ප්‍රකාශකයා | පෙරටුව යන්නා | රජඅණ පතුරුවන්නා | සිදුවන දේ දැනුම් දෙනවා
heraldic=වංශාවලිය පිළිබඳ වූ
heraldry=වංශාවලිය පිළිබඳ ශාස්ත්‍රය
herb=අරටුවක් නැති පැළය | ඖෂධය | ඖෂධී | පැලෑටිය | පැළෑටිය | ශාක | ශාකය
herbage=තණ බිම පිළිබඳ අයිතිය
herbalist=ඖෂධ ශාක වවන්නා | ශාක නිඝන්ඩුකාරයා
herbals=සෂධි නිඝණ්ඩුව
herbarium=ශාක උද්‍යුනය | ශාක සංග්‍රහය | ශාකාගාරය
herbarlum=වියලි පලා වර්ග රැස්කොට ඇති ස්ථානය | වියලි පලා වර්ග රැස්කොට ඇති ස්ථානය පිළිබඳ ග්‍රන්ථය
herbartianism=හංබාටියානුවාදය
herbivorous=ශාක භක්ෂක | ශාකභක්ෂක
hercogamic=යෝගබාධක
hercogamous=යෝගබාධක
hercogamy=යෝගබාධය
herculean=අතිදුෂ්කර | අතිප්‍රබල | යෝධයන්ට පමණක් සුදුසු
herd=එක් රැස්ව ඉන්ට සලසනවා | ගාල් කරනවා | පට්ටිය | රංචුව | රඤ්චුව | රැළ | රැළ ගැසී සිටිනවා | රිළු | සතුන් බලාගන්නා | සමූහය
herdsman=එඩේරා | එඬේරා | ගොපල්ලා
here=ඉංජ | ඒ‍යි | ඔන්න | මුබ | මෙතැන | මෙන්න | මෙහි | මෙහිදී | මෙහේ | මේ ස්ථානය | මොබට
hereafter=මින්මතු | මෙතැන් පටන් | මෙවක් පටන්
hereditament=උරුමප්‍රාප්‍යය | උරුමවිය හැකි දේ
hereditaments=උරුම
hereditary=ආවේණික | උරුමගත | පරම්පරාගත | පරම්පරාවෙන් උරුම වූ | ප්‍රවේණි | පාරම්පර්ය | පාරම්පරික | සහජ
hereditory=සහජ
heredity=ආරය | ආවේණිය | ප්‍රවේණිය | පිතෘගුණානුවෘත්තිය
hereinafter=මෙහි මින් මතු
heres=උරුමක්කාරයා
heresy=අධර්මය | කුදිටු | දුර්ලබ්ධිය | පැවැදිසි වරද | මිථ්‍යාග්‍රාහය | මිථ්‍යාදෘෂ්ටිය | මිථ්‍යාවාදය | මිසදිටු
heretic=අන්‍යදෘෂ්ටිකයා | තීර්ථකයා | පාෂණ්ඩයා | පාෂාණ්ඩයා | මිථ්‍යාලබ්ධිකයා
heretical=කුදිටු | ධර්මවිරෝධි | මිථ්‍යාග්‍රාහී | මිථ්‍යාමතික
heretics=විපරීත දෘෂ්ටිය
heretofore=පෙරාතුව
heritable=උරුම කළ හැකි | උරුමකාරී | උරුමලභ්‍ය | උරුමවිය හැකි | උරුමවියහැකි
heritage=උරුමය | දායාදය | ප්‍රවේණිය | පෙවෙණිය | සහජ ගුණය
herkogamic=යෝගබාධක
hermaphrodite=උභයලිංගික සතා | ද්විලිංගික | ද්විලිංගිකය
hermaphroditism=ද්විලිංගිකතාව
hermeneutics=අර්ථ විවරණ | අර්ථ විවරණ ශාස්ත්‍රය | අර්ථ විවරණය | අරුත් විවරණ සතර
hermetic=වායුරෝධි
hermetically=හුළං පවා නොවදින සේ සම්පූර්ණයෙන්
hermeticism=ආදිරසායනවිද්‍යාවාදය
hermit=තවසර | තවුසා | තාපසයා | මුනි | වානප්‍රස්ථ | හුදකලාව වසන තැනැත්තා
hermitage=අසපුව | ආරණ්‍ය සේනාසනය | ආවාසය | ආශ්‍රමය | කුටිය | තපෝවනය | තාපසාරාමය | වානප්‍රස්ථ | සේනාසනය
hermophrodite=ද්විලිංගිකයා ද්විලිංගික
hern=කොකා
hernia=අණ්ඩවාතය | අන්තර්වෘය | වර්ධ්මය | වර්ධිමය | හර්නියා
hero=කතානායක | කථා නායකයා | කථානායක | විරු | වීර | වීරයා | ශූර
herodotage=හෙරොඩොටායනය
heroic=උච්චකාය | වික්‍රමාන්විත | වීර
heroics=ආඩම්බරයෙන් කරන ප්‍රකාශය
heroin=ගංජා වැනි ද්‍රව්‍යයක්
heroine=නායිකාව | වීර ස්ත්‍රී | වීරාව | හෙරොයින්
heroism=පරාක්‍රමය | ශෞර්ය්‍යය
heron=කොකා | කොස් ලිහිණියා
herpes=චර්ම රෝගයක් | පාමන් රෝගය | විසප්පුව | විසර්පය | හර්පිසය
herpolhode=ආධ්‍රැවපථය
herr=මහතා යන්නට යොදන ජර්මන් පදය
herring=හුරුල්ලා
hers=ඇගේ දේ
hesitant=ඇනහිටීම | දෙගිඩියාව | පසුබට | සැක සහිත | සැකය
hesitate=අනුමාන කරනවා | අවිනිශ්වතව සිටිනවා | දෙපැත්තට ඇදෙනවා | නොකැමැත්ත දක්වනවා | පස්ස ගහනවා | පසුබට වෙනවා | පැකිළෙනවා | වික්කල් ගහනවා
hesitating=ආලිස්සම් | ආලෙස්සම් | පසුබට
hesitation=ඇනහිටීම | දෙගිඩියාව | සැකය
hesperidin=හෙස්පෙරිඩින්
hesperidium=ජම්බීරකය
hessian=ගෝනිරෙදි | හෙසියානුව
hetaera=පුරාණ ග්‍රීසියේ අභිසාරිකාව
hetaerio=සමුච්චය
heterdoox=වෛතුල්‍ය
hetero=අසම
hetero-kinesis=විෂමහේදනය
hetero-sexual=ඉතරලිංගික
hetero-suggestion=ඉතර ව්‍යංජනාව
heteroblastic=විෂම කලලජනනය | විෂමවිකාසක
heteroblasty=විෂමවිකසනය
heterocarpous=විෂමඵලීන
heterochlamydeous=විෂමපරිපුෂ්පී
heterochromosome=විෂමවර්ණදේහය
heterochtie=අසමකුටික | අසමකුටිකය
heteroclinous=අපරමංච
heteroclisy=විෂමප්‍රවිකලය
heteroclitic=අසමකුටික | අසමකුටිකය
heterocycle=විෂමචක්‍රය
heterocyclic=විෂමචක්‍රීය
heterocyst=විෂම සෛලය | හෙටෙරොසිස්ටය
heterodox=අශාසනික | විපරීත දෘෂ්ටි | වෛතුල්‍ය | වෛධර්මික | වෛධාර්මික | ශාස්ත්‍රයුක්තියට නොගැළපෙන
heterodoxy=අපථය | විපරීත දෘෂ්ටි මනස
heterodromous=විෂමස්‍රෝත
heterodromy=විෂමස්‍රෝතභාවය
heterodyne=විසංඛ්‍යාත
heteroecicus=විෂමගෘහී
heteroecious=විෂමගෘහී
heteroecism=විෂමගෘහීකතාව
heterogamous=විෂමජන්මාණුක
heterogamy=විෂම යෝගය | විෂමජන්මාණුකතාව
heterogeneity=නා නා ජාතිත්වය | විෂමජාතිතාව | විෂමජාතීත්‍ය | විෂමජාතීයතාව
heterogeneous=නොයෙක් වර්ගවලට අයත් | භින්නජාතීය | විවිධාකාර | විෂමජාතිය | විෂමජාතීය | විසමජාතීය
heterogenity=විෂමජාතීත්වය | විෂමජාතීතාව | විෂමජාතීයතාව
heterogenous=විෂමජාතීය
heterograde=මේය | මේයය
heteroicous=විෂමගෘහී
heterokaryosis=විෂමන්‍යෂ්ටිකතාව
heterokaryotic=විෂමන්‍යෂ්ටික
heterokontac=විෂමකශික | හෙටෙරොකොන්ටේ
heterokurtic=අසමවක්‍රිම
heterological=ඉතරවේදීය
heteromerous=විෂමාංක
heteromorphic=අපර රූපී | එකිනෙකට වෙනස් වූ ව්‍යහයන් ඇති | විෂමරූපී
heteromorphism=විෂමරූපතාව
heteromorphous=විෂමරූපී
heteronomy=ඉතරනියමය | පරතන්ත්‍රතාව
heterophoria=ඉතර චලනය
heterophyllous=විෂමපත්‍රී
heterophylly=විෂමපත්‍රතාව
heteropic=විෂමපෝෂී
heteropolar=විෂමධ්‍රැව | විෂමධ්‍රැවය
heteroscedastic=විෂම ප්‍රවිචල
heteroscedasticity=විෂම ප්‍රවිචලතාව | විෂමප්‍රවිචලතාව
heterosexual=සමලිංගික නොවන
heterosexuality=ඉතර ලිංගිකතාව
heterospermy=විෂමබීජතාව
heterosporangiate=විෂමබීජාණුධානික
heterosporangic=විෂමබීජාණුධානික
heterosporic=විෂමබීජාණුක
heterosporous=විෂමබීජාණුක
heterospory=විෂමබීජාණුකතාව
heterostatic=විෂමස්ථීතික
heterostyled=විෂමබීජාණුකතාව
heterostylous=විෂමකීල
heterostyly=අසමකීලතාව | විෂමකීලතාව
heterosuggestion=ඉතර ව්‍යංජනාව
heterotelic=ඉතරනිෂ්ඨාත්මක
heterothallic=විෂමතලස්
heterothallism=විෂමතලසතාව
heterotopes=විෂමස්ථානික
heterotrophic=විෂමපෝෂී
heterotropia=විෂමාවර්තනය
heterotypic=විෂම දර්ශීය | විෂමදර්ශීය
heterotypical=විෂමදර්ශීය
heteroxenous=විෂමගෘහී
heterozetesis=ඉතරාර්ථ ආභාසය
heterozygosity=විෂමයෝගතාව
heterozygote=විෂමයුග්මකය | විෂ්මයුක්තාණුව
heterozygous=විෂමයෝගී
hetetobaric=විෂමභාර
heuristic=අත්දැකීමෙන් විනිශ්චය කරන | විවරණෝපයෝගී
hew=කොටනවා | පළනවා | හෙළනවා
hewn=කපන ලද | හෙළන ලද
hexa=ෂඩ්
hexacotylous=ෂඩ්බීජපත්‍රී
hexacyclic=ෂඩ්චක්‍රිය | ෂඩ්චක්‍රීය
hexad=ෂෂ්ඨකය
hexafoil=සපෙතිය
hexagon=ෂට්කෝණ | ෂඩස්‍රය | ෂඩ්භුජය | හය පට්ටම
hexagonal=සයකොන් ඇති
hexagram=සයකොන් තාරකාව
hexahydrate=හෙක්සහයිඩ්‍රේටය
hexahydric=හෙක්සහයිඩ්‍රික
hexamerous=ෂඩංක
hexameter=දිග කවිය | සමත් විරිත
hexamethonium=හෙක්සිමෙතෝනියම්
hexamine=හෙක්සමින්
hexangular=ෂඩ්කෝණ
hexaploid=ෂඩ්ගුණ | ෂඩ්ගුණකය
hexarch=සකොන්
hexasilane=හෙක්සසිලේන්
hexavalent=ෂඩ්සංයුජ
hexis=ගතිස්වභාව
hexode=ෂටෝඩය
hexokinase=හෙක්සොකයිනේස්
hexosan=හෙක්සොසාන්
hexose=හෙක්සෝස්
hexoxide=හෙක්සොක්සයිඩ්
hey=එම්බල | එම්බා | ඔය
hi-fi=අත්‍යනුකූලතාව | අතිඅනු
hiatus=අන්තරය | භංගය | හිස්තැන
hibernal=ශිශිර
hibernate=ශිශිරතරණය කරනවා
hibernation=ශිශිර තරණය | ශිශිර නිද්‍රාව | ශිශිරතරණය | හේමන්ත නිද්‍රාව
hibiscus=බන්දුවක | වද මල | සපත්තු මල
hiccough=ඉක්කා ගහනවා | ඉක්කා වැටෙනවා | ඉක්කාව | හික්කාව
hiccup=ඉක්කා ගහනවා | ඉක්කා වැටෙනවා | ඉක්කාව | හික්කාව
hickory=හොඳ ලී ලබාගත හැකි ගසක්
hidalgo=ස්පාඤ්ඤයේ වංශවතා
hidden=ගුප්ත | ගුළු | ගූඩ | නිලීන | ලීන | ශුභ්‍ය | සැඟවුණු
hide=ආවරණය කරනවා | කසෙන් තළනවා | මුලුගන්වනවා | මුලුගැන්නෙනවා | වළහනවා | සඟවනවා | සැංගෙනවා | සැඟවෙනවා | හංගනවා | හඟවනවා | හම | හම් | හැංගෙනවා
hidebound=ආදානග්‍රාහී | පැරණි මතයෙහිම එල්බගත්
hideous=ඉතා අප්‍රසන්න | භයානක
hideout=තිප්පොල
hidesness=භයානකකම
hiding=සැඟවීම | සැඟවුණු තැන
hidration=සජලනය
hie=ඉක්මන් කරනවා | හනික යනවා
hiemal=ශිශිර
hierachical=ධූරාන්වයික
hierachy=දේවසභා නායකයන්ගේ සංස්ථාව | ධුරාවලිය | ධූරාන්වය | ධූරාවලිය
hierarch=දේවසභාවේ ප්‍රධානයා | ප්‍රධාන පූජකයා
hierarchy=ථෙරාවලිය | ධූරානුක්‍රමය | ධූරාවලිය
hieratic=පූජකයන් පිළිබඳ වූ
hieratical=පූජකයන් පිළිබඳ වූ
hierocracy=පූජකතන්ත්‍රය
hieroglyph=පුරාණ මිසරයේ අකුරු | රූපාක්ෂර | වත්‍ර ලිපි | හයිරෝරේඛනය
hieroglyphic=වත්‍ර ලිපියෙන් සමන්විත
hieroglyphics=රූපාක්ෂර
hieroglyphs=හයිරෝරේඛණය
hierography=වත්‍රලිපි | වත්‍රාක්ෂර
higgle=කේවල් කරනවා
higgledy=අන්තෝජටා බහිජටා
higgling=කේවල් කරනවා
high=ඉහළ | උච්ච | උත්කෘෂ්ට | උත්තම | උත්තුංග | උතුම් | උදාර | උස | උසස් | උස් | කඳුකර | තුංග | තුඟු | ප්‍රධාන | ශ්‍රෙෂ්ඨ | සම්පූර්ණ | සම්භාව්‍ය | සැර | හිවි
high-handedness=පුළුවන්කාරකම
high-hat=කෙරුම්කාරයා
high-order=උසස් ගණය
high-speed=අධිවේග
high-tension=අතිශක්මතාව
highaland=කඳුරට
highest=අග්‍රගණ්‍ය | අනුත්තර | උච්චතම | උතුම් | මුදුන් | ශ්‍රී
highhandedness=බලපුළුවන්කාරකම
highland=උස් බිම | කඳුකරය | ගොඩ | ගොඩ ඉඩම | ගොඩබිම | ගොඩැල්ල | තලාවිය | ථල
highlander=කඳුකර වැසියා
highlands=ස්කොට්ලන්තයේ කඳුකර ප්‍රදේශය
highlife=ධනවතුන්ගේ විතය
highlight=ඉස්මතු කිරීම | උසස්ම දෙය | තීව්‍රාලෝකය
highly=ඉහළින්
highness=උච්චත්වය | උසස් බව | මහෝත්තමයන් වහන්සේ
highstrung=ඉක්මනින් කලබල වන
hight=නම්කරනලද
highway=මහ මඟ | මහපාර | මහමඟ | මහවෙය | මහාමාර්ගය
highwayman=මංපහරන හොරා
hijack=ගුවන් කොල්ලකනවා
hike=පයින් ගමන
hiker=පයින් යන්නා
hilarious=අතිහාස | මහත් සන්තෝෂයෙන් යුත්
hilarity=ප්‍රහර්ෂය
hill=කන්ද | කඳ | කිඳ | මිටි කන්ද | හෙල
hillock=කඳුගැටය | ගොඩැල්ල | මිටිකන්ද
hilly=කඳු සහිත | කඳුකර
hilly-billy=ඇමරිකාවේ දකුණු දිශාවේ ජන ගී | පිටිසරයා
hilum=කණිකාලපය | බීජලපය
him=ඔහු | ඔහුට
himalaya=හිමාලය
himalayan=අති විශාල | ඉතා දුෂ්කර | යෝධ
himself=ඔහුම | තමාම
hind=පසු පස | පිටිසරයා | මුවදෙන
hind-brain=අපර මස්තිෂ්කය | පසු මොළය
hinder=අවකපනවා | බාධා කරනවා | වළකනවා
hindering=සම්බාධ
hindi=ඉන්දියාවේ රාජ්‍ය භාෂාවක් | හින්දි
hindrance=අවහිරය | නීවරණ | ප්‍රපඤ්චය | බාධකය | බාධාව | සම්බාධකය
hindu=හින්දු | හින්දු ජනතාව | හින්දු භක්තිකයා
hinduism=හින්දු ආගම | හින්දු දර්ශනය | හින්දු ධර්මය
hindustani=ඉන්දීය භාෂාව | හින්දුස්තානි
hinge=අසව් | අසව්ව | අසවු කරනවා | ප්‍රධාන කාරණය | ප්‍රධාන ප්‍රවෘත්තිය | සරණේරුව | සරණේරුවක් යොදනවා | සරනේරුව | සව්ව
hinges=සරනේරු
hinny=අශ්වයාට දාව කොටළුදෙනගෙන් උපන් පැටියා
hint=අඟවනවා | ඉඟි අරුත | ඉඟිය | යන්තමින් ඇඟවීම | සංඥාව | සිහිකරවනවා
hinterland=පසු බිම | ප්‍රත්‍යන්තය | පොහොන් බිම
hip=ඇකය | ඉණ | උකුල | උකුළ | උකුළු | කටිය | ජඝනය | තුනටිය | රෝස ඵලය
hip-joint=උකුල් සන්ධිය
hip-rafter=මූලප්පරාලය
hippie=තුප්පහියා
hippo=දිය ඇතා
hippodrom=අශ්වක්‍රීඩාංගනය | සර්කස් මඩුව
hippopotamus=දිය ඇතා
hipster=ඉඟටියෙන් පහළට එල්ලා වැටෙන ඇඳුම
hire=කුලිකිරීම | කුලිය | කුලියට ගන්නවා | කුලියට දෙනවා | බද්ද
hireling=කුලීකාරයා | බැලමෙහෙ කරන්නා
hirer=කුලියට දෙන්නා
hiring=කුලිය ගැනීම | කුලියට දීම
hirsuit=කෙස් ඇති | මවිල් ඇති | ලෝමශ
hirsute=දෘඩරෝමී
hirtellous=රෝමී
hirtus=දෘඩරෝමී
hirudin=හිරුඩින්
his=ඔහුගේ
hispanic=කථාකරන රටවලට අයත්
hispid=දෘඩරෝමී
hiss=පිඹීම | සර සර ගානවා | සරබර ගානවා | සිලිබිලි ගානවා | සීත්කාරය | සූ ගානවා
hissing=සිසීම
histamine=සිරුරේ පටකවල තිබෙන රසායනයක් | හිස්ටමින්
histiology=පටක විද්‍යාව
histochemistry=පටක රසායන විද්‍යාව
histogen=පටක ජනකය
histogenesis=පටක ජනනය
histogenetic=පටක ජනක
histogenic=පටක ජනක
histogeny=පටක ජනනය
histogram=ජාල රේඛය | ජාලරේඛය | ජාලලේඛනය | සංඛ්‍යාත ප්‍රස්තාරය
histological=ඖතික වේදීය | පටක විද්‍යාත්මක | පටකීය
histology=ඖතික වේදය | පටක විද්‍යාව | පටකවේදය
histolysis=පටක විච්ඡේදනය
historian=ඉතිහාස කාරයා | ඉතිහාසඥයා | ඓතිහාසිකයා
historic=ඉතිහාස ගත වන | ඓතිහාසික
historical=ඉතිහාසය පිළිබඳ වූ | ඉතිහාසවිෂයක | ඓතිහාසික | පෞරාණික
historicalism=ඉතිහාසක්‍රම වාදය | ඉතිහාසක්‍රමවාදය
historicism=ඓතිහාසිකත්වය | ඓතිහාසිකතාවාදය | ඓතිහාසිකවාදය
historicity=ඓතිහාසිකත්වය | පෞරාණිකත්වය
historigram=නේමරේඛය
historiography=ඉතිහාසය ලිවීම | කථාලේඛනය
history=ඉතිහාසය | පුරාවෘත්තය | යටගියාව | විත්ති | වෘත්තාන්තය
histrionic=නළුවා | නාටකීය | නාට්‍ය සම්බන්ධී | රංගීය
histrionics=අභිනය | නාට්‍යය | රංග ශාස්ත්‍රය | රංගීය කලා | රැඟුම් දැක්වීම
hit=ගහනවා | ගැටෙනවා | ගුටි බානවා | ගුටිදෙනවා | ජනමෝදකය | තට්ටු කරනවා | නර්මාලාපය | පහර | පාඩු කරනවා | යෝග්‍ය වෙනවා | වදිනවා | වැදුම | හරියනවා | හැපෙනවා
hitch=අමුණනවා | ඇමිණීම | ඇවිණෙනවා | කොක්ක | ගැස්සීම | පුඩුව | බඳිනවා | සම්බන්ධ කරනවා | සම්බන්ධ වෙනවා | හදිසි නැවැතීම | හදිසි බාධාව | හුරහ
hither=මෙතැනට | මොබ | මොබට
hittites=හිටයිටයෝ
hive=එකතුව වාසය කරනවා | මීය | මීවදය | රැස් කොට තබනවා | රොත්ත
hives=කුෂ්ට රෝගයක්
hlydraulicising=ද්‍රාවක්ෂේපණය
hlyperpnoea=ආත්‍යානය
hm=හෙක්ටොමීටරය
hoar=අළුපාට
hoard=අසංවය | තොග මුළු කරනවා | තොග මුළු කරනවා | නිදන්ගත කරනවා | නිධානය | රාශිය | රැස | රැස් කොට තබනවා | සඟවා තබනවා | හොර රහසේ රැස් කර තබනවා
hoarding=දැකුම් පැළැල්ල | දැන්වීම් ලෑල්ල | පුවරු වැට | භාණ්ඩ සඟවා තැබීම | රාශිකරණය | රැස් කිරීම
hoarse=ගොරෝසු | බැ
hoarseness=ස්වරහංගය
hoary=අතිපුරාණ | පලිත | පූජ්‍ය | සුදු
hoax=දඟය | වංචා කරනවා | වංචාව
hob=කුඩා රාක්කය | ගුරු කටුව
hobbing=ගුරු කටුවෙන් කැපීම
hobble=අමාරුවෙන් ඇවිදිනවා | අමාරුවෙන් ඇවිදීම | කුරගානවා | නොණ්ඩි ගසමින් ඇවිදිනවා | නොණ්ඩි ගසමින් ඇවිදීම | බකල ගහනවා
hobbler=කොරා
hobby=විනෝද ව්‍යාපාරය | විනෝදාංශය
hobgoblin=පිශාචයා
hobgobling=පිශාචයා
hobnob=බජනෙ දානවා | මිතුරන් භජනය කරනවා
hock=වයින් වර්ගයක්
hockey=හොකී ක්‍රීඩාව
hocus-pocus=ඇස්බැන්දුම | විජ්ජාව
hod=කූඩය | බදාම ලෑල්ල
hodgraph=ත්වරණප්‍රස්තාරය
hodograph=ත්වරණ ප්‍රස්තාරය
hodometer=ඔඩෝමීටරය
hoe=උදැල්ල | නගුල් පෝරුව | පස් බුරුල් කරනවා | හුදලු | හුදැල්ල
hog=අපිරිසිදු තැනැත්තා | කෑදරකමට කනවා | කෑදරයා | හැඩය
hogarthian=හොගාතියානු
hogback=හුරු පිට
hogging=වක ගැහීම
hoggish=ඌරකු වැනි | කැත
hogmanay=අවුරුද්දේ අවසාන දිනය
hoise=කොලහල
hoist=උත්කර්ෂණ යන්ත්‍රය | ඔසවනවා | ඔසොවනුව | ඔසොව්ව
hoister=ඔසොවනුව
hokum=බහුබූතය
holard=මුළු භූ ජලය
hold=අත්වැල | අයිතිව සිටිනවා | අල්ලනවා | අල්ලා සිටීම | අල්ලාගන්නවා | අල්ලාගෙන සිටිනවා | ආකර්ෂණය | ඇල්ලීම | එල්බ ගන්නවා | ග්‍රහණය | දරනවා | ධාරණය | නවත්වනවා | නවතිනු | නිලයක් දරනවා | පිළිගන්නවා | බලකොටුව | බලපැවැත්වීම | රඳනවා | රඳවනවා | වැළඳගන්නවා | විසිරී යාම වළක්වනවා | සලකනවා
hold-fast=අවුල්පාසුව
holder=අයිතිකාරයා | අල්ලුව | දරන්නා | ධර | ධරයා | ධාරක | ධාරකය | බදු කාරයා | භාජනය | මිට
holdfast=අවුල් පාසුව
holding=අයිතිය | ඉඩම | ග්‍රහණය | ග්‍රාහක | දේපල | බද්ද | බිම් කැබැල්ල | භුක්ති විඳින ඉඩම | භූමිය | සණ්ඨාපනය | සන්ධාරක
holdings=ඉඩම් | විධාරක සමාගම් | සතු දේ | සම්භාර
hole=අපිරිසිදු ගේ පැල | අස්ස | ආවාටය | කුඩා | කුහරය | කූපය | ගුල | ඡිද්‍ර | ඡිද්‍රය | තව් | තව්ව | දැදුර | පුටය | පුළ | බිල | බිළය | බුහුර | බුහුරු | බෙනය | මල | වළ | වළේ දමනවා | විදුම | විසීමට අමනෝඥ ස්ථානය | ශුෂීර | සිද | සිදුර | සිදුරු | සිල | සුෂිර | සුසිර | හිල | හිල් | හිල් කරනවා
holey=සිදුර සහිත
holiday=උත්සව දිනය | නිවාඩු දිනය | විශ්‍රාමය
holiness=පවිත්‍රභාවය | පුණ්‍යත්වය | පූර්ණත්වය | භක්තිය | ශුද්ධත්වය | සාකල්‍ය
holism=සාකල්‍යවාදය
holla=ඕයි කියා අඬගසනවා | හඬනගා කැඳවනවා
holland=ඝන ලිනන් රෙදි | සලන්ද
holliper=හොලිපරය
hollo=ඕයි කියා අඬගසනවා | හඬනගා කැඳවනවා
holloa=ඕයි කියා අඬගසනවා | හඬනගා කැඳවනවා
hollow=උදරය | කුහර | කුහර සහිත | කුහරය | කුහරයක් සාදනවා | ගිලුණු | දෝංකාරය | නික්මෙන | නිම්නභූමිය | පතස | පලක් නැති | පහත් ස්ථානය | බිළය | බෙනය | බොකුටු | වංක | ඕයි කියා අඩගසනවා | හඬනගා කැඳවනවා | හාරනවා | හිස්
hollowness=කුහකකම | හිස්කම
hollows=දාර පිරැවුම
holly=කටු සහිත කොළ ඇති ගස් වර්ගයක්
holm-oak=විශාල පත්‍ර ඇති සදාහරිත ගසක්
holmium=හොල්මියම්
holocaust=අග්නිහෝමය | ගිනිජාලාව | සමූලඝාතනය | සර්වදාහ්‍ය පූජාව
hologamy=පූර්ණයෝගය
holograph=ආත්මලිඛිතය | කර්තෘගේ ලියවිල්ල | ස්වලිඛිතය
holohedral=සර්වතල
holomorphic=පූර්ණරූප
holonomic=පරිකල්‍ය
holonomous=පරිකාල්‍යක
holoparasite=පූර්ණපරපෝෂිතයා
holophytic=ශාකසදෘශ
holophytism=ශාකසදෘශය
holosaprophyte=පූර්ණ මෘතෝපවියා
holotype=පූර්ණදර්ශය
holozoic=සත්ත්වසදෘශ
holster=පිස්තෝල කොපුව
holt=බිළය | වනාන්තය | වෘක්ෂ ගහනය | සැඟවීමට සුදුසු තැන
holy=ධාර්මික | පවිත්‍ර | ප්‍රණ්‍ය | පුණ්‍ය | පූර්ණ | භක්තිමත් | ශුද්ධ | සාකල්‍ය
holystone=වැලිගල
homage=ප්‍රණාමය | පූජා සත්කාර කිරීම | බැහැදැකීම
homaloid=සමාභය
homaloidal=සමාභ
homatropine=හොමොට්‍රොපයින්
homburg=පිරිමින් පළඳින වක් වූ ගැට්ටක් ඇති තොප්පියක්
home=ආල | ආලය | උත්පත්ති ස්ථානය | උන්හිටි තැන | ගෘහය | ගෙදර | ගෙදර පිළිබඳ වූ | ගේ | ගේදොර | ඝර | නිවස | නිවහන | නිවාසය | නිවෙස | නිවෙසනවා | නිවෙසීම | පදිංචිය | පවුල | ස්වදේශ | සියරට
homeless=අනගාරික
homely=චාම් | පහසුවෙන් තේරෙන | සැපදායක
homeomorphism=ස්ථලක පරිණාමනය
homeopath=සම චිකිත්සා ක්‍රමයෙහි යෙදුණු වෛද්‍යවරයා
homeopathy=සම චිකිත්සාව | සමචිකිත්සාව | හෝමියෝපති වෛද්‍ය විද්‍යාව
homeostasis=සමස්ථිතිය
homeric=හෝමරික
homestead=ගෙවත්ත
homewards=ගෙදර දෙසට
homicidal=ඉතා නපුරු | ඝාතක | මිනීමරු
homicide=ඝාතනය | ප්‍රාණඝාතය | මනුෂ්‍ය ඝාතනය | මනුෂ්‍යඝාතනය | මිනීමරනවා | මිනීමරුවා | මිනීමැරීම | මිනීමැරුම
homiletics=ධර්මභාෂණ විද්‍යාව
homily=කෙටි අනුශාසනාව | ධර්මභාෂණය | ධර්මෝපදේශය
homing=නිවාසාගමනය | නිවෙසීම | නිවෙසුම | සම වකිත්සාව
hominid=ක්ෂීරපායි ගණයට හා මිනිසාට සම්බන්ධ | මනුජ | මනුජයා
hominidae=හොමිනිඩේ
hominism=මනුෂ්‍යවාදය | මානුෂවාදය
hominoid=මානවාභ | මානවාභයා | මිනිසාට සමානකම් ඇති
hominoidae=හොමිනෙයිඩෙ
hominy=හොමිනි
homo=හෝමො
homo-erotic=සමකාමුක
homoblastic=සමවිකාසක
homoblasty=සමවිකසනය
homocarpous=සමඵලීන
homocentric=සංකේන්ද්‍රික | සමකේන්ද්‍රීය
homochlamydeous=සමපරිපුෂ්පී
homochromic=සමවර්ණ
homochromoisomers=සමවර්ණ සමාවයවික
homochromous=සමවර්ණක
homoclimes=සමකාලගුණ ප්‍රදේශ
homoclinic=ඒකමංච
homoclinous=ඒකමංච
homoclisy=සමප්‍රවිකලය
homoclitic=සමකුටික | සමකුටිකය
homocycle=සමචක්‍රය
homocyclic=සමචක්‍රිය | සමචක්‍රීය
homodont=සමදන්තී
homodromal=සමස්‍රෝත
homodromic=සමස්‍රෝත
homodromous=සමස්‍රෝත
homodromy=සමස්‍රෝතතාව
homoeandrous=සමරේණුක
homoeandry=සමරේණුකතාව
homoekinesis=සමවිභේදනය
homoeoid=සමරූපාභය
homoeomeries=සමඅවයවිකයෝ
homoeomerous=සමභාග
homoeomorph=සමරූපය
homoeomorphy=සමරූපතාව
homogamous=සමපරිණත
homogamy=සමපරිණතිය | සමයෝගය | සමාභිජනනය
homogene=නුමුහුම
homogeneity=සජාතියත්වය | සමජනනය | සමජාතිත්වය | සමජාතිතාව | සමජාතීයතාව | සමාන බව
homogeneous=එකට ගැළපෙන | සජාතීය | සමජාතීය | සමවාර්ගික | සමාන ජාතික
homogenesis=සමජනනය
homogenity=සමජාතිත්වය
homogenous=සමජාතීය | ස්වකීල
homogeny=සමජනනය
homogonous=සමකීල
homograde=ද්විමේයය
homograph=සමාන රූප වචනය
homographic=ඒකෙකානුකූල
homoiochlamydeous=සමපරිපුෂ්පී
homoisohydric=ඒක සමහයිඩ්‍රික
homokinesis=සමවිභේදනය
homokurtic=සමචක්‍රිම | සමවක්‍රීම
homolateral=සමපාර්ශ්වික
homologation=හැසිරීමෙන් ප්‍රතිබන්ධනය වීම
homologous=සදෘශ | සම පරිමාණ | සමජාත | සමපරිමාණ | සමප්‍රභව | සමාකාර
homologue=සදෘශය | සමප්‍රභවය
homology=සම ප්‍රභවතාව | සමපරිමාණතාව | සමප්‍රභවතාව | සාදෘශ්‍යය
homomalous=සංවක්‍ර
homomericus=සමභාග
homomerous=සමභාග
homometric=සමකිරණමිතික
homomorphic=සමරූපී
homomorphism=සරූපතාව
homomorphous=සමරූපී
homomorphy=සමරූපතාව
homonomous=සමනියාමක
homonuclear=සමන්‍යෂ්ටික
homonym=අර්ථභේදය | නානාර්ථ ශබ්දය | භින්නාර්ථය | සමනාම | සමනාමය
homonymon=සමනාම
homonymy=අර්ථභේදතාව | භින්නාර්ථතාව | සමනාමතාව
homopetalous=සමදල
homophase=සමකලාප
homophone=සමාන ශබ්දය ඇති එහෙත් තේරුම වෙනස් වචනය
homoplasmy=සමභාවය
homoplasy=සමභාවය
homopolar=සමධ්‍රැවීය
homoscedastic=සමවිචල | සමවිචලතා
homoscedasticity=සමවිචලතාව
homosexual=සමලිංග | සමලිංගික
homosexuality=සමලිංග සේවනය | සමලිංගික මෛථූනය | සමලිංගිකතාව
homosporous=සමබීජාණුක
homospory=සමබීජාණුකතාව
homostyled=සමකීල | ස්වකීල
homostyly=සමකිලතාව
homothallic=සමතලස්
homotheism=මනුෂ්‍යදේවත්වය | මනුෂ්‍යදේවවාදය | මානුෂදේවත්වය | මානුෂදේවවාදය
homotopic=ඒකස්ථල
homotype=සමදර්ශය
homotypic=සමදර්ශීය
homotypy=සමදර්ශතාව
homozygocity=සමයුග්මක
homozygosis=සමයුග්මක
homozygote=සමයුක්තාණුව | සමයුග්මකයා
hone=මුවහත් කරනවා | හණ ගල | හණගල | හන ගල
honest=අකුටිල | අවංක | සත්‍යවාදී | සෘජු
honestly=අවංකලෙස
honesty=අවංකකම | අවංකභාවය
honey=පැණි | මධු | මිහිරි බව | මී පැණි | මීපැණි
honeycomb=මධු පටලක
honeycombing=මීවද ගැසීම
honeyed=ඉතා මිහිරි
honeymoon=මධුසමය | මධුසමය ගත කරනවා
honied=ඉතා මිහිරි
honing=හණ ගානවා | හණ ගෑම | හන ගෑම
honk=මෝටර් රියෙහි නළාවේ ශබ්දය වැනි හඬ නගනවා | හංසයන්ගේ නාදය
honky-tonk=පහත් තත්වයේ රාත්‍රි සමාජශාලාව
honorarium=ගෞරවදීමනාව | නිවැතිය | ප්‍රසාද දීමනාව | සංවේතනය | සම්මත මුදල | සම්මාන මුදල
honorarlum=ප්‍රසාදය
honorary=ගරු | ගරු සේවය | නිර්වේතනික | නිවැති | වැටුප් නොලබා කරන සේවය
honorific=ගෞරවවාචක පදය | ගෞරවවාචී | ගෞරවාර්ථය
honour=උදාරභාවය | උපචාර | උපහාරය | කීර්තිය | ගරු | ගරු කරනවා | ගරු කිරීම | ගෞරව කරනවා | ගෞරව දක්වනවා | ගෞරව පදවිය | ගෞරවය | ධර්මිෂ්ටකම | නම්බුව | පතිව්‍රතාව | බහුමානය | බුහුමන | බුහුමන් කරනවා | මාන්න | සත්කාරය | සම්භාවනය | සම්භාවනාව | සම්මානය | සලකනවා | සැලකිල්ල | සැලකීම
honourable=අවංක | උදාර | ගෞරවාර්හ | නම්බුකාර | මානනීය | සගර්ව | සගාර්ව | සම්භාවනීය
honourably=නම්බුපිටින්
honoured=පූජීත | මානිත | සම්භාවිත
hood=අඹරාව | ඇස් වසනවා | ඉස්පයිය | ඡදිකාව | තැන්ද | වියන | සියන | හිස්වැස්ම | හිස්වැස්මක් යොදනවා
hooded=කුර ඇති | ඡදිකාධර
hoodium=තක්කඩියා | මැරවරයා
hoodshaped=ඡදිකාකාර
hoodwink=ඇස් වසා බඳිනවා | කොකා පෙන්වනවා | රවටනවා
hoof=කුරය | ඛුරය | සතුන්ගේ කුරය
hoohoo=හූනියම
hook=අංකුශය | අසුකර ගන්නවා | කොක්ක | කොකු තුඩ | හක් | හාක්කය | හාක්කයක් දමනවා
hook-nosed=වකුටු නාසයක් ඇති
hooka=ගඩුගුඩාව
hookah=ගඩුගුඩාව
hooked=කොකු සහිත | වකුටු වූ
hookworm=කොකු පණුවා | කොකුපණුවා
hooligan=දාමරිකයා | පාදඩයා | මැරවරයා
hooliganism=පාදඩකම
hoondee=විනිමය පත | හුන්ඩිය
hoop=චක්‍රය | පට්ටම | මොර ගහනවා | මොරහජ | වළල්ල | වළලු දමා වෙළනවා | සවි කරනවා
hooping=මුදු වැරගැන්නුම
hoopla=ත්‍යාගයක් ගැනීමට වළල්ලක් දැමිය යුතු ක්‍රීඩාවක්
hoot=කෑමොර ගැසීම | බකමූණාගේ නාදය | හුරේ තියනවා | හූ | හූකියනවා | හූව
hooter=දුම් නළාව | දුම් යන්ත්‍රයේ නළාව
hooting=හූ කීම
hop=කුන්දු ගහනවා | පනිනවා | පිම්ම | බීරමල්
hope=අපේක්ෂාව | ආශංසනය | ඊට හේතුව | ප්‍රාර්ථනා කරනවා | පැතීම | පැතුම | බලාපොරොත්තු වෙනවා | බලාපොරොත්තුව | විශ්වාසය
hopeful=ඇතිකරගත හැකි | බලාපොරොත්තු සහිත
hopeless=කිසිත් නොකළැකි | නිරපේක්ෂක | බලාපොරොත්තු රහිත
hoping=පතන
hopper=ආප්ප | ආප්පය | ධාන්‍ය ඔරුව | පාතිය | බලුමැක්කා | හොපරය
hoppit=මා බඳුන
hopple=අමාරුවෙන් ඇවිදිනවා
hops=බීර මල්
horde=රංචුව | රැළ
hordein=හෝර්ඩයින්
horison=ක්ෂිතිජය
horizon=ක්ෂිතිජය | තිරස | දිගන | දිගන්තය | බුද්ධියෙහි සීමාව
horizontal=තිරස | තිරස් | පොළොවට සමාන්තර වූ | සමස්ත | හරහට වැටුණු
hormogone=හෝමොගෝනය
hormone=ශ්‍රාවය | හෝමෝන | හෝමෝනය | හෝර්මෝනය
horn=අං | අඟ | අඟ වැනි දේ | අඟින් තැනූ | චන්ද්‍රශිඛාව | නලාව | නළාව | නළාව ශබ්ද කරනවා | විෂාණය | ශෘංග | ශෘංගය | සිඟු | සිඟුව | හඟ | හොරණෑව පිඹිනවා
hornbill=කෑදැත්තා
hornblende=ඛනිජ විශේෂයක් | හෝන්බ්ලෙන්ඩ්
hornblock=සිඟු කඳ
horned=අං ඇති | අර්ධචන්ද්‍රාකාර | ශෘංගාකාර | ශෘංගී
hornet=බඹරා
hornfels=හෝන්පෙල්ස්
horny=ඉතා ගොරෝසු | කොරොස් | තද
horologe=වේලාව දක්වන යන්ත්‍රය
horology=ඝටිකායන්ත්‍ර නිපදවීමේ කලාව
horometer=ඝටිකා යන්ත්‍රය
horopter=සීමේක්ෂය | හොරොප්ටරය
horoscope=කේන්දරය | කේන්ද්‍රය | ජන්ම පත්‍රය | ජන්මපත්‍රය | වේලාපත්කඩය | සඳහන | හඳහන
horoscopy=හඳහන් කීම
horrendous=බිහිසුණු | භයානක
horrible=ඝෝර | දරුණු | භයංකර
horrid=භයානක | මහත් පිළිකුල් උපදවන
horrific=භයංකර
horrify=තැතිගන්වනවා
horripillation=මයිල් කෙළින් සිටීම | ලොමුදැහැගැන්ම
horror=තැතිගැන්ම | බීභත්ස්‍යය | භය කාරණය | මහ භය | විත්‍රාසය | සංත්‍රාසය
horse=අශ්වයකු පිට යනවා | අශ්වයකු සපයාදෙනවා | අශ්වයා | අශ්වාරෝහක සේනාව | අස් | අසු | තුරඟා | හය | හස
horse-cart=අශ්ව කරත්තය | අශ්වරථය
horse-fly=අස්මැස්සා
horse-laugh=අට්ටහාසය
horse-power=අශ්ව ජවය | අශ්වබලය
horse-sense=සාමාන්‍ය ඥානය
horse-shoe=අශ්වලාඩම | ලාඩම්
horsefly=ඇට මැස්සා
horseguards=ආරක්ෂක අසරුහමුදාව
horseman=අශ්වාරෝහක | අශ්වාරෝහකයා
horsemanship=අශ්වවිද්‍යාව
horseplay=ඝෝෂා කරන සෙල්ලම්
horst=හෝස්ට්
hortative=අවවාදාත්මක | උනන්දු කරවන
hortatory=අවවාදාත්මක | උනන්දු කරවන
horticultural=උයන්වතු සම්බන්ධ
horticulture=උද්‍යාන විද්‍යාව | උයන් වැවීම | උයන්වතු වැවීමේ ශාස්ත්‍රය
horticulturist=උද්‍යාන වවන්නා | උද්‍යාන විද්‍යාඥයා
hose=කොට මේස් | මේස් | සොඬ නළය | සොඬනළ
hosier=මේස් වෙළෙන්ඳා
hosiery=මේස් ඇඳුම්
hospice=ගිලාන ශාලාව | පථීක ශාලාව
hospitable=අතිථීපූජක | ආගන්තුක සත්කාරය කරන | ආගන්තුක සත්කාරයට කැමති
hospital=ආරෝග්‍ය ශාලාව | ආරෝග්‍යශාලාව | ඉස්පිරිතාලය | ගිලන්හල | රෝහල | වෙදහල
hospitality=අතිථිපූජාව | අනුග්‍රහ සහිතව පිළිගැනීම | ආගන්තුක සත්කාරය | ප්‍රසාරණීයතාව | සංග්‍රහය | සත්කාරය
hospitaller=ආගමික සමාජසේවා ආයතනයක සාමාකයා
host=ආගන්තුක සත්කාර කරන්නා | තානායම් කාරයා | ධාරකයා | විශාල පිරිස | සත්ප්‍රසාදයට යොදන පාන් | සමූහය | සේනාව
hostage=ප්‍රාණ ඇපකරු | ශරීර ඇපකරුවා | ශරීර බන්ධකයා | සුරකු පුද්ගලයා
hostel=නවාතැන | නවාතැන් පොළ | නේවාසිකාගාරය | ලැගුම් ගන්නා තැන | ශිෂ්‍ය නිවාසය | ශිෂ්‍යනිවාසය
hosteler=තානායමේ අශ්වයන් බලාගන්නා
hostelry=තානායම
hostess=සත්කාර කරන්නිය
hostile=ඉදිරි | එදිරි | ප්‍රතිපක්ෂ | විරුද්ධ | සතුරු | හතුරු
hostilities=යුද්ධය | සටන
hostility=එදිරිය | එදිරිවාදිකම් | පත්‍රපක්ෂබව | විරිදුව | විරෝධය | වෛරය | සතුරු බව | සතුරුකම
hostorium=ශෝෂකය
hot=උග්‍ර | උණු | උණුසුම් | උෂ්ණ | ඝර්ම | තපනීය | තප්ත | බොහෝ කුළුබඩු යෙදූ | රත් | රත් වූ | වහා කිපෙන
hot-blooded=වහා කිපෙන
hot-dog=ඌරු මස් සහිත පාන් කෑමක්
hot-foot=කලබලයෙන් | තකහනියේ
hot-spot=තැවි තිත
hotchpot=ඒකරාශිය
hotel=භෝජන ශාලාව | භෝජනාගාරය | හෝටලය
hotly=වැරෙන් | වේගයෙන්
hotness=උණුසුම
hottentot=අප්‍රිකානු ජන කොට්ඨාශයක්
hottentots=හොටොන්ටොට් ජනයා
hound=දඩයම් බල්ලා | ලුහුබැඳ යනවා
hour=කණසම | පැය | පෑ | හෝරා | හෝරාව
hour-circle=හෝරා වෘත්තය
houri=මුස්ලිම් පාරාදීසියේ සුන්දරිය | රූපසුන්දරී
hourly=පැයක් පාසා
hours=කාලය | නියමිත වේලාව
house=ආගාරය | ආල | ගර | ගහ | ගුදම් | ගෘහය | ගෙදර | ගෙය | ගේ | ඝර | නවාතැනක් සපයා දෙනවා | නිවාසය | පදිංචිය | මන්ත්‍රී මණ්ඩලය | රක්ෂාස්ථානයක් සපයා දෙනවා | රාශිය | වංශය | වට්ටාරම | විමන | විමානය | වෙළඳ ව්‍යාපාරය | ශාලාව | ශාලිකා | ශිෂ්‍ය නිවාසය
house-breaker=උමං කණින හොරා
house-fly=ගෙමැස්සා
house-hold=ගෙදර වැසියෝ | පවුල
house-wife=ගෘහණිය | මාය්‍යා | මායියා
housebreaking=ගෙවල් බිඳීම
household=කුටුම්බය | ගිහි | ගෘහය | ගෘහස්ථ | ගේදොර
householder=කුටුම්බිකයා | කෙළෙඹියා | ගෘහමූලික | ගෘහවාසියා
housekeeping=ගෘහ පාලනය
houses=ගෙවල් | නිවාසය
housewife=ගෙදර ඇත්තී | මැහුම්පෙට්ටිය | ස්වාමිදුව
housing=නිවාස | නිවාස කටයුතු | නිවාස සංවිධානය | නිවාස සැපයීම | නිවෙස්නාව
hovel=මඩුව
hover=සුනංගු වෙනවා
hover-fly=බමන මැස්සා
hovercraft=වායු පා යානය
how=කෙලෙස | කෙසේ | කොතරම් | කොපමණ | කොහොම | කොහොම නමුත් | තොරතුරු | මක්නිසා
howdah=රන්හිලිගෙය
however=එසේ වුවත් | එසේවුවහොත් | ඒ කෙසේ වෙතත් | කෙසේ වුවත් | කොපමණ වුවත්
howitzer=උස් කාලතුවක්කු වර්ගයක් | හොවිත්සරය
howl=උඩු බුරනවා | උඩුබුරලනවා | කෑගසා වැලපෙනවා | බෙරිහන් දෙනවා | මොරගහනවා
howler=අපප්‍රයෝගය | දුෂ්ප්‍රයෝගය | රෝදකය | හඬකරය
howling=මොර ගසන
hoyden=දඟකාර කෙල්ල
hub=චක්‍රනාභිය | නාභිය | නැබ | බොස් ගෙඩිය | බොස්ගෙඩිය | මධ්‍යස්ථානය
hubble-bubble=ගඩු ගුඩාව
hubbub=කලබලය | ගෝට්ටිය | චරචරය
hubnerite=හියුබ්නරයිට්
hubris=උඩඟුකම | මවාගත් තේජස
huck-a-back=හාක්ක වියමන
huckaback=තුවාය ආදිය පිණිස යොදන ගොරෝසු රෙදි වර්ගයක
huckleberry=නූස්ව වැවෙන පල දරන පඳුරු වෙසෙසක්
huckster=පොට්ටනිකාරයා
huddle=එක ගොඩකට දමනවා | කුමන්ත්‍රනය | ගොඩ | ගොඩගැසී සිටින පිරිස | තෙරපී සිටිනවා | තෙරපී සිටීම | තෙරපී සිටීමට සලසනවා | මිරිකී සිටිනවා | මිරිකී සිටීම | මිරිකී සිටීමට සලසනවා
hue=කෑගැසීම | පාට | පැහැය
huerta=හුවේටා
huess=සන්දේහය
huff=කේන්ති කරනවා | කේන්ති වෙනවා | කේන්තිය | සැරෙන් හුස්ම අරිනවා
huffy=කේන්තිකාර | කෝපශීලි
hug=තදින් බදාගන්නවා | දැඩි ආලිංගනය
huge=අලි | ගජ | තුල් | ථුල්ල | දැවැන්ත | නැබළ | පුවළ | බංගසාල | මහා | රූක්ෂ | රූස්ස | විශාල | විසල් | සද්දන්ත
hugely=අධික ලෙස
hugeness=විශාලතම
hugger-mugger=පටලැවිල්ල | රහස
hula=හවායිහී කාන්තා නැටුමක්
hulk=පරණ නැව්කඳ | විශාල තැනැත්තා | විශාල දේ
hulking=තඩි | තරබාරු
hulks=සිරගෙවල් වශයෙන් පාවිච්ව කළ නැව්කඳන්
hull=අනුවැස්ම | නැව්කඳ | පොත්ත | පොතු ගහනවා | සිවිය
hullabaloo=කලබලය | කෝලාහලය
hullo=ආමන්ත්‍රණය
hum=ගුමනවා | ගුමුගුමුව | ගුමුව | මුමුණනවා | මුමුව | සිහින් හඬ නඟනවා
human=පෘථග්ජන | මනු | මනුෂ්‍ය | මර්ත්‍ය | මානව | මානුෂික | මිනිස්
humane=කාරුණික | දයාබර | ශිෂ්ඨ
humanism=කරුණාව | මානව විද්‍යාව | මානවවාදය | මානවීය වාදය | මානවීයවාදය | සාහිත්‍යඥානය
humanist=මානවවාදියා | මානවවේදියා
humanitarian=මානවවාදී
humanitarianism=මානවභක්තිය | මානවහිතවාදය
humanities=මානව ශාස්ත්‍ර | මානව ශාස්ත්‍රය
humanity=අනුකම්පාව | දයාව | මනුෂ්‍ය ප්‍රජාව | මනුෂ්‍යත්වය | මනුෂ්‍යවර්ගයා
humanize=මෘදුබව ඇති කරනවා
humanly=මනුෂ්‍ය බලයෙන්
humanoid=මනුෂ්‍යාභ | මනුෂ්‍යාභයා
humble=අවමන් කරනවා | ඉතා සුළු | ඔද බිඳිනවා | නියාලු | නිරහංකාර | නිහතමාන | මැඩපවත්වනවා | යටත් පහත් | යටහත් කරනවා | යටහත් පහත් | සෝරත
humbug=කපටියා | බොරුව | රවටනවා | රැවටිල්ල | රැවටිලිකාරයා | වංචා කරනවා
humdrum=අවිශිෂ්ඨ | දියාරු | නීරස
humer=අම්මය රසය | හාස්‍යය
humerus=උඩබාහුවේ ඇටය | ප්‍රගණ්ඩය | ප්‍රගන්ඩය
humicular=මෘතෝප ඡීවී
humid=ආර්ද්‍ර | තෙත | තෙතමනය ඇති | තෙත් වූ
humidifier=ආර්ද්‍ර කරන්නා
humidify=ආර්ද්‍ර කරනවා
humidity=ආර්ද්‍රතාව | තෙතමනය | දියසීරාව | දියැතිය
humification=හියුමිකරණය
humiliate=අත සෝදනවා | අවමන් කරනවා | අවමානයට පමුණුවනවා | ඔද බිඳිනවා | ඔළුවට අත හෝදනවා | ගරහනවා | නින්දාවට පමුණුවනවා
humiliating=නින්දා පමුණුවන
humiliation=අපකීර්තිය | අවනම්බුව | නින්දාව | මානභංගය | ලජ්ජාව
humility=දීනතාව | නම්‍රතාව | නිහතමානබව | නිහතමානය | යටහත් පහත්කම | විනීතතාව
humming=ගුමනය | ගුමු නාදය | මුමුනය | සිහින් හඬ
hummock=කුඩා කන්ද | ගොඩැල්ල
humorist=කවටයා
humorous=කවට | සිනහ උපදවන | හාසකර | හාස්‍යජනක | හාස්‍යප්‍රිය
humour=අම්මය රසය | කවටකම | පරිහාසයට නැමුණු බව | රසය | රසිකතාව | වත්තප්‍රකෘතිය | ශරීරයෙහි සජස | සරදමට නැමුණු බව | සිතේ පවත්නා ස්වභාවය | සිනහවෙන් සතුටු වෙනවා | හාසය | හාස්‍යය
humous=කෑමක්
hump=කලකිරීම | කුදය | මොල්ලිය
humus=පෝර පස | හ්‍යමස් | හියුමස්
hun=ඉබාගාතේ යන්නා
hunch=කලකිරීම | කුට්ටිය | කුදය | මොල්ලිය | වැදැල්ල
hunched-backed=කුදු
hundred=පත්තුව | ශතකය | සත | සිය | සියය | සීය
hundredweight=හොණ්ඩරය
hunger=ක්ඹුධාග්නිය | ක්ෂුධාව | කුසගින්න | ජටරාග්නිය | ජැඝච්ඡා | බඩගින්න | බඩගින්නේ සිටිනවා | බඩසාය | බලවත් ආසාව | රෝචක | සහගින්දර | සහගින්න | සා | සාගින්දර | සාගින්න | සාගිනි | සාමත | සාය | සුන්බත් | හාමත
hungrily=කුසගින්නෙන්
hungry=ආසා කරන | කෑදර | කෑඹල | සාගින්නෙන් පෙළෙන
hunk=ලොකු කුට්ටිය
hunt=දඩයම | දඩයම් කරනවා | ලුහු බැඳ යනවා | ලුහුබැඳ යාම | සෙවීම | සොයා යනවා
hunter=දඩයක්කරු | දඩයක්කාරයා | මස්වර වැද්දා | වැද්දා | සබර
hunting=දඩ | දඩයම | නිසැරුම | ලුහුබැඳ යාම | සැලීම | සෙවීම
huntress=දඩයක්කාරිය
hurdle=කඩුල්ල | තහංවය | බාධාව
hurdy-gurdy=කරකැවීමෙන් ශබ්ද නගන තූර්ය භාණ්ඩයක්
huricane=සැඩකුණාටුව | සැඩ නල | සැඩකුණාටුව
hurl=වේගයෙන් දමා ගසනවා | හෙළනවා
hurly-burly=කලබැගෑනිය | කෝලාහලය
hurrah=ඔල්වර හඬ | ඔල්වර හඬ දෙනවා | සහෝ
hurray=ඔල්වර හඬ | ඔල්වර හඬ දෙනවා
hurricane=චණ්ඩමාරුතය | නැඩ කුණාටුව | සැඩ කුණාටුව | හුළං කෝඩය
hurried=ඉතා ඉක්මන් | හදිසි
hurry=ඉක්මන | ඉක්මන් කරනවා | ඉක්මන් කරවනවා | ඉක්මනින් යනවා | කඩිමුඩිය | තදියම | දඩිබිඩිය
hurry-scurry=මහත් කඩිමුඩිය
hurst=උපවනය
hurt=උද්දනවා | තුවාලය | පාඩු පවුණුවනවා | පාඩුව | පීඩා කරනවා | පීඩාව | පෙළනවා | රිදණු | රිදවනවා | රිදෙනවා | හිංසා කරනවා | හිංසාව
hurtful=අලාභහානි ඇතිකරන | වේදනා ඇතිකරන
hurtle=වැදෙනවා | වැරෙන් විසි කරනවා
husband=කලත්‍ර | භර්තෘ | වල්ලභයා | සකසුරුවම්කමින් පාවිච්ව කරනවා | සකසුරුවමින් පාවිච්ව කරනවා | සහකාරයා | ස්වාමි | ස්වාමිපුත්‍රයා | ස්වාමිපුරුෂයා | ස්වාමියා | සැමියා | හිමියා
husbandman=ගොවියා
husbandry=කෘෂිකර්මය | ගොවිතැන | පශුපාලනය | සකසුරුම්කම
hush=නිශ්ශබ්ද කරනවා | නිශ්ශබ්ද වෙනවා | නිශ්ශබ්ද වෙනු | නිශ්ශබ්දතාව
hushing=දියෙන් පෙරික්සුම
husk=එළ කරනවා | ඔයනවා | පොත්ත | පොතු අරිනවා | මුඩ්ඩ | ලෙල්ල | ලෙලි | ලෙලි ගහනවා | ලෙලිගසනවා | ලොඹු | සිවිය
husked=සිවිය ඇති | සිවිය හරිනලද
huskiness=රළුබව
husks=දහයියා
husky=ඇස්කිමෝ ජාතිකයා | ගොරෝසු | බැ
hussar=අශ්වාරෝහක භටයා
hussif=ගෙදර ඇත්තී | ස්වාමිදුව
hussism=හස්වාදය
hussy=අකීකරු තරුණිය | මූසලී
hustings=කථිකාසනය | ඡන්ද විමසන ස්ථානය
hustle=කඩිමුඩිය | කලබල කොට කරවාගන්නවා | කලබලයෙන් ක්‍රියා කරනවා | තදබද කොට තෙරපනවා
hut=අතුපැල | කුටිය | කූඩම | තාවකාලික වාසස්ථානය | පැල | පැල්පත | මඩුව | වාඩිය
hutch=මඩුව
huzza=සාධු නාදය | සාධුකාර දෙනවා
huzzy=අකීකරු තරුණිය | කථිකාසනය | ඡන්ද විමසන ස්ථානය | මූසලී
hyacinth=මැණික් වර්ගයක්
hyaena=කරබානා වලසා | තරච්ඡයා
hyalase=හයලේස්
hyalescent=පාරභාසක
hyaline=පාරදෘශ්‍ය
hyaloplasm=හයලොප්ලාස්මය
hyalosome=නිවර්ණක දේහය | හයලසෝමය
hyalosporae=හයලොස්පෝරේ
hyalostaurae=හයලොස්ටවුරේ
hybrid=දෙමුහුන් | දෙමුහුන් ගස | දෙමුහුන් සතා | දෙමුහුම | දෙමුහුම් | මුහුන් | මුහුම | සංකර | හාමු
hybridisation=දෙමුහුම් කිරීම | දෙමුහුම් වීම | මුහුම්කරණය
hybridise=දෙමුහුම් කරනවා | සංකර වෙනවා
hybridization=දෙමුහුන් කිරීම | දෙමුහුන් වීම
hybridize=පහකිරීමට දුෂ්කර උපද්‍රවය
hydantoinate=හයිඩන්ටොයිනේට්
hydathode=ජලඡිද්‍රය
hydometer=ද්‍රවමානය
hydra=ජලජ වියෙක් | පහකිරීමට දුෂ්කර උපද්‍රවය | හයිඩ්‍රා
hydracid=හයිඩ්‍රම්ලය
hydraded=හිස් ගොඩක් ඇති
hydrangea=මල්ගස
hydrant=ජලෝද්ගම නළය | දියමුව
hydrargyrum=පාරද
hydrase=හයිඩ්‍රේස්
hydrastin=හයිඩ්‍රස්ටින්
hydrate=සජල කරනවා | සජලය | හයිඩ්‍රේටරය
hydrated=සජල
hydration=දියකැවීම | සජල කිරීම | සජල වීම | සජලකිරීම | සජලනය
hydraulic=ද්‍රාව | වාමුසුව
hydraulicity=ද්‍රාවතාව
hydraulicking=ද්‍රාව කැණීම
hydraulics=ජලශක්ති විද්‍යාව | ද්‍රාව විද්‍යාව
hydrazine=හයිඩ්‍රසීන්
hydria=හයිඩ්‍රියා බඳුන
hydride=හයිඩ්‍රජන් හා ලෝහයක් පමණක් අඩංගු සංයෝගය | හයිඩ්‍රයිඩ්
hydrilyse=ජල විච්ඡේදනය වෙනවා
hydrion=හයිඩඩ්‍රයනය | හයිඩ්‍රජන් අයනය
hydro=ජල
hydro-diffusion=ජලීන විසරණය
hydro-dynamics=ද්‍රව ගති විද්‍යාව | ද්‍රාවගති විද්‍යාව | ද්‍රාවගතිකය
hydro-electric=ජල විදුලි | ජල හෝ වාෂ්ප මගින් විදුලි බලය නිපදවන
hydro-electricity=ජල විදුලි බලය | ජලවිදුලිය
hydro-meter=හයිඩ්‍රෝමීටරය
hydro-pathic=ජලචිකිත්සාගාරය
hydro-philic=ජලකාමී
hydro-plane=අහස්‍යාත්‍රාවක් වැනි හැඩය ඇති දියෙහි ගමන් කරන ඔර
hydro-scope=ජලඝටිකාව
hydro-sonic=ශබ්දයේ වේගය මෙන් පස් ගුණයක් වේගයෙන් යන
hydro-sphere=ජලගෝලය
hydro-statics=ද්‍රවස්ථීති විද්‍යාව
hydrocarbon=හයිඩ්‍රොකාබන්
hydrocarpic=ජලඵලීන
hydrocarpy=ජලඵලීනතාව
hydrocele=අණ්ඩ වෘද්ධිය | ජල පුඤ්ඡය
hydrocephalus=ජලකපාලය
hydrocephaly=ජලකපාලය
hydrochloride=හයිඩ්‍රොක්ලෝරයිඩ්
hydrochore=ජලව්‍යාප්තිය
hydrochoric=ජලව්‍යාප්ත
hydrocleistogamy=ජලනිමීලයෝගය
hydrodiffusion=ජල අන්තර් විසරණය
hydrodynamic=ජලගතික
hydrodynamical=ද්‍රවගතික
hydrodynamics=ද්‍රවගති විද්‍යාව | ද්‍රවගතිකය | ද්‍රාවගති විද්‍යාව | ද්‍රාවගතිකය
hydrodynamlics=ජලගතිවිද්‍යාව
hydrodynamometer=හයිඩ්‍රො ඩයිනමෝමීටරය
hydroelectricity=ජල විදුලිය
hydroextractor=ද්‍රව නිස්සාරකය
hydrofining=හයිඩ්‍රොප්‍රසාදනය
hydroforming=හයිඩ්‍රොසාදනය
hydrofuge=තෙතහරුව
hydrogam=ගුප්තයෝගිය
hydrogel=හයිඩ්‍රොජෙලය
hydrogen=ජලකර වායුව | හයිඩ්‍රජන්
hydrogen-ion=හයිඩ්‍රජන් අයනය
hydrogenate=ජලීකරණ කරනවා | හයිඩ්‍රජනී කරනවා
hydrogenated=හයිඩ්‍රජනීකෘත
hydrogenation=හයිඩ්‍රජනීකරණය | හයිඩ්‍රොජන්කරණය
hydrogenite=හයිඩ්‍රජනයිට්
hydrogenolysis=හයිඩ්‍රජන් විච්ඡේදනය
hydroger=ජලධර
hydrograph=ජල ප්‍රස්තාරය
hydrographer=ජල මිනුම් පාඨකයා
hydrographic=ජලමාන
hydrography=ජල විද්‍යාව | ජලගුණ විද්‍යාව | ජලගුණවිද්‍යාව විද්‍යාව | ජලමාන විද්‍යාව
hydroid=හයිඩ්‍රාකාර | හයිඩ්‍රාභයා
hydrokinetics=ද්‍රාවචාලන විද්‍යාව
hydrol=හයිඩ්‍රොල්
hydrolase=හයිඩ්‍රොලේස්
hydrolics=ද්‍රවවිද්‍යාව
hydrolith=හයිඩ්‍රොලිත්
hydrology=ජල විද්‍යාව | ජලවිද්‍යාව
hydrolysis=ජල විච්චේදනය | ජල විච්ඡේදනය | ජලවිච්ඡේදනය
hydrolyst=ද්‍රවපේරකය
hydrolyte=ජලවිච්ඡේද්‍යුය
hydrolytic=ජලවිච්ඡේද්‍යු | ද්‍රවවිච්ඡේද්‍යු
hydrolyze=ජලවිච්ඡේදනය කරනවා
hydromancy=ජලපේනය
hydrome=දාරුකය | හඩ්‍රෝම | හයිඩ්‍රෝම
hydromechanics=ද්‍රවයාන්ත්‍ර විද්‍යාව
hydromegatherm=ආර්ද්‍රෝෂ්ණකය
hydrometallurgy=ද්‍රව ලෝහ කර්මය | ද්‍රවලෝහ විද්‍යාව
hydrometer=ද්‍රවමානය | හයිඩ්‍රොමීටරය
hydrometry=ජලමිතිය
hydromorphosis=ජලරූපනය
hydronasty=ආර්ද්‍රසන්නමනය
hydrone=හයිඩ්‍රෝන්
hydronephrosis=ජල වක්කතාව
hydropathy=ජල භාවිතයෙන් රෝග නිවාරණය
hydrophilae=ජලකාමීහු
hydrophile=ජලාකර්ෂක
hydrophilic=ජලකාමී
hydrophilous=ජලකාමී
hydrophobe=ජලවිකර්ෂක
hydrophobia=ජලභීතිකාව
hydrophobic=ජලභීතික
hydrophone=හයිඩ්‍රොපෝනය
hydrophonics=දියවගාව
hydrophyll=ජලපත්‍රය | ජලශාකපත්‍රය
hydrophyte=ආර්ද්‍ර ශාකය | ජලශාකය
hydropot=ජලපිබකය
hydroscopic=ජලාකර්ෂක
hydrosere=ජලසංශ්‍රේණිය
hydrosol=හයිඩ්‍රොසොලය
hydrosphere=ජලගෝලය
hydrostatics=ජලස්ථිතිවිද්‍යාව විද්‍යාව | ද්‍රවස්ථිති විද්‍යාව | ද්‍රවස්ථිතිකය | ද්‍රවස්ථිතිවිද්‍යාව | ද්‍රවස්ථීති විද්‍යාව | ද්‍රවස්ථීතිකය
hydrostereid=ජලෝපල සෛලය
hydrotactic=ආර්ද්‍රසාර්වසාරී
hydrotaxis=ආර්ද්‍රසාර්වසරණය | ද්‍රවාවර්තනය
hydrotherapy=ද්‍රව චිකිත්සාව | ද්‍රාව වකිත්සාව
hydrothorax=ජල උරස
hydrotrophy=ජලීයවිෂම වර්ධනය
hydrotropic=ජලාවර්තී
hydrotropism=ජලාවර්තනය | ද්‍රවවර්තනය
hydrous=ජල සහිත | ජලමය | සජල
hydrox=හයිඩ්‍රොක්සිය
hydroxide=හයිඩ්‍රොක්සයිඩ්
hydroxylamine=හයිඩ්‍රොක්සිල් ඇමයින්
hydroxylation=හයිඩ්‍රොක්සිල්කරණය
hyemal=ශිශිර
hyena=කරබානා වලසා | තරච්ඡයා | බලු දිවියා
hyertonic=උපරි අභිසාරක
hygenic=සනීපාරක්ෂක
hygiene=සනීපාරක්ෂාව උගන්වන ශාස්ත්‍රය | ස්වස්ථතාව | ස්වාස්ථ්‍ය විද්‍යාව
hygrograph=වාෂ්ප ප්‍රස්තාරය
hygrometer=ආර්ද්‍රතාමානය | හයිග්‍රොමීටරය
hygrometric=ආර්ද්‍රතාමිතික | ජලාකර්ෂක
hygrometry=ආර්ද්‍රතාමිතිය | ආ්ද්‍රතාමිතිය
hygromorphic=ආර්ද්‍රරූපී
hygromorphism=ආර්ද්‍රරූපතාව
hygrophil=ආර්ද්‍රකාමියා
hygrophilae=ආර්ද්‍රකාමීහු
hygrophilous=ආර්ද්‍රකාමි
hygrophyte=ආර්ද්‍රශාකය
hygroscope=ආර්ද්‍රතා දර්ශකය
hygroscopic=ජලාකර්ශක | ජලාකර්ෂක
hygroscopy=ජලාකර්ෂණය
hyle=මූලප්‍රකෘතිය
hylomorphism=ද්‍රව්‍යරූපවාදය
hylons=ද්‍රව්‍යාණු
hylosis=ද්‍රව්‍යත්වය
hylosystemism=ද්‍රව්‍යසංස්ථාවාදය
hylotheism=ද්‍රව්‍යෙශ්වරවාදය
hylotropic=ස්ථීරාංක
hylotropy=ස්ථීරාංකතාව
hylozoism=ද්‍රව්‍යජීවවාදය
hylum=කණිකාලපය | බීජලපය
hylus=කණිකාලපය | බීජලපය
hymen=කාලිකා සිවිය | කුමරිච්ඡදය | කුමාරිච්ඡදය | ඡද්මය | පටලය | වෛවාහිකය
hymeneal=විවාහ ගිතය | විවාහය පිළිබඳ
hymenectomy=වෛවාහික විච්ඡේදනය
hymenium=සරුපටය
hymenolichen=හිමෙනොලිකෙන්
hymenomycetes=හිමෙනොමිසේටේස්
hymenomycetous=හිමෙනොමිසේටීය
hymenophore=සරුපටකධරය
hymenopterid=භංගකාමී
hymenopterous=මීමැස්සන් වැනි පියාපත් ඇති කෘමීන්ට සම්බන්ධ
hymn=භක්ති ගීතිකාව
hymnal=ස්තෝත්‍ර සංග්‍රහය
hymnary=ස්තෝත්‍ර සංග්‍රහය
hymnology=ගීත ස්තෝත්‍ර අධ්‍යයනය
hynothesis=උපන්‍යාසය
hyoid=වයියාභය
hyoscine=විෂ සහිත රසායනයක් | හයොසින්
hyoscyamin=හයොසයමින්
hyoscyamus=හයොසයමස්
hypacousia=හීන ශ්‍රවණතාව
hypacousis=හීන ශ්‍රවණතාව
hypanthodium=ප්‍රාග් උදුම්බරය
hyper=අති
hyper-critical=අතිඅවධි | අතිදෝෂදර්ශක
hyper-market=අති සුපිරි වෙළඳසැල
hyper-sensitive=අධිසංවේදී
hyper-sonic=ශබ්දයේ වේගය මෙන් පස් ගුණයක් වේගයෙන් යන
hyperacusis=සුශ්‍රවණතාව
hyperaesthesia=අතිවින්දනය | අධිසංවේද්‍යුතාව
hyperalgesia=පීඩා අතිවේද්‍යතාව
hyperbola=අතිශයෝක්තිය | අධික කොට කීම | බහුවලය | බහුවලයය
hyperbole=අත්‍යක්තිය | අතිශයෝක්තිය | අධික කොට කීම
hyperbolic=බහුවලයික
hyperboloid=බහුවලයාභය
hyperchimaera=උපරිකිමේරාව
hyperchlorhydria=හයිපර්ක්ලෝහයිඩ්‍රියාව
hyperchromatic=උපරිවර්ණ
hypercomplex=අධිසංකීර්ණ
hyperconjugation=අධිසංයුග්මනය
hypercritical=අතිවිවේචක
hyperdactylism=අත්‍යංගුලිකතාව
hyperdimensional=අධිමාන
hyperemesis=අධිඡර්දිය
hyperemployment=අතිපූර්ණ සේවා නියුක්තිය
hyperesthesia=අතිවින්දනය
hyperfeminization=අතිස්ත්‍රෛණය
hyperfunction=අධිකාර්යය
hypergamy=අනුලෝම විවාහය
hypergeometric=අධිජ්‍යාමිතික
hypergeometry=අධිජ්‍යාමිතිය
hyperglycaemia=අතිමධුරක්තිය
hyperinfiation=අත්‍යද්ධමනය
hyperkinesis=අතිගතිචාරය | අතිචාලනය
hypermasculinization=අතිපුරුෂායනය
hypermetropia=දූරදෘෂ්ටිකත්වය | දූරදෘෂ්ටිකතාව
hypermnesia=අතිමානස්‍යය
hypernephroma=හයිපනෙප්‍රෝමාව
hypernormality=අධිප්‍රමතිය
hyperon=හයිපරෝනය
hyperopia=උපරිදෘෂ්ටිය
hyperparasite=උපරිපරපෝෂිතයා
hyperparasitism=උපරි පරපෝෂිතතාව
hyperphoria=උපරිලාසය
hyperpiesis=අතිමර්දත්වය
hyperpituitarism=අතිපිටියුටරිතාව
hyperplane=අධිතලය
hyperplasia=අතිප්ලාස්මීයතාව
hyperplastic=උපරිහාවී
hyperplasy=උපරිහාවිත්වය
hyperprosexia=අත්‍යවධානය
hyperpyrexia=අධි ජ්වරය
hypersensitive=අධිසංවේදී
hypersensitivity=අධිසංවේදිතාව
hypersonic=අධිධ්වානික
hyperspace=අධ්‍යවකාශය | අධි අවකාශය
hypersphere=අධිගෝලය
hypertension=අධ්‍යාතතිය
hyperthymia=අතිසංක්ෂෝභය
hyperthyrodism=අතිතයිරොයිඩතාව
hyperthyroidism=අධි තයිරොයිඩතාව | අධි ඵරාභතාව
hypertomic=අතිතානක
hypertonia=අතිතානතාව | අතිතානය
hypertonicity=අතිතානතාව | අතිතානය
hypertrophic=අධිවර්ධී
hypertrophy=අතිභරණය | අතිවෘද්ධිය | අධිතර්පණය | අධිවර්ධනය
hypha=දිලීර සූත්‍රිකාව
hyphen=සමාස විහ්නය | හයිපනය
hypnagogic=නිද්‍රෝපායී
hypno-analysis=වශී විශ්ලේෂණය
hypnocyst=නිද්‍රාබීජාණුව | හිප්නොස්පෝරය
hypnogenetic=නිද්‍රාජනක | වශීජනක
hypnogenic=නිද්‍රාජනක | වශීජනක
hypnoidal=වශ්‍යාභ
hypnology=නිද්‍රාවේදය | වශීවේදය
hypnopompic=පශ්චාද්නිද්‍රා
hypnosis=උපක්‍රමයෙන් ඇතිකරන නින්ද | උපක්‍රමයෙන් නිදි ගැන්වීම | මෝහන විද්‍යාව | වශීභාවය | සම්මෝහ නිද්‍රාව
hypnosperm=නිද්‍රාබීජාණුව | හිප්නොස්පෝරය
hypnosporangium=නිද්‍රාබීජාණුධානිය | හිප්නොස්පෝරන්ගිය
hypnospore=නිද්‍රාබීජාණුව | හිප්නොස්පෝරය
hypnotic=නිද්‍රාජනක | මෝහන | වශීකාරක | වශීකෘතය | ස්වාපක | ස්වාප්නක
hypnotise=වශී කරනවා
hypnotism=මෝහනය | වශීකරණය | සම්මෝහනය
hypnotize=උපක්‍රමයෙන් නිදිගන්වනවා | වශී කරනවා | වශීකරණවා
hypoanitmonite=හයිපොඇන්ටිමනයිට්
hypobasal=අධෝපාදී
hypoblast=හයිපොබ්ලාස්ටය
hypoborate=හයිපොබෝරේට්
hypobromite=හයිපොබ්‍රෝමයිට්
hypochlorhydria=හයිපොක් ලෝහයිඩ්‍රියාව
hypochlorite=හයිපොක්ලෝරයිට්
hypochondirum=අධහ් සෘක්තිය
hypochondraic=නලංගු
hypochondria=නලංගුව | රත් පිත් විකාරය | රෝගකාංසාව | රෝගභ්‍රමය
hypochromyl=හිපෝක්‍රෝමිල්
hypocotyl=අධහ්කොටිලය | බීජාධරය
hypocotylar=බීජාධරීය
hypocotyledonary=අධහ්කොටිල
hypocraterimorphous=පීරිසි හැඩ
hypocricy=කුහකකම
hypocrisy=කුහක කම | බක තපස්
hypocrite=ඉච්චාකාරයා | කුහකයා | කෛරාටිකයා
hypocritical=කුහක
hypocycle=උපචක්‍රය
hypocycloid=අන්තශ්චක්‍රාභය | අන්තශ්වක්‍රාභය
hypodermal=අධශ්චර්මීය
hypodermic=අධශ්චර්ම | අධශ්චර්මීය | සිවිය ඇතුළට වදින
hypodermis=අධශ්චර්මය
hypoesthesia=ඌන වින්දනය
hypofunction=අවකාර්යය
hypogaeous=අධෝභෞම
hypogamy=ප්‍රතිලෝම විවාහය
hypogastrium=අධශ්ජඨරය
hypogeal=අධෝභෞම
hypogenic=අධෝභෞම
hypogenous=අධෝජන්‍ය
hypoglycaemia=මන්ද මධු රක්තිය
hypogynous=අධෝජායාංගි
hypogyny=අධෝජායාංගතාව
hypohyll=අධහ්පත්‍රය
hypokinesis=අවචාලනය
hypolithic=අධශ්ශිලා
hypomania=අවෝන්මාදය
hyponastic=අධස්සන්නමන
hyponasty=අධස්සන්නමනය
hyponitrite=හයිපොනයිට්‍රයිට්
hyponym=උපනාමය
hypopasila=ක්ෂීණ වර්ධනය
hypophonia=අවභණ්‍යතාව
hypophoria=අවලාසය
hypophrenia=අවබුද්ධිකතාව
hypophyll=අධරපත්‍රය
hypophyllous=අධහ්පත්‍රි
hypophysial=අධෝවර්ධී | හයිපොපිසීය
hypophysis=අධෝවර්ධය | හයිපොපිසිය
hypopiesis=මන්ද මර්දතාවය
hypopituitarism=මන්ද පිටියුටරිතාව
hypoplastic=ක්ෂීණභවිත
hypoplasy=ක්ෂීණභවිත්වය
hypopleura=අධරප්ලුරාව
hypospadias=අධොව්‍යපනිය
hypostasia=උපස්ථාව
hypostasis=උපභවනය
hypostatisation=උපස්ථාපනය
hypostomatic=අධහ්පුටික
hypostomatous=අධහ්පුටික
hypostomium=අධරය
hypostyle=ටැම්මතු මහල | බුහුටැම් පාය
hypotension=අඩු රුධිර පීඩනය | මන්දාතතිය
hypotenuse=කර්ණය | ත්‍රිකෝණයක කර්ණය | ශ්‍රැතිය
hypothalamus=හයිපොතැලමස
hypothec=අනුඋකස
hypotheca=උපපේටිකාව
hypothecal=උපපේටික
hypothecate=උකස් කරනවා | කැප කොට බැඳීම | යටත් කොට බඳිනවා
hypothecation=උකස් කිරීම
hypothecium=උපසරුපටය
hypothemia=අවාවේගය
hypothermia=ශරීර උෂ්ණත්වය අස්වාභාවිකව අඩුව පැවතීම
hypothesis=උපකල්පිතය | උපන්‍යාසය | කල්පනය | කල්පිතය | තර්කමාත්‍රය
hypothesize=උපන්‍යාස කරනවා
hypothetical=අනුමාන සහිත | උපකල්පිත | උපන්‍යාසී | උපන්‍යාසීය | කල්පිත | මනහ්කල්පිත | සෝපාධික
hypothyroidism=මන්දතයිරොයිඩතාව
hypotism=මෝහනය
hypotonic=උපාභිසාරක | මන්දතානක
hypotonus=මන්දතානය
hypotrochoid=අන්තර්වාර්තුලිකාභය
hypotrophy=අධෝවර්ධනය
hypotype=අපදර්ශය
hypovalva=අධෝකපාටය
hypovalve=අධෝකපාටය
hypsographic=තලාතල
hypsometer=හිප්සොමීටරය
hyptropous=අධෝවර්ධී
hyrogen=හයිඩ්‍රජන්
hyssop=සුවඳැති පැළෑටියක්
hystere-epilepsy=හිස්ටීරියා අපස්මාරය
hysterectomy=ගර්භාෂ විච්ඡේදනය | ජරායු විච්ඡේදනය
hysteresis=මන්දායනය | මන්දාහනය | හිස්ටෙරිසිය
hysteria=කෝල සන්නිය | කෝලසන්නිය | මායා රෝගය | මායාරෝගය | හිස්ටීරියාව
hysterical=වායු ග්‍රස්ත
hysterics=කෝලසන්නිය
hysteroneurasthenia=හිස්ටෙරොනියුරෙස්තීනියාව
