l.f.=අවච සංඛ්‍යාතය
l.f.=අවච සංඛ්‍යාතය
l.p.=දිගු වැයුම්
l.t.=අවශක්මතාව
l/c=ණයවර ලිපි
la=බලව | මෙන්න
lab=නම පටබඳිනවා | පරීක්ෂණාගාරය | ලේබලය | ලේබලය ක් අලවනවා
labarum=ලැබාරු ධජය
label=අඩයාලම | නම් කරනවා | නම් පත | නම් සටහන් කරනවා | ලේබලය | ලේබල් කරන්න
labellum=අධරිකාව
labia=ඖෂ්ඨ | තොල්
labial=තොල් පිළිබඳ වූ | සෂ්ඨජ | සෂ්ඨජාක්ෂරය
labiate=සෂ්ඨාකාරය | සෂ්ඨීය
labile=පරිනම්‍ය | විස්ථායී
labium=අධරය | තොල වැනි අවයවය
lable=නම පටබඳිනවා | ලේබලය | ලේබලයක් අලවනවා
laboratory=පර්යේෂණාගාරය | පරීක්ෂණාගාරය | රසායනාගාරය | ව්‍යවසාගාරය | විද්‍යාගාරය
laborious=අමාරු | උද්‍යෝගී | මහන්සියෙන් කළ යුතු
labour=ආයාසය | කම්කරු | කම්කරු සමූහය | කුලී වැඩ | ප්‍රසව | ප්‍රසව වේදනා විඳිනවා | ප්‍රසව වේදනාව | මහන්සිය | වැඩය | විලි පහරනවා | විලිරුදාව | විලිලනවා | වෙහෙස | වෙහෙසෙනවා | ශ්‍රම | ශ්‍රමය | ශ්‍රමික
laboured=ගොරෝසු | දුෂ්කර
labourer=කම්කරුවා | කුලී වැඩකාරයා | ශ්‍රමිකයා
labourite=කම්කරු පක්ෂයේ සාමාකයා
labrador=සුනඛ විශේෂයක්
labryinth=වංගගිරිය
laburnum=ගසක්
labyrinth=අවුල්ජාලය | අවුල්මග | කනේ කුහරය | නිගහනය | වංකගිරිය | වංගගිරිය
labyrinthiformis=ගහනරූපී
labyrinthine=නොයෙක් අවුල් සහිත | වංකගිරිය වැනි
lac=ලක්ෂය | ලතු | ලාකඩ | ලාක්ෂා
laccase=ලැකේස්
laccine=ලැක්සීන්
lace=ඇමිණෙනවා | ගොතා බඳිනවා | පටි දමා බඳිනවා | රස කාවද්දනවා | රේන්ද | රේන්ද ගෙතුම | රේන්ද පටිය | රේන්දපටිය | රේන්දය | වරපට
lacerate=තැනින් තැන ඉරනවා | තුවාල කරනවා | දුක් දෙනවා
lacerated=ඉරි ගිය
laceration=විදාරණය
lacey=ලේස් වැනි
laches=ප්‍රමත්තය
lachrymal=අශ්‍රැවාහක | කදුළු ගලා එන
lachrymose=කඳුළු උපදවන | කඳුළු වගුරුවන | කඳුළු සහිත
lacing=අමුණුව | ඇමිණීම | වරලෑම
laciniate=කඩතොලු සහිත
laciniform=කඩතොලු සහිත
lack=අඩුපාඩුව | අභාවය | නැතිකම | හිඟය | හිඟව පවතිනවා | හිඟව සිටිනවා
lackadaisical=කිසි උනන්දුවක් නැති
lacking=අඩුලුහුජු | ඌන
lacky=දාසයා | පහත් මෙහෙකරුවා
lacolith=ලාකඩ බඩු
laconic=මිතභාෂි | ලුහුඬු | සංක්ෂිප්ත
laconism=ටිකකින් හුඟක් ඇඟවීම
lacquer=ආලේපය | ඔපදැමීමට යොදන ද්‍රව්‍යය | ඔපදැමීමට යොදන වාර්නිස් | දිය ලාකඩ | ලා | ලාකඩ | ලාක්ෂා | ලැකර් | ලැකර් කරනවා | වලිච්වය
lacquering=ලාක්ෂා කිරීම
lacrimation=අස්‍රැකරණය
lacrimator=අස්‍රැකාරකය
lacrimatory=අස්‍රුකාරකය
lacrosse=පන්දුක්‍රීඩා විශේෂයක්
lactase=ලැක්ටේස්
lactate=කිරි එරෙනවා
lactation=ක්ෂීරණය | කිරි එරීම | කිරි දෙන කාලය
lacteal=ක්ෂීරකය
lactic=කිරි පිළිබඳ වූ | කිරෙන් උපන් | දුග්ධජාත
lacticacid=ක්ෂීරාම්ල
lactifer=ක්ෂීරධරය
lactiferous=ක්ෂීරධර | ක්ෂීරවාහී
lactobacillus=ලැක්ටොබැසිලය
lactoflavine=ලැක්ටෝප්ලේවින්
lactometer=ක්ෂීරමානය | ලැක්ටොමීටරය
lactose=කිරිවල ඇති සීනි | ලැක්ටෝස්
lactucine=ලැක්ටූසීන්
lacuna=ඌනතාව | කුහරය | ඛණ්ඩය | ගර්තය | ගර්තිකාව | රන්ධ්‍රය | ලුප්තභාගය | විවරය | සරසිකාව | හිස් තැන
lacunae=කුහර | විවර
lacunary=ආනර්ථක්‍ය
lacunose=සකූප
lacustrine=වැව්වල වත් වෙන | විල්ලැගි | විල්වල වත් වෙන | විල්වල හටගන්නා
lad=කොල්ලා | ගැටයා | ගැටවරයා
laddening=තර්පණය
ladder=ඉණ | ඉණිපෙත්ත | ඉණිමග | ඉණිමඟ | ඉනිමග | සෝපානය | හිණිපෙත්ත | හිණිමග
laddie=පැංචා
lade=බර පටවනවා
laden=පීඩිත වූ | බර පැටවූ
ladiesfinger=බණ්ඩක්කා
lading=පටවනලද බඩු
ladle=කිණිස්ස | කෙණෙස්ස | කෙනෙස්ස | ලොකු හැන්ද | හැන්දෙන් බෙදනවා
lady=ආර්ය්‍යාව | ආර්යාව | කුමාරිහාමි | කුලස්ත්‍රී | දේවී | නෝනා | මැතිනිය | වංශවත් ස්ත්‍රී | ස්වාමිනී | හාමිනේ | ළමාතැනී | ළමාහාමි
ladylike=විනීත
laesio-fidei=විශ්වාසය බිඳීම
laevo=ලීවො | ලීවෝ | වාමාවර්ත
laevulose=ලීවුලෝස් | ලෙවියුලෝස්
lag=අවුරනවා | ගාටනවා | පමාව | ලැග්ම | විලම්බය | සුනංගු වෙනවා | සුනංගුව | හිරේ දමනවා | හෙමිහිට ගමන් කරනවා
lager=බීර විශේෂයක්
laggard=අලසයා | වැඩ අතපසු කරන්නා
lagging=ඇවිරීම | ඇවුරුම | පමාව | පශ්චාද්ගමනය | විලම්බනය
lagoon=කලපු වෙරළ | කලපුව | කළපුව | සඩය
lags=පමාව | පරතරය
lagynos=ලැගිනෝස් කලස
lah=සංගීතයේ එන ස්වරයක්
laic=ගිහි | ගිහියා
laicise=ලෞකිකභාවයට හරවනවා
laid=ඉවත්කොට තබන ලද | ඔත්පළේ සිටින | වැතිරුණු
laiopathy=ලාලව්‍යථය
lair=තිප්පළ | තිප්පොළ | බිළය | බෙනය | ලෙන | වනමෘගයන්ගේ ගුහාව
laissez-faire=නිර්බාධ ක්‍රමය | නිර්බාධය | රාජ්‍ය නිර්බාධ
laitance=උඩුමණ්ඩි
laity=ගිහි පක්ෂය | ගිහි පිරිස | ගිහිකම | ගිහියෝ | ගෘහස්ථ සමූහය
lake=එරුණුහස් | තටාකය | තළා | තළාකය | බාධක විල | ලාක්ෂකය | ලේක් වර්ණය | වැව | විල | විල්
lakh=ලක්ෂය
laksmi=සිරිකත
lalling=ලලායනය
lalophobia=ලාලන භීතිකාව
lalorrhea=ලාලරීතය
lam=තඩි බානවා
lama=ටිබෙට් භික්ෂුව | ලාමා
lamaism=ලාමා ධර්මය | ලාමාවාදය
lamarckism=ලැමාක් වාදය
lamarekism=ලැමාක් වාදය
lamaseral=ලාමාවරුන්ගේ විහාරය
lamasery=ලාමාවරුන්ගේ විහාරය
lamb=පැටියා | බැටළු පැටවා | බැටළුපැටවුන් වදනවා | බැටළුපැටියන්ගේ මස්
lambaste=තළනවා | පහර දෙනවා
lambdagram=ලැම්ඩාරේඛය
lambent=වැනෙන | සෞම්‍ය ප්‍රභා ඇති
lambert=ලැම්බටය
lambkin=කුඩා බැටළුපැටියා
lame=අබ්බාගාත | ඒත්තු නොයන | කොර | කොර කරනවා | නොණ්ඩි | බකල | රොට්ටි | සිත් නොගන්නා | සොකර ගහනවා
lamella=තැල්ල | ලැමලාව | ශරාවකය | සුස්තරය | සූස්තරය
lamellar=ආස්තීර්ණ | සුස්තර
lamellate=සුස්තරීය
lamelliform=සුස්තරීය
lamellose=සුස්තරීය
lameness=කොරය
lament=තැවෙනවා | පැලපෙනවා | වලපිනවා | වැලපීම | වැලපෙනවා | වැහැසෙනවා | විලාප ගහනවා | විලාපය | ශෝකගීතය | ළතෝනිදෙනවා | ළතෝනිය
lamentable=කනගාටුදායක | බරපතළ | ශෝචනීය
lamentation=අදෝනාව | අඳෝනාව | ලතෝනිය | වලප | විලාපය | ශෝකාලාපය | ළතෝනිය
lamented=ශෝවත
lamina=ආස්තරය | කොරපොත්ත | තලය | තුනී තහඩුව | පටලය | පත්‍ර තලය | පපටිකාව | ලැමිනා | ශරාව | ස්තරය | සිවිය
laminar=ඉතා තුනී තහඩු සහිත
laminate=තුනී තහඩු යොදනවා | තුනී තහඩු සාදනවා
laminated=ආස්තරණය කළ | ආස්තෘත | ස්තරීය
lamination=ආස්තරණය | පපටිකායනය
lamineted=ආස්තරණය කළ
laminose=ආස්තරණය කළ
lamp=කුප්පිය | දීපය | පහන | ප්‍රදීප | ප්‍රදීපය | ප්‍රදීපිකාව | පාන | පාන් | මිතුරු | ලාම්පුව | වැට
lamp-black=පහන් දැළි
lampblack=පහන් දැලි
lampdomancy=පහන්සිළු පේනය
lamphole=පහන් කවුළුව
lampoon=නින්දා ලේඛය | නින්දාලාපය | ලිපි මඟින් පහර ගහනවා
lampooner=ලිපි මඟින් පහර ගසන්නා
lampoonist=ලිපි මඟින් පහර ගසන්නා
lamprey=ආඳා වැනි මත්ස්‍යයෙක්
lanate=සලෝම
lance=ලංසය | ලන්සය | සොටිය | හෙල්ලය | හෙල්ලයකින් අනිනවා
lance-ovate=ලන්සාණ්ඩාකාර
lanceolate=ලන්සාකාර | ශල්‍යාශ්‍ර
lancer=ශල්‍යධරයා
lancet=ශලාකාව
lancewood=ලාන්ස් දැව
land=ඉඩකඩම් | ඉඩම | ඉඩම් | ගොඩ | ගොඩ බසිනවා | ගොඩ බහිනවා | ගොඩ බානවා | ගොඩට ගන්නවා | ගොඩබිම | ගොඩලනවා | දිනාගන්නවා | දේශය | පස | පැමිණෙනවා | පොළොව | බිමට බසිනවා | භූමිය | රට | වතුපිටි | ස්ථල | ස්ථාන
land-grant=ගම්වරය
landau=රෝද හතරකින් යුත් රථවර්ගයක්
landed=ඉඩම් හිමි | ඉඩම්වලින් යුත්
lander=නැවතුම් දැරුම
landes=ලෑන්ඩ් තණ බිම්
landing=අවතාරය | ගොඩට බැසීම | බසින තැන | බිමට බැසීම
landlady=ගැහැවිනිය | ගෙවල් හිමිකාරිය
landless=ඉඩම් නැති
landlocked=ඉඩම්වලින් වට වූ
landlord=ඉඩම් හිමියා | ගැහවියා | ගෙවල් හිමියා | තානායම අයිතිකාරයා | නැවතුම් පොල අයිතිකාරයා
landman=මූදේ ගමන් නොකළ තැනැත්තා
landmark=ඉම්ගල | ප්‍රමුඛස්ථානය | බිම් සලකුණ | මංසලකුණ | මාඉම් ගල | මායිම් ලකුණ | මායිම්ගල | සන්ධිස්ථානය | සලකුණු කරනවා
landmarking=මායිම්ගල් පිහිටුවීම
landmine=බිම් බෝම්බය
landscape=භූ දර්ශනය | භූදර්ශනය
landslip=නායයෑම
landsman=මූදේ ගමන් නොකළ තැනැත්තා
lane=දෙවටය | පටු පාර | මුඩුක්කුව | වීථිය
language=අදහස් දැක්වීමේ ක්‍රමය | කථා ව්‍යවහාරය | බස | බහ | බාසාව | භාෂා | භාෂාව | භාෂිතය | වචනය | වාච
languid=උනන්දු නැති | කුසීත | දුර්වල | මලානික | සෙමින් යන
languish=දුර්වල වෙනවා | නිකරුණේ කල් ගෙවනවා | මැලවෙනවා
languishing=ක්‍රමයෙන් බෙලහීන වන | සැනසිල්ලක් බලාපාරොත්තුවෙන් සිටින
languor=අලසබව | මලානිකකම
languorous=අලස
lank=හීන්දෑරි
lanky=උස
lanolin=බැටළු ලොමින් ලබාගත් තෙල් වර්ගයක් | ලැනොලින්
lanoline=බැටළු ලොමින් ලබාගත් තෙල් වර්ගයක්
lantern=ගමන් පහන | ලන්තෑරුම
lantern-slide=චිත්‍ර කදාව
lanthanons=ලැන්තනන
lanthanum=ලැන්තනම් | ලැන්තනම් නැමැති මූලද්‍රව්‍යය
lanthorn=ගමන් පහන | ලන්තෑරුම
lanuginose=සරෝම
lanyard=නළා ලණුව
lao-song=ලාඹ් සොං
laocoon=ලෙයොකෝඔන් | ලෙයොකෝඔන් ප්‍රතිමාව
laodicean=ආගමික උද්‍යෝගයක් නැති | දේශපාලන උද්‍යෝගයක් නැති
lap=අතිවැස්ම | ඇකය | ඉකිළිය | උකුළ | උකුළු | ඔඩොක්කුව | ඔතනවා | දරය | නිතඹ | මූට්ටුකඩ | ලෙවකා බොනවා | වටපොට | සෙමින් රළ ගොඩවදිනවා
lapel=කබා පටිය
lapidary=මැණික් කපන්නා
lapidation=ගල් ගසා මැරීම
lapies=ලපියේස්
lapilli=ලාවා කැට
laplacian=ලාප්ලාසීය
lapp=ලැප්ලන්ත ජාතිකයා
lappet=බුරුල්ව එල්ලෙන සම
lapping=ලෙව කෑම | ලෙවගෑම
lapps=ලැප්වරු
lapse=අත්වැරැද්ද | අපගමනය | අභාවටය යනවා | අභාවිත වෙනවා | අවලංගු වීම | අවලංගු වෙනවා | ආගමනය වෙනවා | ඉක්ම යනවා | ඉකුත්වී යනවා | ඉකුත්වීම | ගෙවී යනවා | ගෙවීයාම | දෝෂය | පහවී යනවා | ප්‍රමාද දෝෂය | ප්‍රමාදය
lapse-rate=පතන ශීඝ්‍රතාව
lapwing=කරළා | පක්ෂියෙක්
larboard=නැවේ වම් පැත්ත
larcency=සොරකම
larceny=ලාසනිය
larch=ලාර්ච් ගස
lard=ඌරු තෙල් | ඌරුතෙල් | ඌරුතෙල් ගානවා | සූකර මේද
larder=ආහාර ගබඩාව
lardy=ඌරුතෙල් වැනි
large=අලි | උරු | ඌරු | ගජ | ගොර | තඩි | තුමුල | තුල් | තූල | දොන්ත | නැබළ | පත | පතර | පීවර | පුවළ | පුළුල් | පෘථුල | බංගසාල | භූරි | මහ | මහත් | මාපට | රුදුරු | ලූ | ලොකු | වසල් | විපුල | විශාල | විසල් | විහිඟුම් | වෘහත්
largely=නොමඳින් | බොහෝ දුරට
largeness=විශාලත්වය | වෛපුල්‍යය
largo=සෙමින් උදාර සේ වාදනය කළයුතු සංගීත කොටස
lariat=තොණ්ඩුව සහිත කඹය
lark=විහිළු කරනවා | විහිළු තහළුවෙහි යෙදෙනවා | විහිළුව | සෙල්ලම
larkspur=ලාඩමක් මෙන් පුෂ්පගර්භයක් ඇති ශාකයක්
larva=කීටයා | දළඹුවා | පිළවා
larvae=දළඹුවෝ | පිළවු
larval=පිළවු අවස්ථාවෙහි වූ
laryngitis=බ්‍රැණ්ඩිය | ස්වරාලදාහය
laryngopharynx=කෘකගසනික
laryngoscope=ස්වරාලේක්ෂය
larynx=උගුරෙහි ඉහළ කොටස | ඌර්ද්ධ්වකණ්ඨය | ගලනාලය | ස්වරාලය
lasagne=ආහාරයක්
lascar=ලස්කිරිඤ්ඤ
lascaux=ලස්කෝ
lascivious=කාමුක
lasciviousness=කාමතෘෂ්ණාව | සල්ලාලකම
laser=ලේසර | ලේසරය | ලේසර් කිරණ
lash=ඇනුම්පද කියනවා | ඇනුම්පදය | ඇහිපිහාට්ට | කස පටිය | කස පහර | කසපහර | කසය | කසෙන් පහර දෙනවා | කෝටු මස් කරනවා | තදින් බැඳ තබනවා
lashes=කස පහර
lashing=කසෙන් තැළීම | බැඳීමට යොදන කඹය | විශාල ප්‍රමාණයක්
lass=කන්‍යාව | කෙල්ල | ගැටිස්සී
lassie=පැටික්කී
lassitude=ක්ලාන්තය | ගිලන්බව | ප්‍රමීලය | මහන්සිය
lasso=මන්ද | මලපුඩු අටවනවා
last=අග | අන්ත | අන්තිම | අන්තිම වසයෙන් | අන්තිමට | අන්තිමයා | අවසාන | අවසානය | ඉතා මෑත | ඉතා මෑත වචනය | ඉතුරු වෙනවා | ඉස්තරම් | ඊයේ | උත්තර | නොනැසී පවතිනවා | පශ්වම | පසුගිය | සපත්තු සාදන අච්චුව | සෑහෙනවා
last-in-first-out=අපිමුනි | අවසානයේ පිවිසෙන මුලින් නික්මෙන
lasting=කල් පවත්නා | නිත්‍ය | ස්ථීර
lastly=අන්තිම වශයෙන්
latch=අගුල | අගුළු ලනවා | තරංකය | දොර කොක්ක
latchet=සපත්තුවට යොදන පටිය
late=අවසාන භාගයෙහි වූ | අවසාන භාගයේදී | නැසීගිය | නොබෝදා සිඬ වූ | පරක්කු | පරක්කු වී | ප්‍රපඤ්ච | ප්‍රමාද | ප්‍රමාද වූ | ප්‍රමාදව | පෙර | බොහෝ කල් ඉක්මගිය | බෝවන තුරු | මතු | විලම්බීත | සුනංගු
lateen=මුහුදු ගමන්වලදී භාවිත කරන දිශාවක්
lately=අලුත | නැතකින් | මෑතදී
latency=අන්තර්හිතතාව | අනුශයිකය | අනුශයිකාන්තරය | ආනුශයිකය | ගුපතතාව | ගුප්තතාව | නොපෙනී පැවතීම
lateness=ප්‍රමාදය | ප්‍රමාදීභාවය
latent=අන්තර්හිත | අනුශය | අප්‍රකට | ආනුශයික | ගුප්ත | නිගූඩ | නිලීන | නෛසර්ගික | ප්‍රච්ඡන්න
later=අවර | පසුව | පහු | පැසුළු
lateral=අංශයට අයිති | ආංශික | ඉන් පැනනැගුණු | පාර්ශ්වික | පාර්ශ්වීය | පැත්තට අයිති | පැත්තෙහි වූ | පැති | වාර්ශ්වික
laterisation=ලැටරයිට් වීම | ලැටරිකරණය
laterite=කබුක් | කබොක් | පණුගල් | ලැටරයිට් | ලැටරයීට්
lateritic=ලැටරිටීක
lateritisation=කබුක්වීම
latest=අබිනව | අලුත්ම | ඉතා අලුත් | නවතම | නව්‍ය
latex=ආක්ෂීරය | ක්ෂීරය | කිරි | ගස්වල කිරි
lath=තීරුව | තුනී ලී පටිය | මිනුම් පතුර | රීප්පය
lathe=කුඹල් චක්‍රය | පට්ටලය | භ්‍රමිය | ලියන කඳ | ලියන පට්ටලය | ලියවන පට්ටලය | ලේ යත | ලේයත | වළන් සාදන්නාගේ රෝදය
lather=සබන් පෙණ | සබන් පෙන | හොඳටම ගහනවා
lathyrism=ලැතිරියාව
latice=ලීස්තරය
laticifer=ක්ෂීරධරය
laticiferous=ක්ෂීරධර
latifoliate=පෘථුල පත්‍රීය
latifolious=පෘථුල පත්‍රීය
latin=ලතින් භාෂාව
latinate=ලතින් භාෂාවට සම්බන්ධ | ලතින් භාෂාවට සමීප
latish=පරක්කු වුණ | ප්‍රමාද වුණ
latitude=අක්ෂය | අක්ෂාංශ | අක්ෂාංශකය | අක්ෂාංශය | ආයාමය | ඉඩ | දේශාංශය | නිදහස | ප්‍රමාණය | රේඛාන්තරය | විෂය
latitudinarian=නිදහස් මත දරන්නා | පුළුල්ව සිතන්නා
latitudinarianism=අක්ෂාංශකවාදය
latrine=වැසිකිළිය
latter=අපර | අපරෝක්ත | පසුව පැමිණෙන | පසුව සඳහන් කළ | මෑත | හංකඩ
latterly=මෑතදී
lattice=ගරාදි | ගරාදි වැට | ගරාදිය | ජලිස් | දැලිස | දැලිස් | සම්බන්ධතා ජාලය
latticed=ගරාදි ගසන ලද
lattices=දැලිස්
latticing=දැලිස් ලෑම
lattitude=අක්ෂාංශය
laud=ගුණකීර්තනය | ප්‍රශංසා කරනවා | ප්‍රශංසාව | වර්ණනාව
laudable=ප්‍රශංසනීය
laudanum=අබින් මද්‍යසාරයෙන් දියකොට තනාගත් ද්‍රව්‍යයක් | ලෞඩනම්
laudation=ප්‍රශංසා කිරීම
laudatiry=ප්‍රශංසාත්මක
laugh=සිනහව | හාස්‍යය
laughable=විහිළු | හාස්‍යජනක
laughing=සිනහවන | සෙමින්
laughter=ප්‍රහසනය | ප්‍රහාසය | වහස | සිනහව | හාසය | හාස්‍යය
launch=දියත් කරනවා | පතුරවනවා | විහිදුවනවා
launder=දෙණ | රෙදි අපුල්ලා මදිනවා
launderette=කාසි යොදා රෙදි සෝදාගත හැකි රෙදි සෝදන
laundress=රෙදි නැන්දා
laundries=රජකස්ථාන | ලොන්ඩරි
laundry=ඇපුල්ලුම් පොළ | ඇපුල්ලූ රෙදිපිළි
laundryman=රජකයා
laureate=පටබැඳි | සම්මානනීය
laurel=කිතුලතාව | ජයපත්‍රය | යශෝමාලාව | ලෝරල
lava=මුහුදු ලාවා | ලාවා | ලෝදිය
lavage=ධොවනය
lavaory=දියගේ
lavatory=අතපය සෝදාගන්නා ස්ථානය | කක්කුස්සිය | කක්කුසිය | නාන කාමරය | වැසිකිළි | වැසිකිළිය
lave=සෝදනවා
lavender=සුවඳ පැල ජාතියක්
lavish=අධික ලෙස දෙනවා | අධික ලෙස යොදනවා | අධික ලෙස වියදම් කරන | අපතේ හරිනවා
lavishly=අත දිගහැර | අත පුරා | අධික ලෙස | නිර්ලෝභීව
lavitation=අහසින් ගමන් කිරීමේ බලය | අහසෙහි නැවතී සිටීමේ බලය
law=තන්ත්‍රය | දහම | ධර්මය | නය | න්‍යාය | නියමය | නියාමය | නී | නීතිය | ප්‍රඥප්තිය | රෙකුලාසිය | ලවේ රටාව | ව්‍යවස්ථාව | ව්‍යවහාර විධිය | ව්‍යවහාරය | විධිය | වෝහාරය | සුතුර | සූත්‍ර
law-abiding=නීතිගරුක
law-breaker=නීතිය කඩ කරන්නා
lawful=නීත්‍යනුකූල | යුක්තියුක්ත
lawgiver=නීති සම්පාදකයා | නීතිදායක
lawless=දාමරික | නීතිභ්‍රෂ්ට | නොපනත්
lawlessness=නීතිභ්‍රෂ්ටතාව | නොපනත්කම
lawn=තණකොළ සහිත පිට්ටනිය
lawning=හැළීම
lawrencium=මූල ද්‍රව්‍යයක්
laws=නීති
lawsuit=නඩුව
lawyer=නීතිඥ | නීතිඥයා | නීතිවේදියා
lax=අනාචාරයට නැමුණු | අනියම් | අස්ථීර | තද නැති | නොසැලකිලිවන්ත | බුරුල් | ලිහිල්
laxative=ආරේචකය | විරේචක | විරේචන ඖෂධය
laxity=තද නැති බව | බුරුල
laxmi=සිරියාව
laxness=තද නැති බව | බුරුල
lay=අගාරික | අතුරනවා | කාව්‍යය | ගිහි | ගීතය | ගෘහස්ථ | තබනවා | තැන්පත් කරනවා | දඟය | දමනවා | දිගා කරනවා | නැති කරනවා | නියම කරනවා | නෝනා | පනවනවා | යොදනවා | ලනවා | ලෑම | සංසිඳුවනවා | හොවනවා
lay-by=මං රඳාව
lay-figure=ආදර්ශ රූපය
lay-in=ඒකවර්ණ න්‍යාසය
layaside=අත්හරිනවා | පසෙක තබනවා
layer=තට්ටුව | පටලය | බිජු දමන කිකිළී | ස්තරය
layerage=අතු බැඳීම
layering=අතු බැඳීම
layette=ළදරු ඇඳුම් පැළඳුම් කට්ටලය
layman=ආධුනිකයා | ගිහියා
layout=පිරිසැලසුම | පිරිසැලැස්ම | වින්‍යාස | වින්‍යාස සැළැස්ම | සැලැස්ම
lazar=පරංගි රෝගියා
lazaretto=ලාදුරු නිවාසය | ලාදුරු රෝහල
laze=අලසකමින් කල්ගෙවනවා | කම්මැලිව සිටිනවා
laziness=ආලස්‍යය | කම්මැලිකම | කම්මැළිකම | කලකම්මැළිකම | ලස
lazy=අලස | ආලිස්සම් | ආලෙස්සම් | උදාසීන | කම්මැලි | කම්මැළි | කලකම්මැළි | කුසීත | මැළි | සෝමාරි
lazy-bones=අලසයා
lb.=රාත්තල
lck=නැතිකම
lcotype=ප්‍රතිදර්ශය
lea=තණබිම | පිට්ටනිය | ලියාව
leach=ක්ෂය වෙනවා | ක්ෂරණය වීම | ක්ෂීරණය | කූඩැල්ලා
leaching=ක්ෂරණය | ක්ෂරණය වීම | ක්ෂීරණය වීම | නිස්සාරණය
leachy=ක්ෂීරණය වූ
lead=අතින් අල්ලාගෙන යනවා | අදිපතිකම | ආදර්ශය | ඊයම් | කැඳවාගෙන යනවා | ගෙන දෙනවා | දක්කනවා | නායකය | නියමුවනවා | පටන්ගන්නවා | ප්‍රධාන | ප්‍රධානත්වය | ප්‍රධානව සිටිනවා | පාලනය කරනවා | පැන්සල්වල යොදන මිනිරන් | පෙරටුව යනවා | පෙරටුවෝ | බර | මග පෙන්වන | මඟ පෙන්වනවා | මඟපෙන්වීම | මුඛ්‍ය භූමිකාව | මුල | මුලින් සිටිනවා | මූලකත්වය | මෙහෙයවනවා | ලෙඩ් | විනායකය | විශාල විදුලි කම්ිබිය | සලස්වනවා
lead-weight=ඊයම්බරුව
leaded=ඊයම් ගාන ලද
leaden=ඊයම් පාටට හුරු | ඊයම් වලින් තැනූ | ඊයම් වැනි | උනන්දුවක් නැති | දීප්තියක් නැති | බර
leader=ඉදිරියෙන් යන්නා | ණය දායකයා | ණය දෙන්නා | නායක | නායකයා | නායිකාව | නියමුවා | නේතෘ | ප්‍රමුඛයා | පුරෝගාමියා | මුදුනා | මූලිකයා | ලොක්කා | විනේතෘ
leaderette=උප කර්තෘවාක්‍යය
leaders=නායක
leadership=නායකත්වය | ප්‍රධානත්වය
leading=ආදර්ශය | උගත් මිනිස්සු | ප්‍රමුඛ
leadline=බරුයොත
leads=නායක | නියමු | මං කම්බි | මංකම්බි | හාරක
leaf=ඉතා තුනී තහඩුව | කොළ | කොළය | දල | පත | පත් ඉරුව | පත්ඉරුව | පත්‍රය | පර්ණ | පල්ල | සම්මුඛ
leafing=දළු ලෑම
leafless=විදල්
leaflet=පත්කඩය | පත්‍රිකාව
leafy=කොළවලින් ගැවසි | පත්‍ර සහිත | පත්‍රීය | සෙවණ ඇති
league=එක්සත් මණ්ඩලය | ගවුව | ගිවිසුම | සම්බන්ධය | සාමග්ගිය
leak=කාන්දු | කාන්දු වීම | කාන්දු වෙනවා | කාන්දුව | පැල්ම | පිට වෙනවා | වෑහෙනවා
leakage=කාන්දු වන ප්‍රමාණය | කාන්දු වීම | කාන්දුව | පිටමං වීම | පිටවීම | වෑස්සීම
leakance=කාන්දුතාව
leaking=සිදුරු සහිත
leaky=සිදුරු සහිත
leal=පක්ෂපාත | ස්ථීර
lean=අගහිඟ ඇති | ඇල වෙනවා | කැහැටු | කෘශ | කෙට්ටු | කෙසඟ | කේඩෑරි | කේඳෑරී | තනු | තුනී | නැමෙනවා | වහළ | වහළු | වැඩි ලාභයක් නොලැබෙන | වෑරුණු | සිඟු | සිහින් | සීන් | හීන්දෑරි | හේත්තු කරනවා | හේත්තු වෙනවා
leaning=කැමැත්ත | හුලහට | හේත්තුව
leap=පනිනවා | පැන පැන යනවා
learn=ඉගෙන ගන්නවා | ඉගෙනගන්නවා | ඉගෙනීම | දැනගන්නවා | හදාරනවා
learned=උගත් | උගතුන්ට විෂය වූ | ඡේක | ධර | ධරයා | පණ්ඩිත | බහුශ්‍රැත | බුහුසූ | රාත්‍රඥ | වක්තෘ | ව්‍යක්ත | විද්‍යාධරයා | විදු | විදු දන | ශ්‍රුත | ශාස්ත්‍රවන්ත | සුමුඛ | සුමුව | සුමේධ | හසළ
learner=ආධුනික | ආධුනිකයා | දුහුනා | පුහුණු වන්නා
learning=අධ්‍යයනය | ඉගෙනීම | ඉගෙනුම | උගත්කම | උද්ග්‍රහණය | ග්‍රහණය | පාණ්ඩිත්‍යය | විද්‍යාව | ශ්‍රුත | ශාස්ත්‍ර | ශාස්ත්‍රෝද්ග්‍රහණය | ශික්ෂාව
learnt=හදාළ
lease=කල් බද්ද | කල්බද්ද | බද්ද | බදු දෙනවා
lease-lend=කල් බදු ණය
leasehold=බදු අයිතිය | බදු ඉඩම | බදුකරය
leash=රැහැණ | රැහැන
leasing=ලීස් දැමීම | සීරු දැමීම
least=අඩුතම | අඩුවෙන්ම | ඉතා අඩු | ඉතා අඩු ප්‍රමාණය | ඉතා අඩුවෙන් | ඉතා සුළු
leat=දිය පාර
leather=තැළිසම | පදම් කළ හම | හම්
leathercloth=සම් රෙද්ද
leatherette=කෘත්‍රිම හම්
leathers=ඇහුරුම් හම්
leathery=චර්මල
leave=අත්අරිනවා | අත්හරිනවා | අත්හැර යනවා | අවසර | අවසරය | අස් වෙනවා | අහක් වෙනවා | ඉඩ අරිනවා | ඉතිරි කරනවා | ඉතිරි කොට යනවා | ඉවත්ව යනවා | උරුමකොට දෙනවා | තබනවා | තබා යනවා | නවතා යනවා | නිවාඩුව | නොගෙන තිබෙද්දී යනවා | පිටත් වෙනවා | පිටවීම | පිටවෙනවා | භාර කරනවා | භාර දෙනවා | සමුගන්නවා | සමුගැනීම
leaved=කොළ | පලු | බෑ ඇති
leaven=මුහුන්
leaves=පලා
leaving=පරිවෘත්තිය | යාම
leavings=ඉඳුල්
leavorotatory=වාමාවර්ත
lebensphilosophie=විත දර්ශනය
lebensraum=පියස්ස
lecher=සල්ලාලයා
lecherous=කාමුක | සල්ලාල
lechery=සල්ලාලකම
lecithin=ලෙසිතින්
lectern=ධර්මාසනය
lecthin=ලෙසිතින්
lectionary=දේවස්ථානයේ කියවන ශුද්ධ ලියවිල්ලේ කොටස්
lectoallotype=වෘතාපරදර්ශය
lectotype=වෘතදර්ශය
lecture=අවවාදය | තරවටුව | දේශනය | දේශනා කරනවා | දේශනාව | පාඩම
lecturer=කථිකයා | කථිකාචාර්යයා | කථිකාචාර්යවරයා | දේශකයා
lecturership=කථිකාචාර්ය තනතුර
ledge=අඩය | අයින | ගැටිය | පටු රාක්කය | පතුල් ගල | පිළ | ලීස්තරය | වාසාවකාශය
ledger=ලැජරය | ලෙජරය
lee=නැවේ වම් පැත්ත | මුවාව
lee-ward=පටිවාත
leech=අනුකම්පා නැත්තා | කූඩැල්ලා | පුහුඩාවා | පූඩාව | පූඩාවා | පූඩැල්ලා
leek=ලීක්ස්
leeks=ලීක්ස්
leer=ඊර්ෂ්‍යාකාරී බැල්ම | ඊර්ෂ්‍යාවෙන් බලනවා | කාමුක වශයෙන් ඇසකොණින් බලා විරිත්තනවා | කාමුක වශයෙන් ඇසකොණින් බලා විරිත්තීම | යටැස
leeringly=යටැසින්
lees=බොර | මණ්ඩි
leeward=සුළං මුව | සුළං මුවා වූ දෙසට
leewardly=සුළඟට මුවා වූ දෙසටපෙරළෙන්නට යන
leeway=පිරිමැසිය යුතු පාඩුව
left=අස්ත | නිෂ්ක්‍රාන්ත | නුහුර | වං | වම | වමට | වමත | වම් | වාම
left-centre=වාම කක්ෂාව
left-handed=වමත්
left-handedness=වමත් හුරුව
left-over=හිඳුල්
leftism=අන්තවාදී සමාජවාදය
leftist=වාමාංශයට අයත් | වාමාංශික
leftmost=වමට බර වූ
leftward=වම් දිශාවට වූ
lefty=වාමාංශිකයා
leg=අඬුව | ඇවිදිනවා | කකුල | කකුල | ගාතය | දුවනවා | පාදය
legacy=උරුමය | තෙස්තමේනතු දායාදය | බූදලය | ලෙගසිය
legal=අන්තිම කැමැත්තකින් පැවරීම | නියම | නීත්‍යනුකූල | නීත්‍යානුකූල | නීති | නීතික | නීතිඥ | නීතිප්‍රකාර වූ | නීතිමය | නීතිය පිළිබඳ වූ | නෛතික | යුතු | රික්ථවරණය කරනවා
legalise=නීත්‍යනුකූල කරනවා | නීතිගත කරනවා
legalism=නීතිගරුකත්වය
legality=නිත්‍යානුකූලතාව | නීත්‍යනුකූලතාව | නීතිකත්වය | නීතිකත්වය නීත්‍යානුකූලතාව | නීතියට එකඟ බව | නෛතිකත්වය
legally=නීත්‍යනුකූලව | නීතික ව
legalze=නීත්‍යනුකූල කරනවා
legate=නියෝජිතයා | පාප් නියෝජිතයා
legatee=උරුමක්කාරයා | බූදලයක් ලැබූ තැනැත්තා | ලෙගසිලාභියා
legation=තානාපති කාර්‍යාලය | තානාපති නිවස්නය
legend=අද්භූත කථාව | ආඛ්‍යානය | ආඛ්‍යායිකාව | ආදර්ශ පාඨය | උපාඛ්‍යානය | කාසියක සඳහන් පාඨය | ජනප්‍රවාදය | ප්‍රබන්ධය | පුරාණ කථාව | පුරාවෘත්තය | මිථ්‍යා කථාව | වෘත්තාන්තය
legendary=කල්පිත | ජනප්‍රවාදගත | පුරාවෘත්තයන්හි සඳහන් වූ | පෞරාණික | මිථ්‍යා
legerdemain=ඇස් බැන්දුම | විජ්ජාව
leggy=දික් කකුල් ඇති
leghorn=කුකුළු වර්ගයක්
legibility=කියවියහැකි බව | පහසුවෙන් කියවිය හැකිවීම
legible=කියවීමට පැහැදිලි
legibly=කියවිය හැකි ලෙස
leging=කකුල් වැස්ම
legion=මහා හමුදාව
legionary=භටයා | යුද්ධ සේනාවකට අයත්
legislate=නීති පනවනවා | නීතිගත කරනවා | ව්‍යවස්ථා සපයනවා
legislation=නීති කරණය | නීති පද්ධතිය | නීති පැනවීම | නීති සම්පාදනය | නීතිකරණය | ව්‍යවස්ථා සම්පාදනය | ව්‍යවස්ථාදානය | ව්‍යවස්ථාපිත නීති සංහිතාව
legislative=නීති සම්පාදක | නීතිකාරක | ව්‍යවස්ථාදායක
legislator=නීති සම්පාදකයා
legislature=නීතිකාරකය | ව්‍යවස්ථාදායකය
legit=ලෙටය
legitimate=ඖරස | තර්කයට එකඟ | නියම | නීත්‍යනුකූල | යුක්තියුක්ත | යුක්තිසහගත | යුතු | ශාස්ත්‍රසම්මත | සුජාත | සුජාතක | සුදුසු
legitimation=සුජාතකරණය
legitimatize=නීත්‍යානුකූලබවට පමුණුවනවා
legitimise=සුජාත කරනවා
legitimization=සුජාතකරණය
legitimize=නීත්‍යානුකූලබවට පමුණුවනවා
legorrhoa=වාක්‍රීතිය
legorrhoea=වාක්‍රීතිය
legume=රනිල | රනිලය
legumen=ලෙගුමින්
legumin=ලෙගුයුමින්
leguminous=රනිල
lei=මල්මාලාව
leiotrichi=ලයියෝට්‍රිකයි
leishmaniasis=ලිශ්මේනියාව
leisure=ඉඩ | ඉඩකඩ | ඉස්පාසුව | පාට්ටුව | විවේක කාලය | විවේකය | විශ්‍රාන්තිය
leisured=ප්‍රමාණවත් විවේකය ඇති
leisurely=කලබලයක් නැති | පාඩුවේ | විවේකීව | හෙමින්
leitmotiv=එකම මාතෘකාව වටා බැඳුණ ගී සරණිය
leizure=අවකාශය
lembago=කටී වාතය
leme=සුණු
lemma=අභිගතය | අවපත්‍රිකාව | ආදර්ශ පාඨය | උපසාධ්‍යය | සරු තුෂය
lemming=ලෑටිගාන කුඩා සතෙක්
lemniscate=දෙපෙති ප්‍රස්තාරය | දෙපෙතිය
lemon=දෙහි | රට දෙහි | ලෙමන්
lemon-coloured=රටදෙහි පාට
lemonade=දෙහි පොන්සා
lemple=කපෝලය
lemur=උණහපුළුවා | ලීමර්
lemuria=ලෙමුරියා
lencocyte=සුදු රුධිරාණුව
lend=කුලියට දෙනවා | ණයට දෙනවා | තාවකාලිකව දෙනවා
lender=ණය දෙන්නා | ණයදායකයා | ණයහිමියා
lending=ණය දෙන
lending-institution=ණය දෙන ආයතන
length=ආයාමය | කාල ප්‍රමාණය | දි ග | දිග | දුර
lengthen=දික් කරනවා | දික් වෙනවා
lengthy=දිගටි
lenience=අනුකම්පාව | මෘදු බව | මොළොක් බව
leniency=අනුකම්පාව | මෘදු බව | මොළොක් බව | ලිහිල් බව
lenient=අනුකම්පා සහිත | තදබල නොවූ | මෘදු | මොළොක්
leninism=ලෙනින්වාදය
leninist=ලෙනින්වාදියා
lenity=අනුකම්පාව | මෘදු බව | මොළොක් බව
lens=කාචය | කොරොස්ම කාලය
lent=කොරොස්ම කාලය
lente=අතුරිත | ලෙන්ටෙ
lenten=කොරොස්ම කාලය පිළිබඳ වූ
lenticel=වාසිදුර
lenticular=කාචාකාර
lentil=කරල් බෝග | මයිසූර් පරිප්පු
lento=ඉතා සෙමින්
leo=සිංහ | සිංහ රාශිය
leonine=සිංහාකාර
leopard=කොටියා | දිවියා
leopardess=දිවි දෙන
leotard=නැටීම පිණිස අඳින ඇඟට තදවන ඇඳුමක්
leper=ලාදුරු රෝගියා
lepidodendroid=ලෙපිඩොඩෙන්ඩ්‍රෝනීය
lepidolite=ලෙපිඩොලයිට්
lepidopterophilus=පතංගකාමී
lepidospermae=ලෙපිඩොස්පෙර්මේ
lepidostroboid=ලෙපිඩොස්ට්‍රෝබීය
leprachaun=අයර්ලන්ත ජනප්‍රවාදයේ එන දේවතාවෙක්
leprosy=ලාදුරු | ලාදුරු රෝගය
leprous=ලාදුරු රෝගය ඇති
leptocentric=උභය ශෛලමීය
leptofrom=ලෙප්ටොරූපී
leptokurtic=කූටවක්‍රිම | කූටවක්‍රිමය
leptokurtosis=කූටවක්‍රිමය
leptome=ලෙප්ටෝම
leptomeningitis=ක්ෂීණ වෘතිදාහය
leptometer=ලෙප්ටොමීටරය
leptosome=කෘශදේහිකය
leptosporangiate=තනුබීජාණුධානික
leptosporangium=තනුබීජාණුධානිය
leptotene=තනුපට
lequor=රාමෙර
lesbian=ලෙස්බියනිය | සම ලිංගික සේවනය කරන ස්ත්‍රිය
lesbianism=නාරීමෛථුනය | ලෙස්බියානුව | ලෙස්බියානුවාදය
lesion=ඉරීම | ක්ෂතිය | තුවාලය | රිෂ්ටය
less=අඩු | අඩුවෙන් | අල්පතර | උනු | කුඩා | තුරල් | වඩා අඩු ප්‍රමාණය | වඩා අඩුවෙන් | වි
lessee=බදු ගන්නා | බදු ගැණුම්කරු | බදු ගැනුම්කාරයා | බදු ලද්දා | බදුකරු | බදුකාරයා | බදුගැනුම්කරු | බදුලද්දා
lessen=අඩු කරනවා | අඩු වෙනවා | තුනී වෙනවා
lesser=කුඩා | කුදුතර | වඩා අඩු වූ
lesson=ආදර්ශය | ගුරුකම | පාඩම
lessor=කල් බදු දෙන්නා | බදු දායකයා | බදු දීමනාකරු | බදු දීමනාකාරයා | බදු දෙන්නා | බදු හිමියා | බදුදායකයා | බදුදීමනාකරු
lest=යමක් නොකරන පිණිස | යමක් නොවෙන පිණිස
leste=ලෙස්ට්
lesu=ලෙසු
let=අවසර දෙනවා | ඉඩ දෙනවා | කුලියට දෙනවා | ප්‍රමාදය | බද්දට දෙනවා | බාධාව
lethal=මාරක | මාරාත්මක
lethargic=අලස | කුම්භකර්ණ | කුසීත | ලස
lethargy=අලසබව | ආලස්‍යය | උනන්දු නැතිකම | නිදිමත | ස්ත්‍යානය
lethel=ප්‍රාණය හානි කරන | මාරක
letherly=විකීමට අමාරු | හම් වැනි
letra=ලෑතර
letter=අක්ෂරය | අකුර | අකුරුවලින් ලකුණු කරනවා | ලිප | ලිපි | ලිපිය | ලිමන | ලියමන | ලියුම | ලේඛ | ලේඛනය | වණ | වර්ණය | ශබ්දය | හසුන
lettered=උගත්
lettering=අක්ෂරලේඛනය | අකුරු යෙදීම | අකුරු යෙදුම | යොදන අකුරු
letterpress=අච්චු අකුරු මුද්‍රණය
letters=අකුරු | ශාස්ත්‍රය | සාහිත්‍යය
lettuce=ලෙටිස් | සලාද ගස
leucine=ලියුසීන්
leuco-compound=අවර්ණ සංයෝගය
leucocyte=ශ්වෙතසෛටය | සුදු රුධිරාණුව | සුදුවන් රක්තාණු
leucocytosis=ශ්වෙත සෛටෝසියාව
leucoplastid=ශ්වේතලවය
leucoplasts=ශ්වේතලවය
leucopygialis=කවුඩුපණික්කියා
leucopyrites=ලියුකොපයිරයිටීස්
leucorrhoea=ලියුකෝරියාව | ශ්වේතරීතය
leucoscope=ලියුකොස්කෝපය
leukaemia=ලියුකෙමියාව | ශ්වේත රක්තය
levant=නැගෙනහිර මධ්‍යධරණී පෙදෙස
levee=ගං කණ්ඩිය | වේල්ල
level=එක මට්ටමෙහි වූ | එල්ල කරනවා | තලය | තලාව | තැනිතලා | තැනිතලාව | නියම තරාතිරම | පැතලි | පැතලි කරනවා | පෝරුව | මට්ටම | මට්ටම් කරනවා | මට්ටම් කරනවා | මට්ටම් ලෑල්ල | මිම්ම | ලෙවලය | ලෙවල් කරනවා | සම | සම කරනවා | සමකරනවා | සමතල | සමතලය | සමතලා | සමතලා කරනවා | සමබිම | සමාන බව | සාධාරණ
leveller=මට්ටම්කරන්නා | මට්ටම්කරු
levelling=උස සෙවීම | තලමිතිය | මට්ටම් කිරීම | සංතලනය
leventine=ලෙවන්ට්හී වැසියා
lever=උත්තෝලනය | දණ්ඩියම | ලීවරය
leverage=උත්තෝලනය යෙදීමෙන් ලැබෙන බලය | උත්තෝලනය යෙදීමෙන් ලැබෙන වාසිය | ලීවරණය
leveret=හා පැටියා
leviathan=තිමිංගලයා
levigation=පේෂණය
levigatiou=නිස්සාදනය
levirate=දේවර සරණය
levis=ලුහු
levitate=යමෙකු අහසෙහි ඉහල පහල යනවා
levitation=සෘද්ධිවාරය
levity=චපල බව | නොසැලකිලිවන්තකම | සැහැල්ලු බව
levo=ලීවෝ | වාමාවර්ත
levorotatory=වාමා භ්‍රමක
levy=අය කිරීම | අයකරනවා | අයබදු ආදිය ලබාගන්නවා | බලෙන් භටපිරිස් බඳවාගන්නවා
lewd=අසභ්‍ය | දුරාචාර | සල්ලාල
lewdness=සල්ලාලකම
lewis=ලුවිසිය
lex=නීතිය | ලෙක්සය
lexical=ශබ්දකෝෂයක් වැනි
lexicographer=ශබ්දකෝෂ කර්තෘ
lexicographist=ශබ්දකෝෂ සම්පාදක
lexicography=කෝෂවිද්‍යාව | ශබ්දකෝෂ තැනීමේ විද්‍යාව | ශබ්දකෝෂ විද්‍යාව | ශබ්දසංග්‍රහ විද්‍යාව
lexicology=ශබ්දකෝෂ වේදය
lexicon=අකාරාදිය | කෝෂය | නිඝණ්ටුව | ශබ්ද කෝෂය | ශබ්ද සංග්‍රහය | ශබ්දකෝෂය
lexis=භාෂාවකට අයිති සියලු වචන
lextationis=එකටෙක කිරීම
ley=තාවකාලික තණ බිම | වැහුම් වගාව
lgnicolism=අග්නිහෝමය | ගිනිදෙවි ඇදහීම
lgnition=ජ්වලනය
liabilities=ආධීනතා | ණයතුරුස් | බැඳීම් | බැරකම් | වගකීම්
liability=ණය | බැඳීම | බැර | බැරකම | වගකීම
liable=ආධීන | වගකිය යුතු
liaise=සම්බන්ධීකරණය කරනවා
liaison=සබඳකම | සම්බන්ධය
liana=කාෂ්ඨාරෝහකය | මාලුවා ලතාව
liane=මාලුවා ලතාව
liar=පචයා | බොරුකාරයා
lias=පොසිල ඇති නිල්වන් ගල් විශේෂයක්
libation=දියර පූජාව | මත්පැන් බීම
libatory=දේවපූජා වශයෙන් පැන් පිදෙන
libel=අපකීර්තිය | අපකීර්තියට පමුණුවනවා | අපවාදය | ලිඛිත අපහාසය | ලිඛිතාපහාසය
libellous=අපකීර්තිය ඇති කරන | අපවාද කරන | ලිඛිතාපහාසාත්මක
liberal=උදාර | තද නැති | ත්‍යාගවන්ත | නිදහස් මතධාරී | නොමසුරු | මධ්‍යස්ථවාදියා | ලිහිල් | විපුල | ස්වතන්ත්‍ර
liberalism=නිදහස්වාදය | මධ්‍යස්ථවාදය | ස්වතන්ත්‍රවාදය
liberality=උදාරභාවය | ත්‍යාගවන්තකම | නිදහස් මත දැරීම
liberalization=ලිහිල්කරණය | විපුලකරණය | ස්වතන්ත්‍රණය
liberally=නොමසුරුව | විශාල ලෙස
liberate=නිදහස් කරනවා | මුදනවා | මුදාගන්නවා
liberated=විනිර්මුක්ත
liberation=නිදහස | විමුක්තිදානය | විමුක්තිය
liberator=විමුක්තිදායකයා
liberize=ලිහිල් කරනවා
libertarianism=ස්වාධීනතාවාදය
libertas=නිදහස | නිදහස් ශක්නුතාව
libertine=කාමුක තැනැත්තා | දුරාචාරයෙහි හැසිරෙන්නා | සල්ලාලයා
libertinism=සල්ලාලකම
liberty=අවසරය | නිදහස | ස්වාධීනතාව
libidinous=ඉතා කාමුක | කාමයෙන් මත් වූ | ලුබ්ධක
libido=කාමරාගය | ලුබ්ධතාව | ලුබ්ධිය
libra=තුලා රාශිය
librarian=පුසතකාලාධිපති | පුස්තකාලයාධිකාරී | පුස්තකාලයාධිපති | පොත්ගුල භාරකාරයා | ලේඛනාලයාධිපති
librarianship=පුස්තකාලයාධිකාරිත්වය
libraries=පුස්තකාලය
library=පුස්තකාල | පුස්තකාලය | පොත්ගුල | ලේඛනාලය
libretto=ඔපරා පෙළ | සංගීත නාටකයේ වචන ඇතුළත් ග්‍රන්ථය
libripens=තුලාධරයා
lice=උකුණෝ
licence=අනුඥාපත්‍රය | අනුඥාව | අවසර පත්‍රය | නොනිසි නිදහස | බලපත්‍රය | වරම | හිතුමතයේ හැසිරීම
license=බල කඩදාසිය | බලපත්‍රය | බලපත්‍රයක් දෙනවා | බලය දෙනවා
licensed=අවසර ලත්
licensee=අනුඥාපත්‍රලාභියා | අනුඥාලාභියා | බලපත්‍රයක් ලත් තැනැත්තා | බලපත්‍රලාභියා
licensor=අනුඥාදායකයා | බලපත්‍රදායකයා
licentiate=අනුඥාපත්‍රලාභියා | අවසරලාභියා | ආවසරික | බලපත්‍රලාභියා
licentious=අනාචාර | අනාචාරී | සල්ලාල
lichen=පාසි වර්ගයක් | ලයිකනය
lichenicolous=ලයිකනෘහ
lichenification=ලයිකනීභවනය
lichenin=ලයිකනින්
lichenoerythrine=ලයිකනොඑරිත්‍රින්
lichenologist=ලයිකන් විද්‍යාඥයා
lichenology=ලයිකන් විද්‍යාව
lichenoxanthine=ලයිකනොසැන්තින්
lichgate=සුසානභූමියට ඇතුල් වන ප්‍රධාන දොරටුව
licit=නීත්‍යනුකූල
lick=තරඟයෙන් පරදවනවා | තළනවා | ලෙවකනවා | ලොවනවා | ලොවිනවා | ලෝනවා | වේගයෙන් යනවා
licker=ලෝනය
lickily=වාසනාවට | වාසනාවන්ත ලෙස
licking=තැළීම | පැරදීම | ලෙවකෑම
licorice=වැල්මී
lid=අපිධානය | කරමූඩිය | ඡාදනය | ඩප්පිය | පිධානය | පියන | මූඩිය | වහන | වැස්ම | වැහුම
lido=නාන වෙරළ
lie=අන්දම | කෙප්පය | තිබෙනවා | දිගා වී ඉන්නවා | දිසාව | නැවතී සිටිනවා | පච | පවතිනවා | පිහිටා තිබෙනවා | බේගල් | බොරු | බොරු කියනවා | බොරුව | මිග | මිථ්‍යා විශ්වාසය | මුසා | මුසාව | මුසාවාදය | මෘෂා | රැවටීම | වැටී තිබෙනවා | වැටී සිටිනවා | වැතිරෙනවා | සතපනවා | හාන්සි වී ඉන්නවා
lief=කැමැත්තෙන් | සතුටින්
liege=මෙහෙකරුවා | යටත් වැසියා
lien=උකස | කැපබලය | ලියම
lieno=ප්ලිහා
lier=බොරුකාරයා
lies=දූෂා
lieu=හිලව්ව
lieutenancy=ලුතිනන් පදවිය
lieutenant=උසස් නිලධාරියකුගේ දෙවෙනියා | ලයිතන්
life=ආයුෂ | ජීව | ජීවය | ජීවි | දිවිය | දිවිහිම් | පණ | පණ ඇති සත්තු | ප්‍රාණවත්කම | ප්‍රාණියා | පාණ | මිනිසුන් ගේ වගතුග | වය | විත කථාව | විතකාලය | විතය | සමාජය
life-belt=රැකුම් මෙවුල
life-buoy=රැකුම් බෝයාව
life-interest=ප්‍රාණ භූක්තිය
life-long=දිවිහිම් | යව්දිව් | යාවව
life-span=ආ | ආයුෂය
lifeless=අජීව | අප්‍රාණික | මළ
lifeline=දිවියොත
lifelinesman=දිවියොත්කරුවා
lifer=දිවි ඇති තෙක් සිර දඬුවම් විඳින්නා
lifetime=ආයුකාලය
lifo=අපිමුනි | පසු ඇතුළු පෙර පිට | පසු පිවිසි පෙර නිකුත්
lift=ආරෝහකය | ආරෝහණය | ආරෝහය | ඉහත් කරනවා | උත්තෝලකය | උපකාරය | උසස් බවට පමුණුවනවා | උසස්බව | උස්සනවා | උස්සාගෙන යනවා | උහනවා | එසවීම | ඔසවනය | ඔසවනවා | ඔසොව්ව | නගනවා | නැඟීම | සෝපානය
lift-pump=ආරෝහ පොම්පය
lifter=අස්කුරුව | ඩැහිය
lifting=ඉස්සී ඒම | එසවුම්
ligament=අස්ථිබන්ධය | බන්ධනිය
ligature=බන්ධකය | බැඳීමට යොදන පටිය | බැම්ම
light=අනාචාර | අඳුරු නැති | අලෝකය | අස්ථිර | ආභාසය | ආලෝක | ආලෝකය | ආලෝකවත් | එලිය | එළ | එළිය | එළිය කරනවා | කඩිසර | කවුළුව | කිරණ | චපල | ඥානය | දල්වනවා | ද්‍යුති | දෘෂ්ටිය | නියම ප්‍රමාණයට අඩු | නොවැදගත් | පත්තු කරනවා | පත්තු වෙනවා | පබ | පබා | පහන | පහසු | පහසුවෙන් දිරවිය හැකි | ප්‍රදීප | ප්‍රසිද්ධිය | පාන | බර නැති | බර යුඬායුධ නොමැති | බැබළීම | රස් | ලඝු | ලහු | ලිහිල් | ලුහු | වැටහෙන ආකාරය | විද්‍යාව | සරල | සැල් | සැහැල්ලු | සෑල්ලු | හෑල්ලු
light-o-love=වෙශ්‍යාව
light-reading=අඤ්ජනම් බැලීම
light-weight=ලුහුබර
light-year=ආලෝක වර්ෂය
lighten=එළිය කරනවා | බර අඩුකරනවා | බර අඩුවෙනවා | බැබළෙනවා | විදුලි කොටනවා | සැහැල්ලු කරනවා
lightening=අකුණ | විදුලි කෙටීම
lighter=බත්තල
lighterage=බත්තල් ගාස්තු | බත්තල් ගාස්තුව
lighthouse=ප්‍රදීපාගාරය
lighting=ආලෝකනය
lightness=ලුහුවත් බව
lightning=අකුණ | විජ්ජුලතා | විජූලිය | විදුලිය
lightning-arrester=අකුණු නිවාරකය
lightning-conductor=අකුණු සන්නායකය
lightsome=උනන්දු වූ
ligneous=කාෂ්ඨ | ලීවල ස්වභාවය ඇති
lignicole=කාෂ්ඨරුහය
lignicolous=කාෂ්ඨරුහ
lignification=ලිග්නිභවනය
lignified=ලිග්නීභූත
lignify=ලිග්නීභූත වෙනවා
lignin=ලිග්නින්
lignite=කාෂ්ටික ගල් අඟුරු | ලිග්නයිට්
lignocellulose=ලිග්නොසෙලියුලෝස්
lignone=ලිග්නෝන්
lignose=ලිග්නෝස්
lignous=කාෂ්ඨ
ligular=ව්හික
ligulate=හ්වල
ligule=හ්වලය
liguliflorate=හ්වපුෂ්පීය
liguliflorous=හ්වපුෂ්පීය
liguliform=හ්වලාකාර | හ්විකාකාර
like=අයුරු | එව් | ඡන්ද | ඡන්දය | නිභ | පහේ | පාහේ | බඳු | මනාප වෙනවා | මෙන් | යථා | යුරු | ලෙස | වගේ | වන් | වශයෙන් | වාගේ | වාලේ | වැනි | විරූ | සජාතීය | සදෘශ | සමාන | සමාන ලෙස | සමාන වූ දේ | සාදෘශ වූ දේ | සිතට අල්ලනවා | සේ
likeable=ප්‍රිය | රුව ඇති කරන
likelihood=අනුමේයතාව | භව්‍යතාව | විය හැකි බව | වියහැකි බව
likely=දක්ෂ | විය හැකි | සමහර විට | සිතිය හැකි | සුදුසු
liken=සමාන කරනවා | සමාන යයි කියනවා
likeness=ආකාරය | රූපය | වේශය | සමරූපතාව | සමාන බව | සමානකම
likes=රුව
likewise=එමෙන් | එසේම
liking=කැමැත්ත | රුවය
lilac=එළ නිල් පාට
lilaceous=මානෙල් පවුලට අයත්
lilent=තූෂ්ණිම්භූත
lilliputian=අඟුටුමිටි | ඉතා කුඩා
lilo=පසු ඇතුළු පසු පිට
lilt=උල්ලාස ගීතය | උල්ලාස ගීතයක් කියනවා | කාලය | ලය
lily=ඉතා ශෝභන ස්ත්‍රී | උප්පල | උපුල් | මානිල් | මානෙල්
limacon=සකටිය
limb=අංගය | අඟ | අඬුව | අඩිය | අවයවය | ඇඟ | ගත | ගාතය | ගාත්‍රය | බාහුව
limber=කාලතුවක්කු රථයේ ඉදිරිපස කොටස | නම්‍ය | පහසුවෙන් නැමෙන
limbo=පාතාල ලෝකය
lime=දෙහි | ලාටු | සුනු | හුණු | හුනු | හුනු අළු
lime-burner=සුනු වඩුවා
limelight=යශෝප්‍රභාව
limen=අන්තර දේහලිය | දේහලිය | ලිමන
limerick=පේළි පහක් ඇති හාස්‍යය උපදවන කවිය | හාස පද්‍යුය
limestone=හිරිගල් | හුණු ගල | හුණු ගල් | හුනු ගල් | හුනුගල්
limey=බ්‍රිතාන්‍ය ජාතිකයා
limit=අන්තය | ඉතා ඉහළ ප්‍රමාණය | ඉම | කඩ | කෙරවළ | කෙළවර | තෝංවය | නියම කරනවා | නියම ප්‍රමාණය | පරිච්ඡේදය | ප්‍රමාණය | මර්යාදාව | මාඉම | මායිම | මායිම් යොදනවා | සමන්තය | සීමා | සීමා කරනවා | සීමාන්තය | සීමාව | හිම | හිම්
limitation=අඩුපාඩුකම | ප්‍රමාණය | සීමාකරය | සීමාන්තිතය | සීමාව
limitative=සීමාකාරී
limited=පරිමිත | සීමා සහිත | සීමාකෘත | සීමාසහිත | සීමිත
limiter=සීමකය | සීමාකාරකය
limiting=සීමාකාරී
limitless=අනන්ත | අපමණ | නිම් හිම් නැති | නොතරම් | සීමා රහිත
limitlessly=දිගට හරහර | නොමින්
limits=සීමා
limma=ලිමාව
limn=රූප අඳිනවා | සිතියම් කරනවා
limnad=සාරස ශාකය
limnaea=සාරස ශාක සමාජය
limner=සිත්තරා
limnetic=සාරස
limning=ආලේඛය
limnium=සාරස ශාකය
limnology=තඩාග විද්‍යාව | විල් විද්‍යාව | සාරස විද්‍යාව | සාරසවිද්‍යාව
limnophilus=සාරසකාමී
limnophyta=ලිම්නොපීටා | සාරස ශාක
limnoplankto=සාරස ප්ලවාංග
limonite=ලයිමනයිට් | ලිමොනයිට්
limousine=මෝටර් රථ විශේෂයක්
limp=කුරගානවා | කොරගසනවා | දැඩි නැති | දුර්වල | නොණ්ඩි ගහනවා | නොණ්ඩිය
limpet=කාවාටියා | කූඩාව | තන්තුඹුවා | තුන්තුඹුවා
limpid=පැහැදිලි
limping=කොර ගසන | කොරය
limy=හුණු සහිත
linage=පෙළපත
linany=නියමිත යාච්ඤා ක්‍රමය
linase=ලිනේස්
linchpin=කඩඇණය
linctus=අවලේහය
linden=දෙහි ගස් වර්ගයක්
line=ඉර | ඉරි වැටෙනවා | ඉරිගසනවා | කව් පදය | ක්‍රියා මාර්ගය | කොට ලියුම | කොටස | නැව් සමාගම | නියමය | නිරක්ෂ රේඛාව | නූල | පරම්පරාව | පාදය | පාලිය | පෙත | පෙළ | පෙළට සිටවනවා | පෙළට සිටිනවා | පෙළපත | පේළි ගසනවා | පේළි ගැසෙනවා | පේළිගෙය | පේළිය | පෝරු දමනවා | මඟ | මාර්ගය | මිරිය පාර | රක්ෂාව | රජ | රාය | රැළි වැටෙනවා | රූල | රේඛා | රේඛාව | රොඹ | ලනුව | ලේඛා | වංශය | වරිය | වැකරැල්ල | වැළ | හිර
line-up=පෙළගැස්සීම
lineage=අන්වය | ආර | පරපුර | පරම්පරාව | පෙලන්තිය | පෙළපත | පෙළැන්තිය | වංශය | වංසය
lineal=අන්වානුගත | පරම්පරානුගත | පෙලැන්තිගත | පෙළපතින් පැවතෙන
lineament=දේහ ලක්ෂණය | මූණුවර
linear=ඒකජ | කෙළින් පිහිටි | දික්කඩ | රේඛා පිළිබඳ | රේඛාමය | රේඛීය
linearity=ඒකජතාව | රේඛීයතාව
lineation=රේඛාවල පිළිවෙළ
lined=රේඛා සහිත
lineman=කම්බිකරු
linen=කොමු | කොමු පිළි | ලිනන් | ලිනන් වලින් සෑදූ | හණ රෙදි
lineolate=සියුම් රේඛා සහිත
liner=ඇතිරිය | යානය
lines=කම්කරුවන්ගේ නිවාස | කවි | රේඛා
linfluence=බල පානවා
ling=කුඩා | පොඩි | සිහින් දිගැටි මාලුවෙක්
linger=කල් පවතිනවා | විඳුවනවා | සුනංගු වෙනවා | හැසිරෙනවා
lingerie=කොමු පිළී
lingering=කල් පවතින | සුනංගු වන
lingo=දියුණු නොවූ භාෂාව
lingua-franca=සාර්ව භාෂාව
lingual=ජීහ්ව | ජීහ්වා | දිව පිළිබඳ වූ | රසනක
linguist=භාෂාවේදියා | වාග්විද්‍යාඥයා | වාග්වේදියා
linguistic=භාෂාමය
linguistics=භාෂා ශාස්ත්‍රය | වාග් විද්‍යාව | වාග් විද්‍යාව | වාග්විද්‍යාව
lingulate=ජීහ්වල | ජීහ්වාකාර
liniment=ආලේපය | ද්‍රවාලේපය | ලිනමන් | ලිනමන්ට්
linin=ලයිනින්
linine=ලයිනින්
lining=අතුරුණුව | ආස්තරය | පිළිපෝරු දැමීම | පෝරු දැමීම | පෝරුදැමීම | පෝරුව | භාස්මාස්තර ලිප | රේඛණය
link=අත්වැල් බැඳගන්නවා | අමුණනවා | අවුණනවා | ඈඳනවා | ගාන්චුව | ගැළපෙනවා | ජ්‍යාය | පුරුක | පුරුද්දනවා | බන්ධනය | සන්ධානය | සන්ධිය | සම්බන්ධ කරනවා | සම්බන්ධ වෙනවා | සම්බන්ධකය | සම්බන්ධය
linkage=ඈඳනය | ප්‍රතිබද්ධය | බන්ධනය | බැඳීම | බැඳීම් පද්ධතිය | සම්බන්ධකය
linking=බැඳිම
links=ගොල් පිට්ටනිය
linnaean=ශාක වර්ග කිරීමේ ක්‍රමයක්
linneon=ලීනියස් විශේෂ | ලීනියස් විශේෂය
linnet=කුරුලු වර්ගයක්
linocut=ලයිනෝකඩ
linolein=ලිනෝලෙයින්
linotype=පේළි වශයෙන් අච්චු අකුරු වැක් කෙරීම | ලයිනෝටයිප්
linseed=ලින්සීඩ් | හණ ඇට
lint=තුවාල වෙළන මෘදු රෙදි වර්ගයක්
lintel=උඩළිපත | කරුබිත | ලින්ටලය | වා කවුළුව
lion=කෙසර | නිර්භීත පුරුෂයා | බාසුරු | මෘගපති | ව්‍යාල | වාළමිග | සිංහ | සිංහයා | සිහ | සී | සීහ | සුප්‍රසිද්ධ තැනැත්තා
lionize=නොයෙක් ගරුබුහුමන් දක්වනවා
lip=අද්දර | අධර | ඔෂ්ඨය | ගැටිය | තොල | තොල්ගහනවා | තොලුව | පැහිහච්චකම | ලවන | ලවනත | සෂ්ඨය
lip-eroticism=තොල් කාමුකත්වය
lip-reading=තොල් පඨනය
lipase=ලයිපේස්
lipid=ලිපිඩ්
lipiodol=ලිපියඩෝල්
lipochrome=ලිපොක්‍රෝම්
lipocyanin=ලිපොසයනික්
lipoid=ලිපොයිඩ්
lipolysis=මේදෝවිච්ඡේදනය
lipolytic=ලයිපොලිටික
lipoma=ලයිපෝමාව
lipped=ඔෂ්ඨීය | ගැටියක් ඇති | තොල්සහිත
lipping=තොල කඩ
lipstick=තොල් සායම්
liquation=ද්‍රාවවේචනය
liquefaction=ද්‍රවභාවය | ද්‍රවීකරණය | දිය වීම | දියකිරීම
liquefier=ද්‍රවීකාරකය
liquefy=ද්‍රව කරනවා | දිය කරනවා | දිය වෙනවා
liquescent=අවද්‍රාවක
liquid=අවසායන | තනු | ද්‍රව | ද්‍රවය | ද්‍රවශීල | දිය | දියර | දියර ජාති | දියළු | දියාරු | දීප්තිමත් | සෞම්‍ය අක්ෂරය
liquidate=අවසායනය කරනවා | ඈවර කරනවා | මරා දමනවා
liquidation=අවසායනය | ඈවර කිරීම
liquidator=අවසායකයා | ඈවරකරු | ඈවරකරුවා
liquidity=ද්‍රවත්වය | ද්‍රවතාව | ද්‍රවශීලතාව
liquidize=දියර බවට පත් කරනවා
liquidizer=මිරිකන යන්ත්‍රය
liquor=ආසව | දියවර්ග | මත්පැන් | මදිරා | මෙර | රහ | රහමෙර | වාරුණිය | සුරා
liquorice=වැල්මී
lira=ඉතාලියේ මුදල් | ලීරාව
lisigenetic=භංගජාත
lisle=ගොත ගැසීම
lisp=ගොත ගසනවා
lisping=ගොත ගැසීම | දුර්ලාලනය
lissom=පහසුවෙන් හැරවිය හැකි අඟපසඟ ඇති
lissome=පහසුවෙන් හැරවිය හැකි අඟපසඟ ඇති
lissomness=පහසුවෙන් නැමෙන අඟපසඟ
list=ඇල වෙනවා | ඇලය | ඇහුම්කන් දෙනවා | කැමැති වෙනවා | ගැටිය | රෙදි තීරය | රෙදි පටියක් යොදනවා | රෙදිවාටිය | ලැයිස්තු කරන්න | ලැයිස්තු සපයනවා | ලැයිස්තුව | ලේඛනය | ලේඛනයට ඇතුළත් කරනවා | වට්ටෝරුකරනවා | වට්ටෝරුව | සීට්ටුව
list-quadrat=සිව්‍රැස් ලැයිස්තුව
listen=අසනවා | අහනවා | ඇහුම්කන් දෙනවා | කන් යොමනවා | කන්දෙනවා | කියන දේ අහනවා | සවන් දෙනවා
listener=අසන්නා | අසා සිටින්නා | ශ්‍රෝතෘ
listening=අසා සිටීම | සකර්ණ
listless=ඇහුම්කන් නොදෙන | උකටලී | උදාසීන | කිසිවකට ඇල්මක් නොදක්වන
lists=රණ බිම
liter=ලීටරය
literacy=අකුරු දැනීම | අකුරු හැකියාව | අකුරුතාව | සාක්ෂරතාව
literal=පදගතාර්ථ | වර්ණ | වාච්‍යාර්ථ | වාච්‍යාර්ථය | සත්‍ය
literalism=වචනාර්ථයටම දැඩිව බැඳුණ බව
literally=ඇත්ත වසයෙන්ම | වචනානුසාරයෙන්
literary=උගත් | ශාස්ත්‍රීය | සාහිත්‍යක | සාහිත්‍යමය
literate=අකුරු දත් | අකුරුකළ | උගත් | ලියන්නට කියන්නට දත් | සාක්ෂර | සාහිත්‍යධරයා
literati=පණ්ඩිත ජනයා | වියත් පෙළැන්තිය
literatim=අකුරක් පාසා
literature=පොත්පත් | ශාස්ත්‍රීය ග්‍රන්ථ | ශාස්ත්‍රීය ග්‍රන්ථ සමූහය | සාහිත්‍යය
litharge=ලිතාජ් | ලෙඩ් මොනොක්සයිඩ්
lithe=දක්ෂ පක්ෂ | සුනම්‍ය
lithium=ලිතියම්
litho-press=ලිතෝ මුද්‍රකය
litho-varnish=ලිතෝ වාර්නිශ්
lithogenesis=ශිලා ජනනය
lithograph=ගල් තහඩුවක කැටයම් කොට ඉන් කරන ලද මුද්‍රණය | ගල් තහඩුවක කැටයම් කොට මුද්‍රණය කරනවා | ගල් තහඩුවක් වැනි දේක කැටයම් කොට ඉන් කරන ලද ම | ගල් තහඩුවක් වැනි දේක කැටයම් කොට මුද්‍රණය කරනවා
lithographer=ශිලා මුද්‍රණ ශිල්පියා
lithography=ලයිතෝ මුද්‍රණ ශිල්පය | ලිතෝ මුද්‍රණය | ලිතෝග්‍රාපිය | ලිතෝමුද්‍රණය | ශිලා මුද්‍රණය | ශිලාරේඛණය
litholapaxy=ග්‍රාව්‍ය ප්‍රක්ෂාලනය
lithology=ශිලා විද්‍යාව | ශිලාවිද්‍යාව | ශිලාශාස්ත්‍රය | ශීලා විද්‍යාව
lithomancy=සිලාපේනය
lithophilus=ශිලාකාමී
lithophyte=ශිලාශාකය
lithospermous=ශිලාබීජ
lithosphere=ශිලා ගෝලය | ශිලාගෝලය
lithotomy=ග්‍රාව්‍යඡේදනය
litigant=නඩුකියන්නා | නඩුමාර්ගයෙන් අරෝ කරන්නා
litigate=නඩු කියනවා | නඩුමගට බසිනවා | නඩුහබ කියනවා
litigation=නඩුකීම | නඩුමාර්ගයෙන් අරෝ කිරීම | නඩුයෑම
litigious=නඩුකියන | විවාදශීලී
litmus=ලිට්මස් | ලිට්මස් කඩදාසි
litre=ලීටරය
litshi=පළතුරු විශේෂයක්
litter=කසළ | පැටවු ගහනවා | රොඩු ගොඩ | වීසිකරනවා | ශිවකාව
litterateur=උගතා | පණ්ඩිතයා | සාහිත්‍යිකයා
little=අල්ප | කිසි | කුඩා | ටික | ඩිංග | ථෝක | පැටි | පුංචි | පුලුට | පොඩ්ඩ | පොඩි | පොඩිත්ත | පොඩිය | පොද | බිඳ | මන්ද | මඳ | මිති | යන්තම් | රොම්බ | සරලුව | ස්වල්ප | ස්වල්ප වශයන් | ස්වල්පය | සිඟිත්ත | සිල්වාරම් | සුඟු | සුළු | සොච්චම
littoral=තීරස්ථ | මුහුදු වෙරළ | මුහුදු වෙරළට අයිති | වෙරළබඩ | සමුද්‍රාශ්‍රිත
liturgic=දේවමෙහෙයේ ක්‍රමයට අයත්
liturgical=දේවමෙහෙයේ ක්‍රමයට අයත්
liturgy=දේවමෙහෙයේ ක්‍රමය
lituus=කාහලය
live=කල් යවනවා | ක්‍රියාත්මක | කුඩා සතුන් සහිත | ජීව | ජීවත් වෙනවා | නැවතී තිබෙනවා | පණ ඇති | ප්‍රාණවත්ව තිබෙනවා | ප්‍රාණවත්ව සිටිනවා | පොරොත්තුව තිබෙනවා | බලපවත්වන | රැකෙනවා | වත් වෙනවා | වත්ව තිබෙනවා | වත්ව සිටිනවා | වමාන | වසනවා | වාසය කරනවා | වැඩ ඉන්නවා | විකාව කරනවා | වෙසෙනවා | සව | සිටිනවා
live-wire=සව කම්බිය
lived=සිටි
liveligood=වනෝපාය
livelihood=ආජීවනය | ආජීවය | ආවනය | ජීවනෝපාය | ජීවිකා | ජීවිකා වෘත්තිය | ජීවිකාව | දිවිපෙවෙත | බඩ රස්සාව | බඩ වැඩුම | රැකීරක්ෂාව | විකාව
liveliness=උනන්දුව
lively=අලංකාර | ඉක්මන් | උනන්දු | වේගවත් | සව
liven=අලංකාර කරනවා | ප්‍රමුදිත කරනවා
liver=අක්මාව | කැවුත්ත | පීකුදු | යකෘතය | වත්වන්නා
liverish=ඉක්මණින් තරහ යන | රත්පිත් ගාය ඇති
liverpulian=ලිවර්පූල්හී වැසියා
liverwort=අක්මාශාකය
livery=ඇතැම් වෙළඳ ශ්‍රේණිවල සාමාකයන්ගේ ඇඳුම | ඉක්මණින් තරහ යන | බුත්තිය බාරදීම | රත්පිත් ගාය ඇති
liveryman=නගර ශ්‍රේණිකයා
livestock=පශු සම්පත | පශුසම්පත
livid=ඉතා සුදුමැලි | ඊයම් පාට | මඳක් නිල් වූ
living=ජංගම | ජීවනය | ජීවමාන | ජීවි | දිවමන් | දිවිපැවැත්ම | ධරමාන | නිවසන | ප්‍රාණවත් | පෙවෙත | බඩවැඩුම | වමාන | වර්තික | වසන | වාසය | විකාව | විජෘම්භමාන | විහරණය | විහාරය | විහාරික | සව
lixicographer=ශබ්දකෝෂ සම්පාදක
lixiviate=සෝදා වෙන් කරනවා
lixiviation=ගැරීම | සෝදා වෙන් කිරීම
lizard=කටුස්සා
llama=ලාමා
llano=ලානෝ | විශාල පතන
lmpedor=සම්බාධකය
ln-circle=අන්තර්වෘත්තය
lncrustation=කබල | කබල හැදීම
lncurvate=ඇත්බඹුරු
lncurved=ඇත්බඹුරු
lndividuation=පෞද්ගලීභවනය
lnduction=ප්‍රේරණය
lnstinct=සහජාසය
lntegument=ඩිම්බාවරණය
lntersporal=අන්තර්බීජාණු
lntracultural=අන්තස්සංස්කෘතික
lntramargnal=උපදාර
lo=බලව | මෙන්න
loach=කුඩා මිරිදිය මත්ස්‍යයෙක්
load=පටවනවා | ප්‍රවේශනය කරන්න | බර | බර පටවනවා | භාර | භාරය | විබර | විභර | හාරය | හිරිහැර කරනවා | හිරිහැරය
loaded=පොහොසත් | සුරාවෙන් මත් වූ
loader=පටවනය | ප්‍රවේශ කාරකය
loading=පැටවීම | පූරණය | භාරණය
loadstone=කාන්දම් ගල
loaf=නිකරුණේ කල් ගතකරනවා | රස්තියාදු වෙනවා
loafer=කම්මැළියා
loam=ලෝම | ලෝම පස | ලෝම් | ලෝම් පස | වාත්තු මැටි | සරුපස
loamy=සරු පස් සහිත
loan=අත මාරුව | ඉණ | ණය | ණයට දුන් දේ | ණයට දෙනවා | ණයදානය | තාවකාලික ප්‍රයෝජනයට දෙනවා | ප්‍රතිදේය | ප්‍රතිදේයය | පිරුවට | පිරුළ | පිරුළු | බැහැර දෙන ග්‍රන්ථ | සෘණය | හිලව්ව
loaned=තත්සම
loath=නොකැමැති
loathing=පිළිකුල
loathsome=අප්‍රියාව උපදවන | අපුල | ඉතා අප්‍රසන්න | කැත
lob=බෝලයට තදින් පහර දෙනවා
lobate=බෙදුණ කොටසක් ඇති | සඛණ්ඩික
lobby=උපශාලාව | ප්‍රවේශ ශාලාව | ලොබිය | සභාකක්ෂය
lobbying=සභාකක්ෂ මන්ත්‍රණය
lobbyist=පාර්ලිමේන්තු මන්ත්‍රී
lobe=කැමිය | කොළයක බෙදුණු කොටස | ඛණ්ඩිකාව | පෙත්ත | පෙනහල්ලේ එක් කොටසක් | බියලී
lobectomy=පිණ්ඩක විච්ඡේදනය
lobed=ඛණ්ඩිකීය | බෙදුණු
lobelia=ලොබිලියා | ශාකයක්
lober=බෙදුණු
lobola=ආභරණය | ලොබෝලාව
lobose=සඛණ්ඩික
lobotomy=පිණ්ඩ විච්ඡේදනය
lobster=පොකිරිස්සා
lobulate=සානුඛණ්ඩික
lobule=අනුඛණ්ඩිකාව | පිණ්ඩිකාව
lobulus=අනුඛණ්ඩිකාව
lobworm=මාලු ඇල්ලීමේදී ඇමට භාවිත කරන බිම් පණුවෝ
local=දේශීය | පරිස්ථානීය | පළාතකට පමණක් අයත් | පළාත්බද | ප්‍රාදේශික | ප්‍රාදේශීය | මෙරට | ස්ථානික | ස්ථානීය
locale=ස්ථානය | සිද්ධිය වූ ස්ථානය
localisation=පරිස්ථානීයකරණය | ප්‍රාදේශීයකරණය | ස්ථානගත කිරීම | ස්ථානගත වීම
localise=පැතිරෙන්ට නොදී වළකනවා | ස්ථානගත කරනවා | ස්ථානගත වෙනවා
locality=ඉසව්ව | පළාත | ප්‍රදේශය | පිහිටී බිම | මංඩිය | මණ්ඩිය | හරිය
localization=ස්ථානගත කිරීම | ස්ථානීකරණය
localize=පැතිරෙන්ට නොදී වළකනවා
locally=පළාත්බදව | ලඟපාත | ළඟපාතම
locate=නිශ්චයනය කරනවා | පිහිටි තැන දක්වනවා | පිහිටි තැන සොයාගන්නවා | පිහිටුවනවා
locatio=කුලියට දීම
location=අනුස්ථානය | අවස්ථිතිය | නිවේශනය | නිවේෂණය | නිශ්චයනය | පරිස්ථානය | පිහිටිස්ථානය | පිහිටීම | පිහිටුම | පිහිටුවීම | ස්ථානය
locator=දෙයක් හෝ සේවයක් කුලියට දෙන්නා | නිවේශකය
loch=විල
lochia=සූතිකහාරය
lociation=ස්ථානනය
locies=ප්‍රාක්ස්ථානනය
lock=අගුල | අගුල් දමනවා | අගුළ | අගුළු වැටෙනවා | අඟුළුලනවා | ඇළ දොර | කෙස්‍රොද | දියගුල | බඹුරු කෙහෙ | යතුරු තහඩුව | යතුරු දමනවා | යතුරු ලනවා | වහනවා | වා අගුල | වැහෙනවා | හිරකරනවා | හිරවෙනවා
lock-in=ඇතගුළු ලෑම
lock-nut=අගුල් මුරුච්චිය
lock-out=අවස්ථිතිය | අවස්ථීතිය | පිට ලැම | පිටගුළු ලෑම | පිටලෑම
lock-up=හිර කිරීම | හිර කූඩුව
lockage=අගුලු දිය හානිය
locker=කුඩා අල්මාරිය | යතුරු දැමිය හැකි කුඩා අල්මාරිය
locket=මාල පෙත්ත | මාලපෙත්ත
locking=අගුළු ලෑම
locknut=අගුළු මුරිච්චිය
locks=කේශකලාපය
locksmith=යතුරු හදන තැනැත්තා
lockup=සිරකූඩුව
locomotion=ගමනාගමනය | චලන ශක්තිය | ජංගමනය | සංචරණය | සංචරනය | සඤ්චරණය
locomotive=ජංගම යන්ත්‍රය | ජංගමක | ධාවන යන්ත්‍රය | පීලි එනජීම | පීලිරිය | මිරිය එන්ම
loculament=කෝෂ්ඨය
locular=කෝෂ්ඨීක
locule=කෝෂ්ඨය
loculicidal=කෝෂ්ඨහේද
locus=පථය | ස්ථානය
locust=පතංගයා | පළඟැටියා
locution=කථා විලාසය | භාෂණය | වාග්ලීලාව
locutionary=භාෂණීය
lode=ඉල්ලම
lodestone=අයස්කාන්තය | කාන්දම් ගල | කාන්දම්ගල
lodestuff=ඉල්ලම් බොර
lodge=උද්‍යානගෘහය | කුඩා ගේ | නවාතැන | නවාතැන් ගන්නවා | නැවතී සිටිනවා | නිවෙස | බංගලාව | මඩූව | ලැගුම් ගන්නවා | වාඩිය
lodger=නවාතැන් ගන්නා | නවාතැන්කරු | නවාතැන්කාරයා
lodging=නවාතැන | ලැගුම
lodgings=ලැගුම්හල්
lodgment=නවාතැන
lodicule=තුෂිකාව
lods=ලුහුමාව
loess=ලොයෙස් | ලොයේස් | සුළඟ නිසා ගංගා මිටියාවත්හි තැන්පත් වන තුනී වැලි
loft=අටල්ල | අට්ටාලය | අටුව | උඩුමහල් | මඤ්ච | මඤ්චක | මැස්ස
loftiness=උදාරබව
lofty=උඩඟු | උදාර | උන්නත | උසස් | උස් වූ | තුඟු
log=කඳ | කොටය | දශමාංශය | දැව කොටය | ලඝු | ලඝුගණකය | ලී කඳ | ලොගය | ළොඹුව
logan=පැද්දීමට තුඩු දිය හැකි විශාල ගල
loganberry=රතුපාට පලතුරු විශේෂයක්
logarithm=ගාතාංක ගණන | ලඝු | ලඝු ගණකය | ලඝුගණක | ලඝුගණකය
logarithmic=ලඝුගණක
logger=ලඝුර
loggerhead=ගුඩ්ඩයා
loggia=සඳළු තලය
logging=ලොග් සටහන් කරනවා
logic=තක | තර්ක ශාස්ත්‍රය | තර්ක ශාස්ත්‍රය | තර්කය | තර්කශාස්ත්‍රය | න්‍යාය | න්‍යාය ශාස්ත්‍රය
logical=තර්ක | තර්කානුකූල | තර්කානුසාරී | තාර්කික | න්‍යායානු | න්‍යායානුසාරී | යුක්ති සහගත | සහේතුක
logician=තර්කවිද්‍යාවේ විශාරද | තාර්කිකයා
logicism=තර්කවාදය | න්‍යායවාදය
logistic=ප්‍රවර්ධන | ප්‍රවර්ධනය
logistics=මනා සංවිධානය
logit=ලඝුකය
lognormal=ලඝුප්‍රමත
logoff=වරන්න
logomachy=වාග් යුද්ධය
logon=පුරන්න
logos=දේවවාක්‍යය | භාරතිය | වාග් බ්‍රහ්මත්වය
logotype=සංවිධානයක ලාංඡනය
loin=ඉණ | එහි වූ මස් | කටී ප්‍රදේශය | ජඝනය | තුනටිය
loin-cloth=ඉණකඩ
loins=ඉඟ
loiter=ගැවසෙනවා | රස්තියාදු වෙනවා | රෝන්දෙ යනවා | සුනංගු වෙනවා
loiterer=අවසැරියා | රස්තියාදුකාරයා
loitering=අවසැරීම | ගැවසීම | නිකරුනේ ගැවසීම | රෝන්දෙ
loll=කම්මැලිව ඉන්නවා
lollipop=රසකැවිල්ල | සීනි බෝලය
loma=ලෝමා
lomentum=සලාකිතය
lone=කාන්සියෙන් සිටින | තනි | මිනිසුන් නොගැවසෙන | හුදකලා වූ
loneliness=කාංසිය | කාන්සිය | කෝල | තනිකම | තනිය | පාළුව | ශාංකාව | හුදකලාව | හුදෙකලාව
lonely=උදෙකලාව | එකලා | කේවල | තනිවම | පාළු | රහෝගත | විජන | හුදකලා | හුදෙකලා | හුදෙකලාවම
loner=තනිව වසන්නා
lonesome=පාළු
long=ගුරු | දික් | දිග | දිග කාලය | දිගටි | දීඝ | දීර්ඝ | දුර | පවත්නා | බොහෝ කල් | බොහෝ කල් ගතවන
long-lasting=වරස්ථිත
long-sight=දූර දෘෂ්ටිකත්වය
longeron=ගුවන්නැවක රාමුවේ දික් අතට ඇති කොටස
longevity=දීර්ඝායුෂ | වරවනය
longing=අටිය | අභිරුවය | අභිලාෂය | ආකාංක්ෂාව | දැඩි ආශාව | දොළදුක | මනදොල | ලාලස | ලාලසා
longitude=අයනාංශකය | දේශාංශකය | දේශාංශය | දේශාන්තර රේඛාව | ධෘවකය | යාම්‍යෝජිත්තර වෘත්ත
longitudinal=අන්වායාම | ආයත | දික් අතට
longlived=දීර්ඝායුෂ
longrange=දුර වදින
longshore=මුහුදු වෙරළෙහි ඇති
longshoretman=නැවකට බඩු පටවන හා බාන පුද්ගලයා
longsight=ළඟ නොපෙනීම
longstanding=වරාගත
longsuffering=බොහෝ කාලයක් දුක් විඳින
lood=පෙනුම
look=ආකාරය | පෙනීම | බලනවා | බැල්ම | බැලුම | යමක් දෙස බලනවා | සම්ප්‍රේක්ෂණය
looking=අවලෝකනය
loom=අලුව | දුරින් පෙනෙනවා | නොපැහැදිලි ලෙස පෙනෙනවා | රෙදි වියන යන්ත්‍රය | වියන යන්ත්‍රය | විශාලව පෙනෙනවා
looming=යන්ත්‍රගත කිරීම | යන්ත්‍රණය | හැදය සවි කිරීම | හැදය සවිකිරීම
looms=වියන යන්ත්‍ර | වියන යන්ත්‍ර
loomweight=වෙමභාර
loon=නුහුගුන කාරයා | පිස්සා
loony=මඳක් සිහිවිකල
loop=තොණ්ඩුව | තොණ්ඩුවකින් බඳිනවා | දරනුව | පුඩු ලනවා | පුඩුලනවා | පුඩුව | පුඩුවක් සාදනවා | ලූපය | වළල්ල
loop-aserial=පුඩු ඇහැසිය
looped=වලිත
loopy=ඔල්මාද | තකතිරු
loose=අනියත | කළ්ළ | ගැලවුණු | චපල | දුරාචාර | නිදහස | නිදහස් | නිදහස් ලෙස | බුරුල් | ලිහා අරිනවා | ලිහිල් | ලීල් | ලොට | විරළ | ශිථිල | සිථිල
loose-coupling=බුරුල් ඇඳුම | ලිහිල් ඇඳූම
loosely=නිදහස් ලෙස
loosen=බුරුල් කරනවා | බුරුල් වෙනවා
looseness=බුරුල | ලිහිල
loosening=බුරුල් කිරීම | ලිහිල් කිරීම
loot=කොල්ලකනවා | කොල්ලකාගත් දේ | කොල්ලය | පැහැරගෙන යනවා | මංකොල්ල කනවා | ලුංටනය කරනවා | ලුංටිතය
looter=කොල්ලකරුවා
looting=ආලෝපය | කොල්ලකෑම | ලුංටනය
lop=එල්ලා වැටෙනවා | කොටකර දමනවා
lope=පැන පැන දුවනවා
lophotrichous=ගුච්ඡරෝමී
lopolith=තලි සෙල
lopsided=පැත්තකට බර
loquacious=කට වාචාල | කටකාර | දොඩමලු | මුඛර
loquaciousness=දොඩමලුකම | දොඩමලුබව | මුඛරිකම | මුඛරිබව | වාචාලකම
loquacity=දොඩමලුකම | දොඩමලුබව | මුඛරිකම | මුඛරිබව | වාචාලකම
loquor=සුරාපානය
lorate=පටිහැඩ
lord=අංශාධිපතියා | අධිපතියා | අනේ ඇත්තට | ප්‍රභූ | භර්තෘ | රාළ | වංශාධිපති | වංශාධිපතියා | වංසක්කාරයා | සම්දරුවා | සමිඳු | ස්වාමි | ස්වාමිපුරුෂයා | ස්වාමියා | සාමිවරයා | සාමී | හාමි | හාමු | හිමි
lordly=අහංකාර | අහංකාර ලීලාවෙන්
lordosis=උඩුකුදය
lordship=අධිපතිකම | ස්වාමිත්වය
lore=කථා | තොරතුරු | ශ්‍රැතිය | සත්‍ය කරුණු
lorica=සන්නාභය
loris=ලොරිස්
lorn=අසරණ | පාළු
lorry=ලොරිය
lose=අපොහොසත් වෙනවා | තට්ටු වෙනවා | තබාගන්නට බැරි වෙනවා | දිනාගන්නට බැරි වෙනවා | නැති කරගන්නවා | නැති වෙනවා | පාඩු පැමිණෙනවා | ලබාගන්නට බැරි වෙනවා | වරද්දා ගන්නවා | සොයාගන්නට බැරි වෙනවා
loser=පරාතයා | පරාද වූ තැනැත්තා | පාඩු පැමිණි තැනැත්තා
loss=අලාබය | අලාභය | අවාසිය | නැතිවීම | පාඩුව | ව්‍යය | හානිය | හැනිය
lost=අපාගත | කපෝති | නෂ්ට | නැති වූ | මුළා වූ | ව්‍යාකූල වූ
lot=ඉරණම | කැබැල්ල | කොටස | ගොඩ | ගොන්න | තොගය | දණ්ඩනය | දෛවය | පංගුව | රාශිය | සමූහ | සමූහය | සලාක | සීට්ටුව | හේතුව හෝ අහේතුව
lotase=ලොටේස්
loth=නොකැමැති
lotion=දියරය | බෙහෙත් දියර | ලෝෂණය
lotoflavin=ලොටොප්ලේවින්
lotteries=ලොතරැයි
lottery=අහම්බය | ලොතරැයිය
lotus=අම්බුජ | කමල | තඹර | තඹරු | තඹුරු | තාමර | නෙළුම | නෙළුම් ගස | නෙළුම් මල | පංකජ | පද්ම | පදුම | පියුම | ශතපත්‍ර | සරා | සරෝරුහ | සහස්පත් | සියපත
loud=කෑගසන | ඝෝෂා සහිත | මහා ශබ්ද ඇති | ශබ්ද නඟා | සැරෙන් | හයියෙන්
louddress=ඇඳුමක්
louderback=ලවුඩබැක්
loudly=ශබ්ද නඟා | සැරෙන් | හයියෙන්
loudness=සැර | හඩේ සැර | හඬේ බර | හඬේබර
loudspeaker=ලෞඩ්ස්පීකරය | ශබ්ද විකාශකය
lough=විල
louis=ප්‍රන්සයේ පරණ රන් කාසියක්
lounge=අලසකමින් කල් ගතකරනවා | හාන්සි වී සිටිනවා | හාන්සි වෙන සෝපාව
lounger=අලසයා
louse=උකුණා | ලේයා
lousy=උකුණන් ඇති | නීච
lout=අශික්ෂිතයා | ජඩයා | තඩියා | නිවටයා | පතුරු ජනේලය
louver=පතුරු ජනේලය
louvre=පතුරු ජනේලය | ලූවරය
lovable=ආදරණීය | ප්‍රිය වඩන
lovage=කෑම රසවත් කිරීමට යොදන පැළෑටි විශේෂයක්
love=ආදරය | ආදරය කරනවා | ආදරය දක්වනවා | ආලය | ආලය කරන වස්තුව | ඇල්ම | ඇලුම් කරනවා | දයාව | නුරා | ප්‍රණය | ප්‍රිය කරනවා | ප්‍රේමය | පෙම | පෙම්වතිය | මෛත්‍රීය | රති | ශෘංගාර | සනා | ස්නේහය | සාදරය | සෙනෙහස
loveless=අනාදර | ආදරය අහිමි
loveliness=ප්‍රසන්නභාවය
lovely=අලංකාර | ඉතා ලක්ෂණ | මනහර | මනෝහර | රම්‍ය
lover=පෙම්වතා | වල්ලභයා | සල්ලාලයා
lovers=පෙම්වත් යුවළ
lovey-dovey=ප්‍රිය වූත් රසාත්මක වූත්
loving=ආදරණීය | දයාබර | ප්‍රේමවන්ත | වත්සල | ස්නේහවන්ත | සාදර
loving-kindness=මෛත්‍රිය | මෛත්‍රීය
low=අඩු | අඩුවෙන් | අධම | අනාර්ය | අසභ්‍ය | උස නැති | ඌළියක්කාර | කුප්ප | ගර්හිත | ගෙරි | ජඩ | තප්පුලනවා | තිරච්ඡාන | තිරශ්චීන | තුච්ඡ | දුර්වල | දෙබරාදු | නිකෘෂ්ට | නීච | පට්ට | පහතට | පහත් | පහතින් | පහළ | ප්‍රමාණ නොවූ | පාත | පාත් | පාහර | බලු | ම්ලේච්ඡ | යටහත් පහත් | ලාමක | වාමන | වෙට්ට | සප්පට | සවුත්තු
lower=අඩු කරනවා | අඩු වෙනවා | අඳුරු වෙනවා | පහත් කරනවා | පහත් වෙනවා | පාත දමනවා | පාත් කරනවා | බහිනවා | බානවා | යටි | වඩා පහත්
lowering=අවතරණය | බැස්සීම | රවා බලන | රවා බලනවා
lowest=අඩුතම | අවම | කුඩා ම | පඤ්චම
lowing=තැපිල්ලීම
lowlander=මිටියාවතෙහි නිවැසියා
lowliness=නිවටකම
lowly= නිවට | පහත් | විනීත
loxodrome=සදිශ පථය | සමදිගංශ පථය | සමදිගංශකය
loyal=ඉතා හිතවත් | ගැති | දේශප්‍රේමී | පක්ෂපාත | රාජපාක්ෂික | ලෙන්ගතු
loyalist=ගැත්තා | රාජපාක්ෂිකයා
loyalty=පක්ෂපාතකම | පක්ෂපාතිත්වය | පාක්ෂිකභාවය | ලැදිකම | විශ්වාසවන්තකම
lozenge=ලොසින්ජරය
lrregularity=අක්‍රමිකතාව
lsogon=සම ක්‍රාන්තිකය
lsostacy=සමතුලාවාදය
lsostylous=සමකීල
lsvara=තිනෙත් | ශිව | සිව
lt=සීමාව
lubbard=අදක්ෂයා | කම්මැළියා | තරබාරු
lubber=අදක්ෂයා | කම්මැළියා | තරබාරු
lubberly=තරබාරු | තරබාරු ලෙස
lubricant=අභ්‍යංජකය | අභ්‍යඤ්ජකය | ලිහිස්සි තෙල් | ලිහිසි තෙල් | ස්නේහකය | ස්නේහය
lubricate=අභ්‍යංජනය කරනවා | අභ්‍යඤ්ජන කරනවා | ලිස්සා යාමට සලසනවා | ස්නේහක දමනවා | ස්නේහන කරනවා | ස්නේහනය කරනවා
lubrication=අභ්‍යංජනය | අභ්‍යඤ්ජනය | ලිස්සා යාමට සැලසීම | ස්නේහනය
lubricator=ස්නේහකය
lubricity=ගැලවී යාම | පලායාමේ හැකියාව
lucence=දීප්තිය
lucent=දීප්තිමත් | භාස්වර | විනිවිද පෙනෙන
lucerne=ලුසන්
lucid=අවිකල | ඉපැහැදිලි | නිර්මල | පැහැදිලි | සිහිය ඇති | සුබෝධ
lucidity=ඉපැහැදිලි බව | විශාදතාව | සිහිමත්බව | සිහිය ඇති තත්ත්වය | සුබෝධත්වය
lucifer=ගිනිකූරු වර්ගයක්
lucilia=ලුසිලියා
luck=ඉරණම | භාග්‍යය | වාච්වය | වාසනාව | විපාකය | ශුභාශුභය | හේතු බලය
luckless=අවාසනාවන්ත
lucky=ධන්‍ය | පින්වත් | බදුරු | මංගල | වාසනාවන්ත | ශුභ | සුභ
lucrative=මූල්‍යදායක | ලාභ උපදවන | වාසි ඇති | වාසිමත්
lucre=ධනය | මුදල් | ලාභය
lucubration=වන තුරු පාඩම් කිරීමෙන් කළ නිර්මාණය
luddite=දියුණුවට අකුල් හෙළන්නා
luddites=ලඩිට්
ludicrous=විහිළු | සිනා උපදවන | හාස්‍යජනක | හාස්‍යජනකය
ludo=දාදු කැටයකින් කරන ලූඩො ක්‍රීඩාව
luff=සුළං ඇති දිශාවට සමීපව යාත්‍රා කරනවා
luffing=ඩෙරිකීම
lug=අමාරුවෙන් ඇදගෙන යනවා | කන | තුඩුව | දිවත
luggage=ගමන්බඩු | බර බද්දර | ලැගෙජ් | සම්බල
lugger=කුඩා රුවල් නැවක්
lugubrious=දුක්මුසු | විලාප සහිත
lugworm=ඇමට ගන්නා පණුවෙක්
lukasbruder=ලුකාස්බෲඩ
lukewarm=ඇල් මැරුණු | මන්දෝත්සාහී | යන්තම් උණු | වැඩි සැලකිලි නැති
lull=උපසමය | දරු නැළවිල්ල | නලවනවා | නළවනවා | නිසලබව | සනසනවා
lullaby=දරු නැලවිල්ල | දරු නැළවිල්ල | නැලවිල්ල | නිද්‍රාගීතය | ලාලිකාව
lulled=ලාලිත
lumbago=කටීවායුව | තුනටිය රුදාව
lumbar=කටී | තුනටියට අයත්
lumber=අමාරුවෙන් හෙමින් ගමන් කරනවා | දැව | නිශ්ඵල දේ ගොඩ ගසනවා | ලී දඬු
lumbering=අමාරුවෙන් යන | දැව කර්මාන්තය
lumberman=දැව සපයන්නා
lumen=කුහරය | ලුමනය | ලූමනය
luminance=දීප්තතාව
luminary=ප්‍රසිද්ධ උගතා
luminescence=සංදීප්තිය | සන්දීප්තිය | සන්දීප්තීය
luminescent=ප්‍රභාසම්පන්න
luminiferous=ආලෝකවාහක | සංදීප්තිධර | සන්දීප්තිධර
luminiphore=සන්දීප්තිධරය
luminosity=දීප්තිය
luminous=ආලෝකවත් | දිලිසෙන | දීපන | දීප්ත | පැහැදිලි | බබළන
lumonosity=දීප්තිය
lump=ආලෝපය | ඉදිමුම | උණ්ඩිය | එකට ගොඩගසනවා | කැටිය | කැදැල්ල | කුට්ටිය | ගුඩ | ගුළ | ගුළිය | ගොඩ | තැම්බ | පිඩ | පිණ්ඩය | පුඤ්ජය | පුට | පුටය | බෙටි | වැදැල්ල | ස්කන්ධ | සුරුණ්ඩි
lumpish=ගුඩ්ඩ | ගුලිගැසුණු | බර
lumps=ගිනි ගඩොළු
lumpy=කැට සහිත
lunacy=උන්මන්තක භාවය | උන්මාදය | උමතුව | පිස්සුව
lunar=චන්ද්‍ර | චන්ද්‍රයා පිළිබඳ
lunate=අඩ සඳ වැනි | අර්ධ චන්ද්‍රාකාර | චන්ද්‍රයිතය | චන්ද්‍රිකාව | වක්හඳ
lunatic=උන්මත්ත | උන්මත්තක | උන්මත්තකයා | උමතුවා | පිස්සා
lunation=ගමනේදී චන්ද්‍රයාගේ ඇතිවන වෙනස්කම්
lunations=චන්ද්‍ර වාරය
lunch=දවල් කෑම | දිවා ආහාරය ගන්නවා | පෙරබත | මධ්‍යාහ්න භෝජනය
luncheon=දවල් කෑම | දිවා ආහාරය ගන්නවා | මධ්‍යාහ්න භෝජනය
lune=ලූනය
lung=ක්ලෝමය | පුෂ්ඵුසය | පෙනහැල්ල | ඵුප්පුසීය
lunge=ඉදිරියට පැනීම | පැන පහර දෙනවා
lungs=පෙණහල්ල
lunu-miris=ලුණුමිරිස්
lupin=මල් ගසක්
lupine=වෘක ගණයට අයත්
lupinine=ලුපිනින්
lupinite=ලුපිනයිට්
lupulin=ලුපුලින්
lupus=දදයක් වැනි චර්මරෝගය
lupusion=වාණ්ඨය
lurch=දුෂ්කරතාව | හදිසියෙන් ඇලවෙනවා
lurcher=දෙමුහුන් සුනඛ විශේෂයක්
lure=ආකර්ෂණය | ඇදගන්නවා | ඇම | උපාය
lurid=අඳුරු | භය උපදවන | මලානික | සුදුමැලි
lurk=රැක සිටිනවා | සැඟවී තිබෙනවා | සැඟවී සිටිනවා
lurking=අප්‍රකට | ගුප්ත | විසන් | විසැඟි | සැඟවී සිටින
luscious=අතිමධුර | ඉතා රසවත් | කාමුක | රස හරිත
lusciousness=මාධුර්ය්‍යය
lush=සාරවත්
lusiform=විපර්යාසය
lust=අධික ආශා ඇති වෙනවා | අධික ආශාව | කාමතෘෂ්ණාව | තණ්හාව | තිදොස | තෘෂ්ණාව | රසකාමය | රා | රාගය | ලොල්බව
luster=ප්‍රභාව
lustful=කාමුක | රාගික | සංක්ලේශ | සරා | සරාග | සලල
lustily=ප්‍රබල ලෙස
lustiness=ශක්තිමත්කම
lustral=ශෝධක
lustration=පවිත්‍රීකරණය | පාචනය
lustre=කාන්තිය | කැලුම | කීර්තිය | කේතු | දිස්නය | දීප්තිය | ප්‍රජ්වලනය | ප්‍රභාව
lustreless=නිෂ්ප්‍රභ
lustrous=කාන්තිමත් | රුවර
lusty=ඔදවත් | ප්‍රබල | ශක්තිමත්
lusus=විපර්යාසය
lutanist=වීණාවාදකයා
lute=කින්නාරම | වීණාව
lutecium=ලුටීසියම්
luteolin=ලුටෙයොලින්
lutes=ඇවුරුම් බදාම
lutetium=බරැති මූලද්‍රව්‍යයක්
lutheran=රෙපරමාදු නිකායට අයත්
lutheranism=ලුතරියානුවාදය
lutherian=ලුතරියානු
luting=ඇවිරීම
lutist=වීණාවාදකයා
lux=ලක්සය | ලක්ස්
luxe=සුඛෝපභෝගී
luxuriance=අති බහුලත්වය
luxuriant=අත්‍යලංකෘත | විපුල | සව්සාර | සාරවත්
luxuriate=සැපෙන් කල් ගෙවනවා
luxuries=සුඛෝපභෝග | සුඛෝපභෝගී භාණ්ඩ
luxurious=ඉතා සැපවත් | සශ්‍රීක | සැපෙහි ඇලුණු | සුඛෝපභෝගී
luxury=මහත් සැපත | සුඛෝපභෝගී
lvee=රාජසභාව
lycanthropy=වෘකමානත්වය
lyceum=ඇරිස්ටෝටල් දාර්ශනිකයාගේ උද්‍යාන නිකේතනය
lychgate=සුසානභූමියට ඇතුල් වන ප්‍රධාන දොරටුව
lycopodiaceous=ලිකොපෝය
lycopodinean=ලිකොපෝය
lycopodium=ලයිකොපෝඩියම්
lycopsid=ලිකොප්සිඩය
lycopsida=ලිකොප්සිඩා
lye=ලයිය
lying=දිගා වී සිටින | බොරු කියන | බොරු කීම | මුසාවාදය | වැතිරීම | හාන්සි වී සිටින
lying-in-home=තිඹිරිගෙය | සූතිකාගාරය
lying-in-hospital=සූතිකාගාරය
lying-in-room=තිඹිරිගෙය
lymph=දිය | වසා
lymphadenitis=වසා ග්‍රන්ථිදාහය
lymphangitis=වසා ධාරනීදාහය
lymphatic=වසාවාහී
lymphocyte=වසා සෛටය | වසා සෛලය
lynch=ආක්‍රමික දණ්ඩනය | නඩු නැතිව දඬුවම් කරනවා | ලිංවනවා
lynx=වල් බළලා
lyophile=ද්‍රවකාමිය
lyophilic=ද්‍රවකාමි | ද්‍රවකාමී
lyophobe=ද්‍රවභීතිකය
lyophobic=අද්‍රවණශීල ද්‍රවභීතික | ද්‍රවභීතික
lyosorption=ද්‍රවාවශෝෂණය
lyotrope=ද්‍රවාවර්තකය
lypemania=දොම්නස් උමතුව
lyra=ලයිරාව
lyrate=වීණාකාර
lyre=ලයරය | වීනා විශේෂයක්
lyric=අතිශය වර්ණනාත්මක | උදාන කාව්‍යය | ප්‍රීතියෙන් පිණා ගිය | භාව ගීතය | භාවගීතය | භාවනා කාව්‍යය
lyrical=අතිශය වර්ණනාත්මක | උදානාත්මක | ප්‍රීතියෙන් පිණා ගිය
lyricist=ගීත රචකයා
lysigenetic=භංගජාත
lysigenic=භංගජාත
lysigenous=භංගජාත
lysimeter=ලයිසිමීටරය
lysin=ලයිසීන්
lysis=ජාරණය | විච්ඡේදනය | ශ්ලථය
lysol=ලයිසෝල්
lyssa=රහස
