n-acid=සමක අම්ලය
n-acid=සමක අම්ලය
n.b.p.s.=මිල හා ආදායම් පිළිබඳ ජාතික මණ්ඩලය
n.d.c.=ජාතික ආරක්ෂක දායක මුදල
n.p.l.=ජාතික භෞතික පරීක්ෂණාගාරය
n.t.p.=සම්මත උෂ්ණත්වය හා පීඩනය
n.u.=අංකය නැත
naasting=නාස්තිංගය | ප්‍රථමයෙන් මිලට ගැන්මේ අයිතිය
nab=පැන අල්ලා ගන්නවා | හදිසියෙන් අල්ලා ගන්නවා
nabla=නබ්ලා | නැබ්ලා
nabob=මහා ධනවතා
nacre=සිප්පි
nadagama=නාඩගම
nadir=අධහ්ස්වස්තිකය | අධෝ බින්දුව | අධෝබින්දුව | ඉතා පහත් තැන | යට අහස් මුඳුන
nadiral=අධෝ බින්දු
naevus=උපන්ලපය | නිවය | විහ්නය
nag=කුඩා අශ්වයා | දිගින් දිගට විවේචනය කරනවා | නිතර ලෙල්ලම් කරනවා
nagativism=ප්‍රතිෂේධතාව | ප්‍රතිෂේධතාවාදය
naiades=ජල දෙව්දූවරු
nail=ඇණ ගසනවා | ඇණගසා සවි කරනවා | ඇණය | නඛ | නිය | නිය පොත්ත | නියපොත්ත
nail-socket=ගුලු ඇණ තව්ව
nail-stain=නියමල
nailbourne=නේල්බෝනය | සවිරාම ගංගාව
nailing=ඇණ ගැසීම | ඇණ ලෑම
nails=නිය
nainsook=තුනී රෙදි වර්ගයක් | නැන්සූක්
naive=අව්‍යාජ | නිවට | නෝන්ජල්
naivete=අව්‍යාජභාවය | බොළඳකම
naivety=අව්‍යාජභාවය | අවිදග්ධතාව | බොළඳකම | සරලමතිකත්වය
naked=අචේලක | අනාරක්ෂිත | අලංකාරයක් නැති | උපකාරයක් නැති | දිගම්බර | නග්න | නිර්වස්ත්‍ර | නිරුවත් | වැස්මක් නැති | විවෘත | සිතාම්බර | සෙලුවැලි | සෙලූ | හෙලු වැලි
nakedeye=පියවි ඇස
nakedness=නිර්වස්ත්‍රභාවය | සෙලුවැල්ල | සෙලූව | හෙලු | හෙලුව
namby-pamby=කබල් | බොළඳ | හැඟිම් බර
name=අපදේශය | අභිධා | අභිධානය | නම | නම් කරනවා | නම් තබනවා | නාමය | නියම කරනවා | ප්‍රඥප්තිය | ප්‍රසිද්ධිය | සංඥා කරනවා | සංඥාව | සන් | සඳහන් කරනවා
named=නමැති | ප්‍රඥප්ත | යන | සංඛ්‍යාත
nameless=අප්‍රසිද්ධ | නිර්නාමික
namely=එනම් | කෙසේද යත් | තිදොස | නම් වසයෙන් කියතොත් | වනු
nameplate=නම් පුවරුව | නම් ලියනලද තහඩුව | නම් ලියනලද ලෑල්ල
names=නාම මාත්‍රිකයෝ
namesake=එම නමම ඇත්තා
naming=නම් කිරීම | නම්තැබීම
nanandrous=අඟුටු පුමංගී | වාමන පුමංගී
nancy=කාන්තාවක් බඳු පිරිමියා
nanism=කුරුබව
nankeen=කහ පාට කපු රෙදි
nannoplankton=වාමනප්ලවාංග
nanny=ළමයාගේ කිරි මව
nanny-goat=එළුදෙන
nano=නනු
nanophanerophyte=අල්පදෘශ්‍යශාකය
nap=අඩ නින්ද | කඩදාසි සෙල්ලමක් | ටික වේලාවක් නිඳාගන්නවා | බූව
napaim=නේපාම් බෝම්බ විශේෂය
nape=කුළල් සන්ධිය | ගලවලුව | පිටිකර | බෙල්ලේ පසුපැත්ත
napery=කෑම මේසයෙහි එළන රෙදි
naphtha=ඛණිජ තෙල් වර්ගයක් | නැප්තා
naphthaline=කපුරු බෝල
napier=නේපියර්
napiform=බමර හැඩ | බමර හැඩය
napkin=අත්පිස්නාව | ඉඳුල් කඩය | ඔසප්කඩ | කුඩා තුවාය | නැක්කිම
nappe=නැපිය | වටුම | සිඟුව
nappy=ඉණකඩ
naptha=නැප්තා
napthalene=නැප්තලීන්
naration=කථනය
narceine=නාසේන්
narcissism=ආත්මරාගය | නායිස්මය | නාසිස්මය | ස්වරූප රාගය | ස්වරූපරාගය
narcissus=මානෙල් වැනි මල්ගසක්
narcolepsy=නිද්‍රාලුව
narcosis=මාදකත්වය | සිහි නැති අවස්ථාව
narcotic=මත්ද්‍රව්‍ය | මාදක | මාදකය
narcotine=නාකොටින්
nares=නාස්පුඩුව
nark=පොලිසියේ ඔත්තු කාරයා
narodism=නරෝදවාදය
narrate=කථනය කරනවා | කියාගෙන යනවා | ලියා දක්වනවා | විස්තර කරනවා
narration=ආඛ්‍යානය | කථනය | කියාදීම | විස්තරය
narrative=ආඛ්‍යාන | ආඛ්‍යානය | කතන්තදරය | කතන්දරය | කතාන්තරය | කතාව | කථන | කථා වස්තුව | කථාන්තරය | කථාව | විස්තරය | වෘත්තාන්ත | වෘත්තාන්තය | වෘත්තාන්තයක් දක්වන
narrator=ආඛ්‍යායික | කථක | කථිකයා | පොතේගුරු | විස්තර කරන්නා
narrow=ඇකිළෙනවා | උදාර නොවූ | කුඩා | පටු | පටු කරනවා | පටු වෙනවා | පළල් නොවූ | ලෝභී | සංකට | සීමා කරනවා | සීමා වෙනවා | සීමා සහිත | හීන
narrow-minded=උදාරභාවයක් නැති
narrowing=පටු කිරීම
narrowly=යන්තම් | යන්තමින් | සියුම් ලෙසින්
narrowness=පටුබව
narrows=පටු කපොල්ල | පටු සමුද්‍රසන්ධිය | සඩය
narwhal=දළ තල්මහ
nasal=අනුනාසික | නාසය පිළිබඳ | නාසික
nasalised=නාසික්‍ය | සඤ්ඤක
nasalize=නාසික්‍ය බවට පමුණුවනවා | නාසිකාක්ෂර කරනවා
nascency=ඡායමානතාව
nascent=අංකුර | අටගැනී එන | ආරම්භක | ජායමාන | සෑදීගෙන එන
naso-pharynx=නාසා ග්‍රසනිකාව
nastic=සන්නමන
nastily=නිර්දය ලෙස
nastiness=අප්‍රසන්නකම
nasturtium=කහ හෝ රතුමල් ඇති උද්‍යාන පැළෑටියක්
nasty=අපිරිසිදු | අරුව උපදවන | කැත | නපුරු | නිර්දය | පිළිකුල් සහිත | වේදනා ඇතිකරන | සන්නමනය | හැඩි
natal=සූති
natalism=සූති
natant=ප්ලව
nataraja=නටරාජා
natation=පීනීම
natha=නාථ | නාථදෙවි
nation=ජනතාව | ජාතිය | දැය | දෑ | දේශය | රටක වැසි සෙනඟ | වර්ගයා
national=ජන්ම | ජාතික | ජාතිය | ජාතීය | දේශීය | පුරවැසියා | පොදු | රටවැසියා | ස්වජාතික
nationalisation=ජනසතු කිරීම
nationalised=ජනසතු
nationalism=ජාත්‍යාලය | ජාතික වාදය | ජාතිකවාදය | ජාතිමමත්වය | ජාතිවාදය | දේශානුරාගය
nationalist=දේශාභිමානියා
nationality=ජාත්‍යාලය | ජාතිකත්වය | ජාතිය | පුරවැසිභාවය | යම්කිසි ජාතියකට අයිතිබව | යම්කිසි රටකට අයිතිබව | රටවැසිභාවය
nationalization=ජනසතු කිරීම | ජනසතුකරණය | රජයට පවරා ගැනීම
nationalize=ආණ්ඩුවේ පාලනයට පවරාගන්නවා
native=ආජන්ම | උරුම | දේශජ | දේශජයා | දේශවාසියා | දේශිය | දේශීය | නිසග | පියවි | යම් පළාතක උපන් | යම් පළාතකට අයිති | යම් රටක උපන් | යම් රටකට අයිති | සහජ | ස්වදේශිකයා | ස්වදේශියා | ස්වදේශීය | ස්වදේශීය දේශජ | සිංහල
natives=ස්වදේශීහු
nativism=දේශජවාදය | දේශවාදය | දේහජවාදය | වාදය
nativity=උත්පත්ති කථා | උත්පත්තිය | කේන්ද්‍රය
natter=කථා කරනවා | දොඩවනවා
natterjack=කුඩා ඉස්ගෙඩි විශේෂයක්
natty=කදිම
natural=අකෘත්‍රිම | අවංක | අවශ්‍ය | අව්‍යාජ | ඉබේ ඇතිවන | තාත්වික | නිශ්ශෝභ | නිහ්ශෝභ | නෛසර්ගික | ප්‍රකෘති | ප්‍රාකෘත | ප්‍රාකෘතික | පියවි | පෘථජ්ජන | බලාපොරොත්තු විය යුතු | භාවික | වියහැකි | සහජ | සහජාත | ස්වභාවික | ස්වභාවීය | ස්වාභාවික | සාත්වික
naturalisation=රටවැසියනය
naturalise=රටවැසියනය කරනවා
naturalism=තාත්වික වාදය | ප්‍රකෘති වාදය | ස්වභාව වාදය | ස්වභාවධර්ම විද්‍යාව | ස්වභාවවාදය | ස්වාභාව වාදය
naturalist=ප්‍රාණි විද්‍යාඥයා | ස්වභාව විද්‍යාඥයා | ස්වභාවවාදියා
naturalistic=ස්වභාවාත්මක | ස්වාභාවික
naturality=ප්‍රකෘතිය
naturalization=ජාති ප්‍රවේශනය | ජාතිප්‍රවේශනය | දෑ වැද්දුම | දෑවැද්දුම | දේශානුකූලනය
naturalize=පුරවැසිකම දෙනවා
naturalized=දේශානුකූලකෘත
naturally=අව්‍යාජයෙන් | වියයුතු ලෙසම | ස්වභාවයෙන් | ස්වභාවික ලෙස
nature=ගතිය | ගුණය | ජන්මගතිය | ධර්මතාව | නිසග | නිසර්ග | ප්‍රකෘතිය | බව | භාවය | ලක්ෂණය | වර්ගය | ස්වරූප | ස්වභාව | ස්වභාව ධර්මය | ස්වභාවධර්මය | ස්වභාවය | ස්වරූපය | සැටි | සැටිය | සැබව | සොබා | සොබාදහම | හැටි
natured=ගති ඇති
naturism=ස්වාභාව්‍යය
naturist=නිර්වස්ත්‍රව සිටින්නා
naufrage=නැව් බිඳුම
naught=කිසිත් නැතිබව | බින්දුව | ශූන්‍යය
naughtiness=දඟකාරකම
naughty=අකීකරු | දඟ | දඟකාර | දහංගලේ | නරක | විල්ලෝඩි
naumachia=මුහුදු යුද්ධ ප්‍රේක්ෂාව | මුහුදු යුද්ධාලය
nausea=ඔක්කාරය | ජුගුප්සාව | බඩ දැඟලීම | මහත් පිළිකුල | වමියාව | විවම්සාව | විවමිෂාව
nauseate=පිළිකුල ඇති කරනවා | පිළිකුල ඇතිවෙනවා
nauseating=ජුගුප්සාජනක | පිළිකුල් සහිත | බඩදඟලන | වාමනීය
nauseous=පිළිකුල් සහිත | විවම්සායී
nautch=නැටුම
nautical=නාවික | නාවුක
nautilus=රුවල් බෙල්ලා
naval=නාවික | පෙකණිය | යුද්ධනැව් සමූහයට අයත්
nave=කිඹුල් මුව | නැබ | පල්ලියේ මැද කොටස | රියනැබ
navel=තුණ්ඩිකාව | තුන්දිය | නාභිය | නැබ | පෙකනිය | බුරිය | මධ්‍යස්ථානය
navel-string=පෙකණි වැල
navicert=නෞසහතිකය
naviculaeform=නෞකාකාර
naviform=ඔරු හැඩ
navigability=යාත්‍රීයතාව
navigable=නාව්‍ය | යාත්‍රණීය | යාත්‍රා කළහැකි
navigate=අහස්නැව් යනවා | අහස්නැව් යවනවා | අහස්නැව් යාත්‍රා කරනවා | නැව් යනවා | නැව් යවනවා | නැව් යාත්‍රා කරනවා
navigation=ජලතරණය | යාත්‍රණය | යාත්‍රා කිරීම
navigational=ජලතරණ
navigator=නැව් පදවන්නා | යාත්‍රිකයා
navvy=කුලීකාරයා
navy=කණින්නා | නාවික හමුදාව | යුද්ධනැව් සමූහය
nawab=මහා ධනවතා
naxalism=නක්සල්වාදය
naxalites=නක්සල්වාදියෝ | නක්සලිකයෝ
nazaranes=නසරීනයෝ
nazarene=නාසරත්හී වැසියා
naze=තුඩුව
nazi=නට්සි | හිට්ලර්ගේ නාසිහමුදාවේ සාමාකයා
nazism=නට්සිවාදය
naïve=අවිදග්ධ | බොළඳ | සරලමතික
nd=දිනැ
neanderthal=ශිලා යුග මානවයා පිළිබඳ
neandertholoid=නෙයන්ඩතාලාභ | නෙයන්ඩතාලාභයා
neap=අඩු
neapolitan=නේපල්ස්හී වැසියා
near=අසල | ආසන්න | කට්ටු | කරා | කිට්ටු | කිට්ටුවට පැමිණෙනවා | කෙරෙහි | නි | නිහ් | ප්‍රත්‍යාසන්න | ප්‍රති | මසුරු | මෑත | වැලත | වෙත | සමීප | සාමීප්‍ය | ළං | ළං වෙනවා | ළඟ
near-by=අසබඩ
near-sight=ලඟ පෙනීම
near-sighted=දුර නොපෙනෙන
near-singing=දෝලන ආසන්න
nearby=අවට | අසල | අහල | වටපිට
nearly=කිට්ටුවෙන් | ටිකක් අඩුවෙන් | සම්පූර්ණයෙන්ම වාගේ
nearness=කිට්ටුව
neat=කදිම | කලවන් නැති | ගවයා | දක්ෂ | පිරිසුදු | යස | සුකෘත
neaten=යමක් ඉතා පිළිවෙළට කරනවා
neatly=පිළිවෙළට
neatness=එළිපහළිය | පිළිවෙළ
neb=තුඩ | නාසය | හොට
nebula=කුඩා වලාකුළ | නිහාරිකාව | නීහාරිකාව | පටලය
nebulae=කුඩා වළාකුළු
nebulization=නීහාරීකණය
nebulizer=නිහාරීකාරකය
nebulose=මේවන්
nebulosity=වලා ඇඳිරිය
nebulous=නියමයක් නැති | නොපැහැදිලි
necessaries=අවශ්‍ය දෑ | ආවශ්‍යකතා
necessary=අනිවාර්ය | අවශ්‍ය | අවශ්‍ය වූ දේ | ආවශ්‍යක | කළමනා | නොවැළැක්විය හැකි | මුදල් | වුවමනා | සනෑ
necessitarianism=අවශ්‍යම්භාවීවාදය | සැම කාර්යයක්ම හේතුවක් නිසා හටගන්නේ යැයි කියන ක
necessitate=අවශ්‍ය බවට පමුණුවනවා | අවශ්‍ය වෙනවා | බල කරනවා | බලෙන් සලසනවා
necessitous=ඉතා දිළිඳු
necessity=අවශ්‍යතාව | ඇවැසියාව | ඉරණම | උවමනාව | දිළිඳුකම | බලවත් සනෑකම | වුවමනා
neck=කණ්ඨ | කණ්ඨය | කම්බු | කර | කරටිය | ගල | ග්‍රීවය | ග්‍රීවාව | ගෙල | බදාගෙන ඉඹිනවා | බෙල්ල | බෙලි | බොටුව
neck-tie=කරපටිය
neckerchief=ගෙල වටා බඳින රෙදිකඩ
necking=ග්‍රීවනය
necklace=ඇටවැල | කන්ඨහාරය | තැල්ල | මාල | මාලය | මාලේ | මුක්තාහාරය | හාර | හාරය
necklet=ඇටවැල | කුඩා මාලය
neckton=නෙක්ටන්
necromancer=භූත වෛද්‍යවරයා
necromancy=ප්‍රේත නෛමිත්තය | ප්‍රේත මන්ත්‍රණය | ප්‍රේතමන්ත්‍රණය | භූත විද්‍යාව | මෘතාක්මපේනය
necrophagy=ගවභක්ෂණය | මළ මිනී කෑම
necrophilia=මළමිනීවලට අස්වාභාවික ආකර්ෂණයක් ඇති වීම | ශවකාමය
necrophilism=ශවකාමය
necrophobia=ශවභීතිකාව
necropolis=විශාල සුසානභූමිය
necrosis=අස්ථියක ක්ෂය වීම | නෙක්‍රෝසිය | පටකයක ක්ෂය වීම | විපන්‍යය
nectambulism=නිද්‍රා අටනය
nectar=අම | අමාරසය | අමෘතය | ඉතා රසවත් පානය | මකරන්ද | මධු | මල්පැණි | සුධාරසය
nectar-like=අමෘත
nectarine=රසවත් ඵල වර්ගයක්
nectarium=මධුකෝෂය
nectary=ගසක ස්‍රාවය | මධුකෝෂය
neddy=බූරුවා
nee=විවාහයට පෙර නම වූ
need=අවශ්‍යතාව | අවශ්‍යව පවතිනවා | උවමනාව | දුප්පත්කම | වුවමනා | වුවමනා කරනවා | වුවමනාව | ඕනෑකම | හිඟය
needful=අවශ්‍ය
needle=ඉදි කටුව | ඉදිකටුව | ඉදිකටුව වැනි දේ | කටුව | කූර | තුන්න | සූව | සූවය | හිද | හිඳ | හිඳිකටුව
needle-hole=හිදිකටුමල
needle-woman=මැහුම්කාරී
needlecord=සියුම්ව වියන ලද රෙදිපිළි
needless=නුවුවමනා
needling=කූරු ගැසීම
needly=සිද
needs=ඕනෑ එපාකම්
needsmust=නොකර ඉන්නට බැරි
needy=අර්ථි | දුප්පත් | ඕනෑ | හිඟන
neer-do-well=කාළකණ්ණියා
nefarious=අතිදුෂ්ට | දරුණු
negate=නැතැයි දක්වනවා | නිශේධනය කරනවා | යමක විරුද්ධාර්ථය හඟවනවා
negation=නැත යයි කීම | නිශේධනය | නිෂේධනය | ප්‍රතිෂේධය
negative=අනුඡායා | අභාවය | අභාවවාචක | තහනම් කරන | තහනම් කරනවා | නඤ්ඤර්ථ | නාස්තික | නැතැයි කීම | නැතැයි දක්වන | නැතිකම | නිශේධක | නිශේධනීය සෘණාත්මක | නිශේධය | නිෂ්ප්‍රභ කරනවා | නිෂේධ | නිෂේධක | නිෂේධාත්මක | ප්‍රතික්ෂේප කරනවා | ප්‍රතිච්ඡායාව | ප්‍රතිෂේධක | ප්‍රතිෂේධය | සෘණ | සෘණකාරී | සෘණාත්මක | සෘනාත්මක
negatively=සෘණකාරී ලෙස
negativism=නිෂේකවාදය | නිෂේධකතාව
negatron=නෙගට්‍රෝනය
neglect=අතපසු කරනවා | නොකොට අරිනවා | නොසලකා අරිනවා | නොසලකා හැරීම | නොසැලකිල්ල | ප්‍රමාදදෝෂය | ප්‍රමාදය | පැහැර හරිනවා | පැහැර හැරීම
neglectful=නොසැලකිලිමත්
neglegence=අනවධානය
neglegible=නගණ්‍ය | නොගිණිය යුතු
neglige=යට ඇඳුම
negligence=අනවධානය | නොසැලකිල්ල | ප්‍රමාදය
negligent=නොසැලකිලි සහිත | නොසැලකිලිමත්
negligible=ඉතා සුළු | නොගිණිය යුතු
negotiability=ගණුදෙනු කිරීමේ ශක්නුතාව | ගණුදෙනු හැකියාව
negotiable=ගනුදෙනු කළ හැකි | ගිවිසගත හැකි | ප්‍රතිදේය
negotiate=කතිකා කරනවා | ගනුදෙනු කරගන්නවා | ප්‍රතිදානය කරනවා | ප්‍රමන්ත්‍රණය කරනවා | බාධාවක් ඉක්මවා යනවා | හුවමාරු කරගන්නවා
negotiation=කතිකාව | ගනුදෙනු කිරීම | ගිවිස ගැනීම | ප්‍රමන්ත්‍රණ්‍ය | සංසන්ධි කතිකාව | සංසන්ධිකනිකාව
negotiator=ගනුදෙනු කරන්නා | සංසන්ධිකයා | සාකච්ඡා කරනවා
negrillo=කුරු නීග්‍රෝ මිනිසා | නිග්‍රිල | නිග්‍රිලයා
negrito=නිග්‍රිම | නිග්‍රිමයා | පොලිනේසියානු ජාතිකයා
negritude=නීග්‍රෝ සංස්කෘතියේ වටිනාකම සහතික කිරීම
negro=කාපිරි | කාපිරියා | නීග්‍රෝජාතිකයෙක් | නීග්‍රෝ
negroid=කළු ජාතික | නිග්‍රාභ | නිග්‍රාභයා
negus=ජලය සමග මිශ්‍ර කළ මිහිරි උණු මුද්‍රික පානය
nehrung=නේරුං
neigh=හේෂාරව කරනවා | හේෂාරවය | හේෂාරවය කරනවා
neighbour=අවට පිහිටි ප්‍රදේශය | අසල්වැසියා | අසල්වැසියෝ | ළඟ සිටින්නා
neighbourhood=අවට පිහිටි ප්‍රදේශය | අසර | අසල්වාසී | අසල්වැසියෝ | වටපිට | වටාපිටාව
neighbouring=සාමන්ත | ළඟපාත පිහිටි
neighbourly=අසල්වැසියන්ට සුදුසු | හිතවත්
neither=දෙකින් එකක්වත් නොවන
nekton=නෙක්ටන්
nelson=මල්ලව පොර
nemathecium=නෙමතීසිය
nemathelminthes=නිමැතෙල්මින්තිස්
nematode=ඒකච්ඡන්දයෙන් | සිහින් පණුවෙක්
nemesis=දුර්විපාකය | පළිගැනීම | ප්‍රතිඵලගත කෝපය | යුක්තිමය කෝපය
nene-storied=නවභූමක
neo=අලුත් | නව | නව
neo-classical=නව සම්භාව්‍ය
neo-darvinism=නව ඩාවින්වාදය
neo-lamarckism=නව ලාමක් වාදය
neo-logism=නවන්‍යායවාදය
neo-logy=නවන්‍යාය | නවපද භාවිතය
neo-malthusianism=නව මැල්තස් වාදය | නව මැල්තස්වාදය
neo-natal=නවජ
neoarsphenamine=නියො ආර්ස්පෙනාමින්
neocathersis=නව භාවශුද්ධිය
neoclassical=නව සම්ප්‍රදායික
neodymium=නියෝඩිමියම් | ලෝහමය මූලද්‍රව්‍යයක්
neogeaean=නවලෝක
neogeic=නවභූමික
neolithic=නවශිලා
neolocal=නවවාසික
neologism=නව වාක්කරණය | නූතන ශබ්දය
neologist=නවන්‍යායික
neology=නවවාදය | නවවේදය
neomancy=ඉනිපේනය
neon=නියොන් | නියොන් නැමති වායුව | නියෝන්
neonatal=නවජ
neophyte=ආධුනිකයා | නවක භික්ෂුව | නවශාකය | ශෛක්ෂයා
neoplasm=නව්‍ය ප්ලාස්මය | නියොප්ලැසම
neoplatonism=තුන්වන සියවසේ ඇති වූ ප්ලේටෝගේ කල්පිතය
neotropical=නවනිවර්තන
neotype=නූදර්ශය
neozoic=භූ ඉතිහාසයේ පසුභාගයට අයත්
nepenthe=නෙපෙන්තේ
nepenthin=නෙපෙන්තින්
neper=නේපර් | නේපියර්
nephascope=මේඝමානය
nephelometer=ආවිලතාමානය
nephelometry=ආවිලතාමිතිය
nephew=බෑනා | භාගිනෙය්‍ය
nephoscope=මේඝමානය
nephrectomy=වක්ක විච්ඡේදනය
nephritic=වකුගඩුවට සම්බන්ධ
nephritis=වක්කදාහය | වකුගඩු ඉදිමීම
nephroid=වෘක්කාභය | වෘක්කාහ
nephrolithotomy=වක්ක අශ්මරි ද්‍රොණය
nephroma=වක්කමාව
nephron=නෙප්‍රෝනය | වක්කය
nephropexy=වක්ක ප්‍රතිබද්ධය
nephrosis=නෙප්‍රෝසියාව | වක්ක්‍යය
nepotism=ඥාත්‍යනුග්‍රහය | ඥාති වාදය | ඥාති සංග්‍රහය | ඥාතිවාදය | ඥාතිසංග්‍රහය
neptune=මුහුදට අධිපති දෙවියා
neptunium=නෙප්චූනියම් | නෙප්චූනියම් නම් මූලද්‍රව්‍යය
nereid=දිග මුහුදු පණුවෙක්
nerve=ධෛර්යය | නහරය | නහසනවා | නාඩිය | නාරටිය | ලජ්ජා නැතිකම | ස්නායුව | හපන්කම
nerve-cell=ස්නායු සෛලය
nerve-head=ස්නායු ශීර්ෂය
nerve-racking=ස්නායු පීඩන
nerve-ring=ස්නායු චලය
nerverless=ශක්තියෙන් අඩු
nervine=නාඩි ශක්තිමත් කරන
nervous=ඉක්මනින් කලබල වන | ඉක්මනින් භය වන | නාඩි පිළිබඳ | බයාදු | ස්නායු | ස්නායු කම්පිත | ස්නාසීය | සැක සහිත
nervousness=කහඹිලියාව | කෝලය | චකිතය | සබකෝලය | ස්නායුකම්පනය | ස්නායුචකිතය
nervy=චංචලභාවයෙන් සිටින
nescience=අවිද්‍යාව
nescient=අඳුන
ness=තුඩුව
nest=කදලුව | කැදැල්ල | කූඩුව | කූඩුවක් තනා එහි ලගිනවා | ගොනුව | බෙනය
nest-egg=ඉතිරිකරගත් මුදල්
nesting=නීඩ කිරීම | නීඩායනය
nestle=තුරුල් වෙනවා
nestling=කුරුළු පැටියා
nestorians=නෙස්ටෝරියානුවෝ
net=අමිශ්‍ර | ජාලය | දල | දැල | දැල වැනි දේ | දැලකින් වසනවා | දැල් දමා අල්ලනවා | දැල් රෙදි | පතරම | ලාභ ලබාගන්නවා | ශුද්ධ
net-ball=දැල්පන්දු
net-like=ජාලාකාර
net-profit=ශුද්ධ ලාභය
nether=පහළ | යට
nethergarment=අධෝ අංශුකය
nethermost=ඉතා යට | යටි අතට
nethersky=නිභස්ථලය
netherworld=අධෝලෝකය
nett=අමිශ්‍ර | තනි | ලාභ
nett-weight=ශුද්ධ බර
netted=ජාලාකාර
netting=දැල | දැල් රෙදි ගෙතීම
nettle=තරහ අවුස්සනවා
network=ජාලකය | ජාලය | ජාලාකර්මය | ජාලාව
neucleoproteins=න්‍යෂ්ටි ප්‍රෝටීන්
neural=ස්නසා | ස්නායු | ස්නායුක
neuralemma=ස්නසා කුෂිකාව
neuralgia=වාතශූලය | ස්නසා වේදනා | ස්නසාර්දනය | ස්නායු වේදනාව | ස්නාසාර්දනය
neurasthenia=නහර දුර්වලකම | නියුරස්තීනියාව | නියුරැස්තීනියාව | ස්නායුක්ෂයය
neuritis=ජනසාප්‍රදාහය | නහර ඉදිමීම | ස්නසාදාහය
neuro=ස්නායු
neuro-psychiatry=ස්නායු මනෝචිකිත්සාව
neuro-syphilis=ස්නසා උපදංශය
neurocranium=ස්නායු කපාලය
neurocyte=ස්නායු සෛලය
neuroglia=නියුරොග්ලියා | ස්නසා ශ්ලේෂය
neurological=ස්නසාවේදීය
neurology=ස්නසාවේදය | ස්නායු විද්‍යාව | ස්නායු වේදය | ස්නායුවේදය
neuroma=නියුරෝමාව | ස්නසාමාව
neuromere=ලවය
neuromuscular=ස්නායු පේශීය
neuron=නියුරෝනය | ස්නසාව
neurone=නියුරෝනය | ස්නසාව | ස්නායු සෛලය
neuronymy=ස්නායු නාමකරණය
neuropathy=ස්නායුව්‍යථය
neurophysiology=ස්නායුකායික විද්‍යාව
neuropil=ස්නායු විතංසය
neuroplexus=ස්නායු ප්‍රතානය
neuropore=ස්නායු ද්‍රය
neuropsychiatry=ස්නායු මනස්චිකිත්සාව
neurosis=නියුරෝසියාව | ස්නායු රෝගය | ස්නායුවිකාරය | ස්නාස්‍යය
neuroterminal=ස්නායු අග්‍රය
neurotic=නහර ලෙඩින් පෙළන | නියුරෝසි | නියුරෝසික | ස්නායු විකාරියා | ස්නායුව්‍යාධික | ස්නායුවිකාරී | ස්නාස්‍යක
neurotomy=ස්නායු ව්‍යවච්ඡේදය
neurypnology=ස්නායුවශි වේදය
neuter=නපුංසක | නිපුස් | නිර්ලිංගිකි | වඳ පුෂ්පය
neutral=අනුභය | අපක්ෂග්‍රාහී | අපක්ෂපාත | උදාස | උදාසීන | උදාසීනය | නිර්ලිංගිකි | මධ්‍යස්ථ | විශේෂයක් නැති
neutralisation=උදාසීනකරණය | උදාසීනීකරණය | මධ්‍යස්ථකරණය | මැදිහිටිකූරුව
neutralised=මධ්‍යස්ථකෘත | මැදිහිටිකළ
neutralism=අනුභයවාදය | මධ්‍යස්ථතාවාදය | මධ්‍යස්ථවාදය
neutralist=මධ්‍යස්ථවාදියා
neutrality=උදාසය | මධ්‍යස්ථතාව | මධ්‍යස්ථභාවය | මැදිහිටියාව
neutralization=උදාසකරණය | උදාසීනිකරණය | නිෂ්ප්‍රභ කිරීම | මධ්‍යස්ථකරණය
neutralize=උදාසනය | උදාසීන කරනවා | නිෂ්ප්‍රභ කරනවා | බල නැති කරනවා
neutretto=නියුට්‍රෙටෝව
neutrino=නියුට්‍රිනෝව | විද්‍යුත් ආරෝපණය හා ස්කන්ධය ශූන්‍ය වූ මූලික අංශු
neutron=න්‍යට්‍රෝනය | නියුට්‍රෝනය
nevados=නෙවාඩෝ සුළං
neve=නේවේ හිම කැට
never=කවදාවත් | කවදාවත් නැති | කිසි විටෙකත් නැති | සම්මජ්ජාති | සම්මජාති
nevertheless=එතකුදු | එතකුදු වුවත් | එතෙකුදු වුවත් | එසේ නමුත් | එහෙත් | නුමුත්
nevus=න්‍යච්ඡය
new=අභිනව | අමුතු | අලුත | අලුත් | කෝඩු | දහර | නව | නවීන | නුපුරුදු | නූ | වෙනස් | ළඟදී
new-born=නවජාත
new-fangled=අලුත් තාලේ | නූතන
new-moon=අමාවක | නව සඳ | නවසඳ
newborn=නවජයා
newel=තරප්පු පේළියක ප්‍රධාන කණුව | පියවළ
newly=අභිනවයෙන් | අලුතෙන්
newmoonday=අවපසළොස්වක
newness=අලුත්කම
news=ආරංචි | ආරංචිය | තොරතුර | පුවත | ප්‍රවෘත්ති | ප්‍රවෘත්තිය | පුවත | පුවත් | රාවය | වග | විත්ති | සරූප | ස්වරූපය | හෝඩුවාව
news-reel=ප්‍රවෘත්ති අඩංගු සේයාපටය
news-stand=පත්‍ර විකුණන තැන
news-vendor=පත්‍ර විකුණන්නා
news.print=ප්‍රවෘත්ති පත්‍ර කඩදාසිය
newsletter=ප්‍රවෘත්ති හසුන | පුවත් පත්‍රිකාව | පුවත්ලිපිය
newsmedia=ප්‍රවෘත්ති මාධ්‍ය
newsmonger=පුවත්සොඬා
newspaper=ප්‍රවෘත්ති පත්‍රය | පුවත් පත | පුවත්පත
newspool=ප්‍රවෘත්ති සංසදය
newsprint=පත්‍ර කඩදාසි | පත්‍ර කඩදාසිය | පුවත්පත් කඩදාසි
newssheet=කුඩා ප්‍රවෘත්තිපත්‍රය
newsworthy=ප්‍රවෘත්තියෝග්‍ය
newsy=ප්‍රවෘත්තිවලින් පිරුණු
newt=කබරගොයා වැනි සතෙක් | දිය හූනා | දියහූනා
newton=නිව්ටනය | බලය මැනීමේ ඒකකයක්
next=අනතුරුව | අනන්තර | අනුව | අල්ලාපු | ඉක්බිති | ඉතා කිට්ටු | ඊගාවට | ඊළඟ | ඊළඟට | ඊගාව | එක්බිති | එහා | ඒ ළඟ | තදනත්තර | නැවත | යා | ලබන | සමනත්තර
next-door=අල්ලපු ගෙදර
next-friend=නඩු සහායක
next-of-kin=කිට්ටුතම නෑයා | ලඟ ම නෑයා | ලඟම නෑයා
nexus=බන්ධකය | බන්ධනය | බැඳිය | සම්බන්ධය
niacin=නිකොටිනික් අම්ලය
nib=තුඩ | පෑන් තලය | පෑන්තලය | පුඩුව | හොට
nibbana=අජරාමර | අජාත | අමත | ඛේම | නිර්වාණ | නිවන | පරිනිර්වාණ | මොක් | මොක්පුරය | මෝක්ෂ | ශාන්තිපද | ශාන්තිපුර | සාන්තිපුර | සිව
nibble=කොත්තු කරනවා | ඩිංග | නිබලය | ලෑටි ගානවා | ලෑටිගානවා
niblick=ගොල් පිති වර්ගයක්
nibs=පොඩි කරන ලද කොකෝවා ඇට | පොඩි කරන ලද කෝපි ඇට
nice=කදිම | තීක්ෂ්ණ | ප්‍රිය | මනා | මනෝඥ | රස විඳීමෙහි දක්ෂ | සියුම්
nicety=ඉතා සුළු වෙනස | සියුම් බව
niche=අවකාශය | නිකේතනය | සුදුසු ස්ථානය
nichrome=නයික්‍රෝම් | නික්‍රෝම්
nicht-ich=අනාධ්‍යාත්මය
nick=කත්තු කපනවා | කත්තුව | සිදුර | හොරෙන් ගන්නවා
nick-name=විකටනාමය
nickel=නිකල්
nicker=එංගලන්තයේ පවුම | කත්තු කටුව
nickethamide=නිකතමයිඩ්
nicking=කත්තු කැපීම
nickname=අපනාමය | පද බඳිනවා | පදහදනවා | විකට නම
nicol=නිකලය
nicotin=නිකටීන්
nicotine=නිකටින් | නිකොටින්
nictitate=නිවී පත්තුවෙනවා
nidus=නීඩය
niece=ණිහිණිය | ණිහිය | ලේලි
niederblatter=අධහ්පත්‍රය
niello=නියෙල්ලෝ විධික්‍රමය | නියෙල්ලෝව
niff=ගන්ධයක්
niffy=දක්ෂ | හැඩකාර
niggard=මසුරා | ලෝභයා
niggardly=මසුරු
nigged=නිඛාතය
nigger=කල්ලා
niggle=පටු ලෙස විවේචනය කරනවා
niggling=කේවෙල් කිරීම | තුච්ඡ | මසුරු | වැදගැම්මකට නැති
nigh=ළඟ | ළඟින්
night=අන්ධකාරය | අඳුරු සමය | නිශා | නිශාව | නිස | රජනි | රජනී | රාත්‍රි | රාත්‍රිය | රැය | ශර්වරී | ශාර්වරී
night-bird=තැනින් තැන යන තැනැත්තා | නිශාචර පක්ෂියා
night-blindness=ඇඳිරිය | කණ | තමස් අන්ධතාව | රෑට ඇස් නොපෙනීම
night-club=රාත්‍රී සමාජශාලාව
night-fall=ඇඳිරි වැටීම
night-long=මුළුල්ලම
night-school=රාත්‍රි පාඨශාලාව
night-terror=තමස් භීරුකතාව
night-watch=රැකවල
nightfall=නිශාමුඛය
nightie=ඇඳුම
nightingale=කොවුලා
nightjar=පක්ෂියෙක්
nightly=කෙරෙන | හැමදා ට
nightmare=දුස්ස්වප්නය | නපුරු සිහිනය | භයජනක අත්දැකීම | මහත් භයට හේතුව | රාත්‍රි භීභත්සය
nightmare-walker=නිද්‍රාචාරක
nightshade=විෂ ගෙඩි ඇති වල්පැළෑටි විශේෂයක්
nightwatch=රාත්‍රියාමය
nighty=ඇඳුම
nigrescent=මඳක් කළුවන්
nihilism=නාස්තික දෘෂ්ටිය | නාස්තිකවාදය | නාස්තිවාදය | ශූන්‍යවාදය
nihilist=නාස්තිවාදියා | ශූන්‍යවාදියා
nike=නීකා දෙවඟන
nil=කිසිත් නැති බව | බෝයි | ශූන්‍යය
nilfactor=අධිශූන්‍ය සාධකය
nilpotent=අධිශූන්‍යභාවී
nim=නිම් ක්‍රීඩාව
nimble=ඉක්මන් | කඩිසර | චතුර | යුහු | ශීඝ්‍ර
nimbleness=කඩිසරකම
nimbus=පරිවේශය | ප්‍රබා මණ්ඩලය | ප්‍රභාමණ්ඩලය | රංසි මාලාව | රැස් වළල්ල | ව්‍යාමප්‍රභා | වැසි වළාකුළ | වැහි වලාකුළ
nincompoop=ගුඩ්ඩයා | නිවටයා | මෝඩයා
nine=නමය | නවය
ninefold=කොටස් නවයකින් යුත් | නවගුණයක් | නවවරක් | නවවිධ
ninepins=ලී කොට නවයකින් යුත් ක්‍රීඩාවක්
nineteen=දහනවය
ninetieth=අනූවැනි
ninety=අනූව
ninny=මූර්ඛයා
ninth=නවම | නවවැනි
niobium=නයෝබියම්
nioblum=විරල ලෝහමය මූලද්‍රව්‍යයක්
niose=කරච්චලය
nip=අධික ශීතල | කරටිය කඩා දැමීම | කුඩා මත්පැන් වීදුරුව | කෙනිත්තීම | කොනහනවා | කොනිත්තනවා | ඩිංග | තදින් මිරිකීම | වනසනවා | වැම නතර කරනවා | වැම නවත්වනවා | හනු කෝණය
nipper=අඬුව | සිඳුව | සුරුබුහුටි කොල්ලා
nipple=චූචුක | චූචුකය | තනපුඩුව | පුඩුව
nipples=අඬුව
nipponese=ජපන් බස
nippy=කඩිසර | ශීතල
nisus=ව්‍යායාමය
nit=ලේඩියා | ලේයා
nitrading=නයිට්‍රජන් දැඩියම
nitramon=නයිට්‍රැමෝන්
nitrate=නයිට්‍රික් අම්ලයේ ලවණය | නයිට්‍රේට් | නයිට්‍රේට් අම්ලයෙන් නිශේචනය කරනවා
nitrated=නයිට්‍රෝකෘත
nitration=නයිට්‍රජන් දැඩියම | නයිට්‍රෝකරණය
nitrator=නයිට්‍රෝකාරකය
nitre=නයිටර් | වෙඩිලුණු
nitric=නයිට්‍රික්
nitride=නයිට්‍රජන් අඩංගු සංයෝගය | නයිට්‍රයිඩ්
nitriding=නයිට්‍රජන් දැඩියම
nitrifiable=නයිට්‍රීකාරක
nitrification=නයිට්‍රීකරණය
nitrifier=නයිට්‍රීකාරකය
nitrify=නෛට්‍රෛට් හෝ නයිට්‍රෙට් බවට පත් කරනවා
nitrifying=නයිට්‍රීකාරී
nitrite=නයිට්‍රයිට්
nitro=නයිට්‍රජන් හා අම්ලකර සම්බන්ධ
nitro-lime=නයිට්‍රොලයිම්
nitrobacter=නයිට්‍රේට බැක්ටීරියා | නයිට්‍රොබැක්ටර්
nitrobacteria=නයිට්‍රොබැක්ටීරියා
nitrocellulose=නයිට්‍රොසෙලියුලෝස්
nitrogen=ජීවාන්තක | නත්‍ර වායුව | නයිට්‍රජන් | නයිට්‍රජන් වායුව | වාන්තක වායුව
nitrogenated=නයිට්‍රජනීකෘත
nitrogenization=නයිට්‍රජනීකරණය
nitrogenous=නයිට්‍රජනීය
nitroglycerene=නයිට්‍රොග්ලිසරීන්
nitroglycerine=නයිට්‍රොග්ලිසරීන්
nitrometer=නයිට්‍රොමීටරය
nitroniumion=නයිට්‍රෝනියම් අයනය
nitrophilous=නයිට්‍රොකාමී
nitrophyte=නයිට්‍රොශාකය
nitroprusside=නයිට්‍රොප්‍රසයිඩ්
nitrosomonas=නයිට්‍රයිට් බැක්ටීරියා | නයිට්‍රොසොමොනාස්
nitrous=වෙඩිලුණු
nitty-gritty=ඇත්ත ඇති සැටියෙන්
nival=හිම
nivation=හිම ඛාදනය
nix=කිසිත් නෑ | සුම්මා
no=එපා | නහමක් | නැත | නැති | නැහැ | නෑ | නි | නිහ් | බැහැ | බෑ
noasting=නාස්තිංගය | ප්‍රථමයෙන් මිලට ගැනීමේ අයිතිය
nob=ඔළුගෙඩිය | බක්කා
nobbing=තැලීම
nobby=හොඳින් ඇඳ පැළඳ ගත්
nobelium=කෘත්‍රිම මූලද්‍රව්‍යයක්
nobility=අභිජාත පෙළැන්තිය | අභිජාතතාව | අභිජානතාව | උදාරභාවය | කුලීන පන්තිය | කුලීන පෙළැන්තිය | කුලීනතාව | රදළ පෙළ | ශ්‍රෙෂ්ඨත්වය
noble=අග්‍ර | අරිය | අරී | අලාමක | ආර්ය | ආරිය | උත්තම | උතුම් | උදාර | උසස් | කල්‍යාණ | කුලීන | කුලීනයා | නෝබලය | පරම | පවර | ප්‍රවර | ප්‍රශස්ත | මංගල්‍ය | මඟුල් | මහ | මහත් | මහාත්ම | මහේශාක්‍ය | රදළ | වංශවත් | වංශාධිපතියා | වර | විශිෂ්ට | විහිඟුම් | ශ්‍රී | ශ්‍රීමත් | ශ්‍රේෂ්ඨ | සභ්‍ය | සාධු | සිංහ | සිරි | සුපිරි | හේලී
nobleman=කුලීනයා | වංශාධිපතියා | සිටාණ
nobleness=උතුම්කම | උදාරභාවය
noblesse=උසස් කම | වංශාධිපතිවරු
nobly=උදාර ලෙස
nobody=කිසිවෙක් නොවේ | වැදගැම්මකට නැති තැනැත්තා | සොච්චමා
nocive=හිංසක
nock=දුන්නෙහි හීය රැඳවීමට ඇති තන්තුව
noctambulist=නිද්‍රාචරයා
noctilucent=ශානිභාෂක
nocturnal=නිශාගත | නිශාචර | රාත්‍රිගත
nocturne=නිශාගීතය | නිසා දසුන
nocuous=පීඩාකර | හිංසා ගෙනදෙන
nod=අණ | කිරා වැටෙනවා | ශීර්ෂ අනුමතිය | ශීර්ෂ ප්‍රණාමය
nodal=ගැට
nodding=කිබිසි
noddle=ඔළුගෙඩිය
noddy=මුහුදු පක්ෂියෙක්
node=ඉදිමුම | කාප්ප ගැටය | ගණ්ඨීය | ගැටය | නිෂ්පන්දය | නෝඩුව | පාතය | පුරුකය | මංසල
node-locus=ගැට පථය
nodiferous=ගැට සහිත
nodose=ගැට සහිත
nodular=කුඩා ගැට සහිත | ගැටිති
nodule=කුඩා ගැටය | ගැටිත්ත | පුරුක
nodulose=ගැටිති සහිත
nodvoid=ග්‍රන්ථිකාභය
noegenesis=නූජනනය
noel=නත්තල් උත්සවය
noema=අභිඥානය
noematic=අභිඥානික
noesis=අධිඥාව
noetic=අධිඥ | අභිඥාන
nog=කට්ටය | කුඩා ලී ඇබය | බීර විශේෂයක්
noggin=කුඩා ලී භාජනය
nogging=ලී රාමුවක කරනලද ගඩොල් ඇතිරීම
noh=ජපානයේ නාට්‍ය විශේෂයක්
noils=පනා රොඩු | පනාරොඩු
noise=අජ | අනපේක්ෂිත තොරතුරු | කෝලාහලය | ගාලගෝට්ටිය | ගිගුම | ගිගුරුම | ගොස | ගෝට්ටිය | ඝෝෂාව | ප්‍රසිද්ධකර හරිනවා | ප්‍රසිද්ධිය | මහත් ශබ්දය | රවණ | ශබ්ද | ශබ්දය | සද | ස්වර | හජ
noiseless=නිශ්ශබ්ද
noisome=දුර්ගන්ධ | සනීපයට බාධක
noisy=කෑගසන | මහත් ශබ්ද ඇති
nolition=අනිච්ඡාව | අනිෂ්ටිය
nom-de-plume=ආරූඩ නාමය | ආරූඩනාමය
noma=නෝමාව
nomad=එඬේරා | තණබිම් ශාකය | තැනින් තැන හැසිරෙන්නා | සංචාරක
nomadic=අගම් | සංචාරක | ස්ථීර පදිංචියක් නැති
nomadism=එඩේරියාව | එඬේරතාව | එඬේරියාව | සංචාරක විතය | සංචාරලෝලය
nomen=දෙවෙනි නාමය
nomenclature=නාම නිඝණ්ඩුව | නාමකරණ | නාමකරණය | නාමනිඝණ්ඩුව | නාමපද්ධතිය | නාමාවලිය | නිඝණ්ඩුව | පරිභාෂික ශබ්දාවලිය
nomic=රීතික | ව්‍යවහාරික | ස්වභාවික
nominal=ඉතා සුළු | නමින් පමණක් වූ | නාමමාත්‍ර | නාමසම්බන්ධී | නාමික | නිශ්ඵල | මතිමාත්‍ර
nominalism=නාමමාත්‍රවාදය | ශබ්දාර්ථභේදවාය
nominally=නමට | නාමමාත්‍ර වශයෙන්
nominate=නම් කරනවා | නම්කරනවා | නාමයෝජනා කරනවා | පත් කරනවා | යෝජනා කරනවා
nominated=පත් කළ
nomination=නම් කිරීම | නම් යෝජනා කිරීම | නාම යෝජනාව | නාමයෝජනාව
nominee=නම් කළ තැනැත්තා | නම්කරන ලද තැනැත්තා | නම්කල තැනැත්තා | නාමිකයා | නාමිතයා | නියෝජිතයා
nomium=තෘණප්‍රජාව
nomogram=විධිරේඛය | විධිලේඛය
nomograph=නියාමරේඛය | විධි රේඛය | විධිරේඛකය | විධිරේඛය
nomographic=විධි රේඛික | විධිරේඛික
nomography=නියාමරේඛනය | විධිරේඛනය | විධිලේඛය
nomology=න්‍යායවේදය | විධිවේදය
nomophilus=තෘණකාමී
nomothetic=ව්‍යවස්ථිතික
non=නැති | වි
non-ability=නොහැකියාව
non-acceptance=අප්‍රතිග්‍රහණය
non-access=නොපැමිණියාව
non-accumulating=අසංචේය
non-act=නොකිරිය
non-adjustable=සැකසිය නොහැකි
non-age=අඩුවයස | නුපුණු වයස
non-alcoholic=අමද්‍යු
non-aligned=කිසිම කඳවුරකට නොබැඳුණ | නොබැඳි
non-appearance=පෙනී නොසිටීම
non-application=අදාළ නොවීම
non-aqueous=අජලීය
non-aristotalism=අනැරිස්ටෝටලියානු
non-assistance=අනුපකාරය
non-associating=අසංඝටන
non-attachment=විරතිය
non-attendance=නොපැමිණීම | පැමිණ නොසිටීම
non-availability=නිරුපයෝජ්‍යතාව
non-axial=අනාක්ෂක
non-bailable=ඇප දිය නොහැකි
non-being=අසත්තාව | නිස්සත්තාව
non-belligerency=යුද්ධයට නොබැඳි
non-bonded=නිර්බන්ධිත
non-bonding=නිර්බන්ධනීය
non-buddhistic=අබෞද්ධ
non-buddist=අබෞද්ධයා
non-chemically=අනෛන්ද්‍රීය | ඓන්ද්‍රීය
non-circular=අවෘත්තාකාර
non-co-operation=අසහයෝගය
non-cognizable=අසංඥෙය
non-coincidence=අසම්පාතය
non-coincident=විසම්පාත
non-combatant=සිවිල් ජනයා
non-comformity=අනනුකූලතාව
non-commercial=අවාණිජ
non-commissioned=අධිකාරය නොලත්
non-commitment=නොකැපවීම
non-committal=පැත්තක් නොගත්
non-commutative=නිර්න්‍යාදේශ්‍ය
non-compensating=හානිපූරණ කළ නොහැකි
non-compliance=අනනුරූපතාව | ඉටු නොකිරීම
non-conductor=අසන්නායකය
non-conformist=අනනුකූල නිකායිකයා | අනනුකූලයා | අනනුසාරියා | භින්නමතිකයා
non-conformity=අනනුකුලතාව | අනනුකූලතාව
non-connotative=නිර්ගුණාර්ථක
non-constitutional=අසංස්ථීතික | ආණ්ඩුක්‍රමික නොවූ
non-contentious=අප්‍රතිවාදක
non-contingent=අනාපතික
non-contradiction=අප්‍රතිවිරෝධය | අවිසංවාදය
non-cooperation=අනුපකාරය | අනුපකාරී | සහයෝගතා වර්ජනය | සහයෝගතාවෙන් ක්‍රියා නොකිරීම
non-cooperative=අනුපකාරී
non-correlated=අසම්බන්ධිත
non-corrosive=අවිඛාදක
non-crawl=තෙත් කාරකය
non-creep=තෙත් කාරකය
non-critical=අවිචාරාත්මක
non-cumulative=අසමුච්චෙය
non-defamatory=අනපකීර්තිකාරී
non-delivery=බාර නොදීම
non-direction=නිර්දේශ නොකිරීම
non-disclosure=නොහෙලිකිරීම | නොහෙළි කිරීම
non-ego=අනහම | නිරාත්මය
non-electrolyte=විද්‍යුත් අවිච්ඡේද්‍යුය
non-endospermic=නිර්භ්‍රෑණපෝෂී
non-enmity=අවෛරය
non-entry=ඇතුළු නොවීම
non-erecting=අනූර්ද්වකාරක
non-essential=අනවශ්‍ය
non-event=නොවැදගත් සිද්ධිය
non-existence=අභාවය | අසත්තාව | නොපැවැත්ම
non-existent=අභූත | අවිද්‍යමාන | අසත් | නොපවත්නා | වත් නොවන | විද්‍යාමාන නොවන
non-expressive=අප්‍රකාශක
non-fatal=අසාධ්‍ය නොවන | මාරක නොවන
non-feasance=අකතනීතිකරය | පැහැර හැරීමේ වරද
non-ferrous=යමුසු නොවන | රෙස් නොවන
non-fiction=අප්‍රබන්ධ | ප්‍රබන්ධ නොවන | සම්පූර්ණයෙන් ප්‍රබන්ධිත නොවන සාහිත්‍ය නිර්මාණය
non-figurative=අනාලංකාර | අරූපික
non-flame=අදීප්ත දැල්ල
non-forgeable=හැඩතැළිය නොහැකි
non-formal=අවිධිමත් | නිරාකෘතික
non-holonomic=අපරිකල්‍ය
non-homogeneous=නොසමජාතීය
non-horizontality=නොතිරස්තාව
non-indictable=අනධිචෝදනීය
non-injury=අවිහිංසාව
non-intersecting=ඡේදනය නොවන | නිශ්ඡේදන
non-intervention=අන් අයගේ මතභේදවලදී මැදහත් නොවීමේ ප්‍රතිපත්ති
non-ionic=අනයනික
non-ionized=නිශ්අයනීකෘත
non-legal=අනෛතික
non-liability=අනාධීනත්වය | වගසිටු රහිත බව
non-linear=අරේඛීය | නිරේකජ
non-linearity=නිරේකජතාව
non-loaded=නොබැරැලූ
non-luminous=අදීප්ත
non-magnetic=අචුම්බක
non-material=අද්‍රව්‍යමය
non-metal=අලෝහය
non-metering=අමානනය
non-monetary=අමූල්‍ය | මූල්‍ය නොවන
non-moral=අසදාචාර
non-novel=නොනවකතාව
non-objective=අවෛශයික
non-observation=අනීරීක්ෂණය
non-owning=අහිමි
non-parallel=අසමාන්තර
non-parallelism=අසමාන්තරතාව
non-parametie=අපරාමිතික
non-parametric=අපරාමිතික
non-participating=අසහභාගී | සහභාගී නොවන
non-party=දේශපාලන පක්ෂවලින් මිදුණ
non-payment=නොගෙවීම
non-periodic=අනාවර්ත
non-planar=අතල
non-polar=නිර්ධ්‍රැවීය
non-polarized=අධ්‍රැවිත
non-praedial=අභූමික
non-presentment=ඉදිරිපත් නොකිරීම
non-prnunciation=අනුච්චාරණය
non-professional=අවෘත්තීය
non-proliferation=න්‍යෂ්ටික ආයුධ සීමාකිරීම
non-proportional=අසමානුපාතික
non-proprietary=හිමිකාර නොවූ
non-prosecution=අනභිචොදනය
non-protonic=නිර්ප්‍රෝටෝනික
non-random=නිස්සසම්භාවී
non-rational=නිර්බුද්ධික
non-reactive=අප්‍රතික්‍රියා
non-reciprocal=අපරස්පර
non-recognition=ප්‍රත්‍යනභිඥානය
non-recurrent=අප්‍රතිවර්තන
non-recurring=අසමාවර්ත
non-reflexive=අපරාවර්තී
non-removable=ඉවත් කළ නොහැකි
non-representational=අනිරූපාත්මක
non-residence=නොපදිංචිය | පදිංචි නො වීම
non-resident=නොපදිංචි | පදිංචිනැති | පදිංචිය නැති
non-residue=නිරවශිෂ්ට
non-resonant=අනනුනාදක
non-response=නිෂ්ප්‍රතිචාරය
non-retentive=ආධාරණ
non-returner=අනාගාමී
non-reversible=අප්‍රතිවර්ත්‍ය
non-right=අදෘඩ
non-sensory=අසංවේද්‍යු
non-sensuous=අනින්ද්‍රියික | ඉන්ද්‍රිය විප්‍රයුක්ත
non-sequitur=නගම්‍යත | නො හැඟෙන | නොහැගෙන | නොහැඟේ
non-seuit=නඩුකරය ප්‍රතික්ෂේප කරනවා
non-sexual=අලිංගික
non-singular=අනපූර්ව
non-skid=නොලිස්සන
non-smoker=දුම් නොබොන්නා
non-social=අසාමාක
non-starter=නිකමා
non-stick=නොඇලවෙන
non-stop=නොනැවත ක්‍රියා කරන
non-such=උතුම් ආදර්ශය | ශ්‍රේෂ්ඨ පුද්ගලයා
non-suggestibility=අව්‍යංග්‍යතාව
non-suit=නඩුවක් පවත්වාගෙන යාම නතර කිරීම
non-summary=ලඝු නොවන | සංක්ෂේපණීය නොවූ
non-summons=සිතාසි බාර නොදී
non-symbolic=අසංකේතාත්මක
non-symmetrical=සමමිතික නොවන
non-systematic=අක්‍රමවත්
non-tenure=බුත්තියක් නැති | හිමිකමක් නැති
non-terminal=අනග්‍රස්ථ
non-tidal=වඩ බා දිය නොමැති
non-toxic=නිර්විෂ | විෂ නැති
non-transiting=අසංක්‍රාන්ති
non-transitive=නිස්සංක්‍රාම්‍ය
non-union=වෘත්තීය සමිතියකට අයිති නැති
non-user=අප්‍රයෝජනය | නොපාවිච්වය | ප්‍රයෝජනය නොගැනීම
non-vacuolate=නිර්රික්තක
non-valent=අසංයුජ
non-variant=අවිචල
non-vascular=විනාල
non-vertical=නොසිරස්
non-verticality=නොසිරස්තාව
non-viable=නිර්ව්‍ය
non-violence=අවිහිංසාව
non-voluntary=නිරිච්ඡානුග
non-voting=අයිතිකරුට ඡන්දය දීමේ වරප්‍රසාදය නැති
non-worldy=අලෞකික
nonage=බාලාවස්ථාව
nonagenarian=අනුහැවිරිද්දා
nonagon=නවපට්ටම | නවාශ්‍රය | නවාස්‍රය
nonary=නවමය
noncause=අහේතුව
nonce=මේ අවස්ථාව
nonchalance=උදාසීනකම
nonchalant=උදාසීන | නොසැලකිලිවන්ත
nonconformist=අනනුකූල පුද්ගලයා
nonconformity=අසදෘශතාව | එකඟ නොවන බව
nondescript=අනියම් | විවිධ | විශේෂ ලක්ෂණ නැති
none=කිසිවෙක් නැත | කිසිසේත් නැත
nonentity=අස්ථීතිය | වැදගැම්මකට නැති තැනැත්තා | සොක්කා
nones=පුරාණ රෝම දිනදර්ශනයේ එන දිනයන්
nonfinito=නොනිමිය
nonius=නෝනියස්
nonliterate=අනක්ෂර
nonnaturalism=අතාත්විකවාදය | අස්වභාවවාදය
nonpareil=අසදෘශ | අසහාය
nonplus=අන්දුන් කුන්දුන් කරනවා | කලබල කරනවා
nonsense=අණ්ඩර දෙමළ | අනන්මනන් | අර්ථශූන්‍ය | අර්ථශූන්‍යය | නිරර්ථක | නිරර්ථක කථා | නිරර්ථය | ප්‍රලාප | ප්‍රලාපය | මනස්ගාත | මැත | විකාර | විප්‍රලාපය | විලම්බීතය | සුනරුත
nonsensical=නිරර්ථක | විකාර
nonstop=අඛණ්ඩ | නොනැවතී
noodle=නෝන්ජලයා | මෝඩයා
noodles=චීනුන්ගේ ආහාර වර්ගයක්
nook=මුල්ල
noology=මානසවිද්‍යාව | මානසවේදය
noon=ඉර මුඳුන් වේලාව | ඉරමුදුන | මධ්‍යාහ්නය
noontide=මධ්‍යාහ්නය
noose=තොණ්ඩු දමා අල්ලනවා | තොණ්ඩුව | පාගුලිය | පාශය | පාසය | මලපුඩුව
noosphere=මානසගෝලය
nooze=මල
nor=ත් නැත | ත් නොවේ
nordic=නෝඩික | ස්කැන්ඩිනේවියාවේ ජන කොට්ඨාසයකට අයිති
noria=නෝරියාව
norm=ආදර්ශය | ධර්මතාව | ධර්මය | න්‍යාය | නියමය | ප්‍රතිමානය | ප්‍රමාණය | මිම්ම | සම්මත | සාමාන්‍යය
normal=අනුප්‍රමාණ | අභිලම්බ | අභිලම්බය | අවිශේෂ | ප්‍රකෘති | ප්‍රකෘතිමත් | ප්‍රමත | ප්‍රමානික ලාභය | ප්‍රමිත | ප්‍රාමණික | ප්‍රාමාණික | පියවි | පෘථජ්ජන | යථා | යථාවිධ | විධිවත් | සමක | ස්වාභාවික | සාම්‍ය | සාමාන්‍ය | සාමාන්‍ය නියමයට එකඟ
normalcy=සාමාන්‍යත්වය
normalising=සමනය
normality=පතිමානකතාව | ප්‍රතිමානිකතාව | ප්‍රමතිය | පියවි බව | යථාක්‍රමත්වය | යථාවිධතාව | සමකත්වය
normalization=ප්‍රමත කිරීම | ප්‍රමතකරණය | සාමාන්‍යකරණය
normalize=ප්‍රමත කරනවා | යථා තත්වයට පත් කරනවා
normalizer=ප්‍රමතකාරකය
normalizing=සමනය | සමනය කිරීම | සාමාන්‍යකරණය
normally=සාමාන්‍යයෙන්
normaly=සාමාන්‍ය තත්ත්වය
norman=නෝර්මන්ඩිහී වැසියා
normative=ප්‍රතිමානක | ප්‍රාමාණික
normogram=විධිරේඛය
normosplanchnic=ආරෝහපරිණාහ සම්පන්න | සමංග
norms=ප්‍රතිමාන
norny=සිඟුවත්
norse=නෝර්වේයානු භාෂාව
norte=නෝට් සුළං
north=උත්තර | උතුර | උතුරු
north-east=ඊශාන | ගිකිකොණ
north-pole=උත්තර ධ්‍රැවය | උත්තරධෘවය
north-west=වයඹ | වායඛ්‍ය
northener=උතුරේ පදිංචිකරුවා
norther=උතුරු සුළඟ
northerly=උතුරු දෙසෙහි වූ | උතුරෙන් එන | උතුරෙහි
northern=උත්තර | උතුරු | උතුරු දෙසෙහි වූ | උතුරෙන් එන | උතුරෙහි
northerners=උතුරුදිග වාසීහු | උතුරුදිගුවෝ
northernmost=උතුරට ඉතා කිට්ටු
northers=උතුරු සුළං
northings=උතුරු දිගටි
northmost=උතුරට ඉතා කිට්ටු
northward=උතුරු දිශාවට වූ
northways=උතුරු දෙසට
norwegian=නෝර්වේ රටට අයිති
norwester=වයඹ සුළඟ
nose=අයුතු සේ මැදිවෙනවා | ඉවඅල්ලනවා | ඝ්‍රාණය | ඝාන | තුඩ | නහය | නාශිකාව | නාසය | නැහැය | මූණත | හොට
nose-cone=කේතුවක් වැනි නහය
nose-string=නාස් ලණුව
nosebleed=නාසයෙන් ලේ ගැලීම
nosedive=අහස්‍යාත්‍රාවක් ලම්බාකාරව පහත්වීම
nosegay=මල් පොකුර
nosepiece=නාසැස්ස | නැහැකඩ | ප්‍රතිනාසිකය
nosering=නාසාලංකාරය
nosh=අනුභව කරනවා
nosing=නාසිකාව | පැද්දුම් භාරය
nosogenesis=ව්‍යාධි සම්භවය
nosophobia=ව්‍යාධි භීතිකාව
nostalgia=කාන්සාව | සාංකාව
nostalgic=කාන්සා ඇති | සාරාණීය
nostril=නාස් පුඩුව | නාස්පුඩුව | නාසාවිවරය
nostrils=නාස් පුඩු | නාසා විවර
nostrum=රහස් බෙහෙත
nosy=විමසිලිමත්
not=නහමක් | නැත | නැති | නි | නිහ් | නො | නොවේ
notabilia=සටහන් කළයුතු දේ | සිහියේ තබාගතයුතු සේ
notability=ප්‍රසිද්ධ තැනැත්තා | ප්‍රසිද්ධිය
notable=විශිෂ්ට | සංගණ්‍ය | සැලකියයුතු | සිහිකළයුතු
notarial=නොතාරිස් | නොතාරිස් පිළිබඳ වූ
notary=නොතාරිස්
notation=අංකනය | ප්‍රස්තාරය | සලකුණු කිරීම | සලකුණෙන් දැක්වීම | ස්වර ලිපිය
notch=අටණිය | අටනිය | කට්ටය | කත්තු කපනවා | කත්තුමල්ලිය | කත්තුව
notched=කට්ට වැටුණු
notcher=අටනි කපනය
notching=අටනි කැපීම | කට්ට කැපීම
note=කුඩා ලිපිය | තුණ්ඩුව | දීපිකාව | ධ්වනිය | නෝට්ටුව | ප්‍රසිද්ධිය | මුදල්පත | වට්ටෝරුව | විස්තර ලියනවා | විස්තරය | සටහන | සටහන් කරගන්නවා | සටහන් කරනවා | සටහන් ලියනවා | සණ්ඨානය | සන්නිවේශය | සඳහන | සලකුණ | සලකුණු කරනවා | ස්වරය | සැඳහුම | සැලකිල්ල
note-blindness=ස්වරාන්ධතාව
note-paper=ලියුම් ලියන කඩදාසිය
notecase=සටහන් පත්‍ර කවරය
notelet=කුඩා ලියුම් කැබැල්ල
notepaper=ලියුම් ලියන කඩදාසිය
notes=නෝට්ටු
noteworthy=සැලකියයුතු
nothing=අභාවය | ආකිංචන්‍යය | කිසිත් නැතිබව | ශූන්‍යය
nothingness=අකිංචනය | අභාවය | ශූන්‍යය
nothings=පොඩි පොඩි දේ | වැදගැම්මකට නැති දේ
notice=ආවේදනය | කලින් දැනුම්දීම | දකිනවා | දැන්වීම | දැනුම | දැනුම්දීම | නිවේදනය | නොතීසිය | ප්‍රකාශනය | ප්‍රසිද්ධිය | විඥාපනය | විවේචනය | සැල | සැලකිල්ල | සැලකිල්ලට භාජන කරනවා
notice-board=දැන්වීම් පුවරුව
noticeable=නිවේදනීය | ප්‍රකට | ප්‍රත්‍යක්ෂ | සැලකිය යුතු
notification=දැනුම්දීම | නිවේදනය | ප්‍රකාශ පත්‍රය
notified=නිවේදනය කළ | නිවේදිත
notify=දැනුම් දෙනවා | නිවේදනය කරනවා | ප්‍රසිද්ධ කරනවා
noting=සටහන් කිරීම
notion=කල්පනාව | ගුණය | ප්‍රත්‍යය | මතය | මතිය | සංකල්පනය | සංකේතය | හැඟීම
notional=කාල්පනික
notochord=පෘෂ්ඨ රජ්ජුව
notoriety=අපකීර්තිය
notorious=අපකීර්තියට පත්ව සිටින | කුප්‍රකට | කුප්‍රසිද්ධ | දුෂ්ප්‍රසිද්ධ | ප්‍රකට | විඛ්‍යාත
notoriously=ඉතා නරක ලෙස | එතකුදු වුවත් | එසේ තිබිය දීත්
notre-dame=නෝට්‍රඩෑම්
notwithstanding=එතකුදු වුවත් | එසේ තිබිය දීත්
nougat=පැණි හෝ සීනිවලින් සාදන රසකැවිලි විශේෂයක්
nought=බින්දුව
noumenon=නිෂ්ප්‍රපංචය | ස්වායත්තය
noun=නාම පදය | නාමපදය | නාමය
nourish=ඇතිදැඩි කරනවා | ජීවත් කරනවා | පුසිනවා | පොහොනි කරනවා | පෝෂ්‍ය කරනවා | රස්සා කරනවා | වඩනවා | වඩවනවා | සාත්තු කරනවා | හදනවා
nourished=වැඩූ
nourishing=දැඟුම් | ධාත්‍රී | පෙහෙණිය | පෝෂක | පෝෂ්‍යදායී
nourishment=ආහාර | පෝෂණය
nous=අභිවත්තය | ධීය | සාමාන්‍ය දැනීම
nouveau=නව | නුවෝ
nova=නව තාරකාව | නවතරු | නවතාරාව
novae=නවතරු | ස්ඵෝටක තරු
novarsenobillon=නොවසෙනොබිලොන්
novation=නවායනය | නවීකරණය
novecento=විසිවන ශත වර්ෂය
novel=අලුත් | කෝඩු | නව | නවකතාව | නවකථාව | නවීන | නැවුම් | නුපුරුදු
novelette=කුඩා නවකථාව | කෙටි නවකතාව | කෙටි නවකථාව
novelist=නවකථා රචකයා | නවකථාකරු
novella=නොවෙලා අන්දරය | වෘත්තාන්ත කථාව
novellae=නොවෙල්ලා
novelty=අපූරු සිද්ධිය | අමුත්ත | අලුත් දේ | නවතාව | නුපුරුදු බව
november=නොවැම්බර් මාසය
novena=නුවානය
novennial=නවවර්ෂීය
novice=ආධුනික | ආධුනිකයා | කෝඩුකාරයා | නවක | නවකයා | නවාගත | ශ්‍රාමණේර | සාමණේර | සාමණේරතැන | හෙරණ
noviciate=ආධුනිකත්වය | සාමණේර කාලය | සාමණේරභාවය
novictiate=පුහුණුවේ ආරම්භය | සාමණේරයන්ගේ ආරාමය
noviform=නවාකාරය
novocaine=නොවකේන්
now=ඉතින් | එවිට | දැන් | ප්‍රත්‍යත්පන්න
nowadays=මේ කාලයෙහි
nowel=මාහරය
nowhere=කොහේවත් නැත
nowise=කෙහොමවත් නැත
noxious=අනිෂ්ට | අවැඩදායක | හානිකර | හිංසක
nozzle=තුඩ | තුඩුව | තුණ්ඩය | නැසින්න | පුඩුව | හොම්බ | හොස්ස
np=තැනැ
nt=නැහැ
ntelligence=ප්‍රතිභාණය
nu=ග්‍රීක හෝඩියේ දහතුන් වෙනි අකුර
nuance=නුවාන්සය | සියුම් වූ වෙනස
nub=ගල්අඟුරු ගොඩ
nubite=වැඩිවිය පැමිණි | විවාහයට සුදුසු
nucamentum=පුච්ඡය
nucellus=කුක්ෂීය
nuchal=අවටුව | අවටූ
nuciferous=අස්මධර
nuciform=අස්මාකර
nuclear=න්‍යෂ්ටි | න්‍යෂ්ටික
nucleate=න්‍යෂ්ටි ඇතිකරනවා
nucleated=න්‍යෂ්ටි සහිත
nucleid=න්‍යෂ්ටික ලවන
nuclein=නියුක්ලෙයින්
nucleinate=නයුක්ලියනේට්
nucleolate=න්‍යෂ්ටිකා සහිත
nucleolated=න්‍යෂ්ටිකා සහිත
nucleole=න්‍යෂ්ටිකාව
nucleolus=න්‍යෂ්ටිකය | න්‍යෂ්ටිකාව
nucleon=න්‍යෂ්ට්‍යංගය | නියුක්ලියෝනය
nucleonics=නියුක්ලියෝනික තාක්ෂණිකය
nucleoplasm=න්‍යෂ්ටිප්ලාස්මය
nucleoplasmic=න්‍යෂ්ටිප්ලාස්මීය
nucleoprotein=නියුක්ලියොප්‍රෝටීන්
nucleoside=නියුක්ලියොසයිඩය
nucleotide=නියුක්ලියොටයිඩය
nucleous=න්‍යෂ්ටිකාව | න්‍යෂ්ටිය
nucleus=ආරම්භය | ගර්භය | න්‍යෂ්ටිය | න්‍යෂ්ටීය | මධ්‍යස්ථානය | වීජ කේන්ද්‍රය
nudation=නගනීකරණය | නග්නීකරණය
nude=අනාරක්ෂිත | නග්න | නග්න ප්‍රතිමාව | නග්න රුව | නග්න වත්‍රය | නග්නය | නිර්වස්ත්‍ර
nudicaulous=නග්නස්කන්ධ
nudist=දිගම්බරයා | නිර්වස්ත්‍රව හැසිරෙන තැනැත්තා
nudity=නග්නත්වය | නග්නභාවය | නිරුවත
nuer=නුවර්
nugatory=අල්පබව | අවලංගු | නිෂ්ඵල | හිස්
nugget=පිඬ | පිඩ | වටිනා කුඩා දෙය
nuisance=අනදරය | කන්දොස්කිරියාව | කරච්චලය | කරදරය | පීඩාව | වද කරච්චලය | වදය | හක්කලම | හිංසනය | හිරිහැරය
null=අභිශුන්‍ය | අභිශූන්‍ය | අභිශූන්‍යය | අවලංගු | නිෂ්ප්‍රභා | නිෂ්ඵල
null-geodesic=අභිශූන්‍ය භූමිතිකය
nullified=අහෝසි
nullify=අවලංගු කරනවා | අහෝසි කරනවා | නිෂ්ප්‍රභ කරනවා | නිෂ්ඵල කරනවා | ශූන්‍ය කරනවා
nullipara=අවිජන්‍යාව | අවිජාතාව
nulliparaous=අවිජන්‍ය | අවිජාත
nullity=අභිශුන්‍යතාව | අභිශූන්‍යතාව | නැතිකම | වලංගු නැති දේ | ශූන්‍යතාව
numb=පණ නැති | හැඟීම් නොදැනෙන | හිරි වැටුණු | හිරි වැටෙන්නට සලසනවා | හිරිවැටෙනවා
number=අංක යොදනවා | අංකය | ඉලක්කම | කලාපය | ක්‍රමාංකය | ගණන | ගණන් කරනවා | ගණය | නොම්මරය | සංඛ්‍යා | සංඛ්‍යාව | සඟරා කලාපය | සමූහය
numbered=අංකිත | ගණිනලද
numbering=අංක දැමීම | අංක යෙදීම
numberless=අසංඛ්‍ය | සංඛ්‍යා විරහිත
numbers=කවි පද | ගණන්
numbness=හිරිය
numerable=ගණන් කළ හැකි | සංඛ්‍යාවාචී
numeraire=ගණ්‍යතාව
numeral=අංකය | ගණන් පිළිබඳ වූ | සංඛ්‍යාංකය
numerals=සංඛ්‍යාංක
numerate=ගණන් කරනවා
numeration=ගණනය | ගණන් කිරීම | ගණනාව | සංඛ්‍යාංකනය
numerator=අංශය | භාරකය | ලවය
numeric=සංඛ්‍යාත්මක
numerical=ගණන් වශයෙන් වූ | සංඛ්‍යා | සංඛ්‍යාත්මක
numerically=සංඛ්‍යාත්මක වශයෙන්
numerology=ඉලක්කම් සතු ගුප්ත බල අධ්‍යයන ක්ෂේත්‍රය | සංඛ්‍යා විද්‍යාව | සංඛ්‍යාවේදය
numerous=අනල්ප | අනේක | අවිරල | නැතක් | නොමඳ | ප්‍රචුර | බාහුල්‍ය | බුහු | බොහෝ | යේභූය්‍ය | සංඛ්‍යා වශයෙන් විශාල
numerousness=බහුලභාවය | බාහුල්‍යය
numinous=ආධ්‍යාත්මික | දේවත්වයක් ඇති
numismatic=කාසි විද්‍යාව හා සම්බන්ධ | ටංකන විද්‍යාව
numismatics=නාණක ශාස්ත්‍රය | නාණක්‍යය
numismatist=නාණක ශාස්ත්‍රයෙහි විශේෂඥයා
numskull=ගුඩ්ඩයා | මොට්ටයා
nun=තපස්විනී | භික්ෂුණී | මෙහෙණින්න
nunatak=නුනටැක්
nuncio=පාප් නියෝජිතයා | පාප්තුමාගේ දූතයා
nunnery=කන්‍යා මඩම | තාපසිකාරාමය | තාපසීන්ගේ ආරාමය | මෙහෙණවර
nupharetum=නූපාර් ග්‍රාමය
nuptiae=විවාහය
nuptial=විවාහය පිළිබඳ | වෛවාහික | වෛවාහිත
nuptials=විවාහ මංගල්‍යය | වෛවාහික | සරණමංගල්‍යය
nurse=ආයා | ඇතිදැඩි කරනවා | කිරිමවු | රැකබලාගන්නවා | සාත්තු සප්පායම් කරනවා | සාත්තුකාරී | හෙදවරිය | හෙදිය
nursery=තවාන | තෝතැන්න | පාත්තිය | බාලාංශය
nurseryman=තවාන්කාරයා
nursing=කිරි දීම | පෙහෙණිය | සාත්තු කිරීම | හෙදකම
nursling=කිරිදරුවා
nurti=නූර්ති
nurture=ඇතිදැඩි කරනවා | ඇතිදැඩි කිරීම | පුහුණු කරනවා | පෝෂණය | පෝෂණය කරනවා | රැක බලාගැනීම | සම්භෘතිය
nut=අස්මාව | ගෙඩි කඩා එකතු කරනවා | මුරිච්වය | ෂෝක් කාරයා | හිස්ගෙඩිය
nut-cracker=ගිරය
nutant=කිබිසි
nutation=අභිසර්පණය | අභිසර්පනය | පෘථිවි අක්ෂයේ දෝලනය
nuthatch=කුඩා පක්ෂි විශේෂයක්
nutlet=අස්මිකාව
nutmeg=දෑ | සාදික්කා
nutria=මූෂික වර්ගයට අයත් සතකුගෙන් ලබාගන්නා සම් හා ලොම්
nutrient=පෝෂකය | පෝෂ්‍යදායී
nutriment=පෝෂකරය | පෝෂ්‍යදායී අහාර
nutrition=ආහාර | පෝෂණය
nutritious=පුෂ්ටිකර | පෝෂ්‍යදායක | පෝෂ්‍යදායී
nutritive=පුෂ්ටිකර | පෝෂ්‍ය | පෝෂ්‍යදායී
nuts=දෘඩපල | පිස්සු | විකාර
nutshell=කටුව
nutter=ඔල්මාද කාරයා
nutty=ගෙඩි සහිත | ගෙඩිවල රස ඇති
nuxvomica=ගොඩකදුරු | නක්ස්වොමිකා
nuzzle=සෙමින් නාසයෙන් පිරිමදිනවා
nyctalopia=නිශා නෛත්‍රිය
nyctanthous=නිශාපුෂ්පී
nyctanthy=නිශාපුෂ්පීතාව
nyctigamous=නිශාපුෂ්පී
nyctinastic=නිද්‍රාසන්නමන
nyctinasty=නිද්‍රාසන්නමනය
nyctipelagic=නිශාප්ලවාංග
nyctitropic=නිශාවර්තී
nyctitropism=නිශාවර්තනය
nyctophobia=තමස් භීතිකාව
nylon=කෘත්‍රිම බහුඅවයවක ද්‍රව්‍යය | නයිලොන් | නයිලෝන්
nymph=අප්සරාව | ඉතා ලක්ෂණ ස්ත්‍රී | දෙවඟන
nymphaeetum=නිම්පේයා ග්‍රාමය
nympho=අධික කාමාශාවක් ඇති ස්ත්‍රිය
nymphomania=කාමෝන්මාදය | නාරිකාමෝන්මාදය | සුරතෝන්මාදය
