p.=නිර්මාතෘ
p.=නිර්මාතෘ
p.a.x.=පෞද්ගලික ස්වයංක්‍රිය විනිමය | පෞද්ගලික ස්වයක්‍රිය විනිමය
p.b.x.=පෞද්ගලික ශාඛා විනිමය
p.e.=සම්භාවී දෝෂය
p.e.r.t.=වැඩ සටහන් ඇගැයීම හා සමාලෝචන ශිල්ප ක්‍රමය
p.e.ratio=මිල ඉපයුම් අනුපාතය
p.m.=පස්වරුවේ
p.m.h.=මිනිස් පැය අනුව
p.m.x.=පෞද්ගලික අත් විනිමය
p.p.=වෙනුවට
p.r.o.=මහජන සම්බන්ධතා නිලධාරී
pabigerous=බූ දරණ
pabulum=ගොදුර
pace=අඩිය | අවසර ඇතිව | ඇවිදින අන්දම | ඇවිදීමේ වේගය | ගෞරවයෙන් | පිය | පියවර | සක්මන් කරනවා
pacha=තුර්කි ආණ්ඩුකාරයෙක්
pachydermatous=ඉතා ඝන හමක් ඇති
pachytene=ඝනපට
pacific=ශාන්තිකර | සමාදානයට කැමැති
pacification=සමාදාන කිරීම
pacifism=ශාන්තවාදය | සාමවාදය
pacifist=යුද්ධ කිරීමට විරුද්ධව සාමය උදෙසා ප්‍රයත්න දරන්න | ශාන්තිවාදියා | සාමවාදියා | සාමවාදී
pacify=අස්වසනවා | ප්‍රශමනය | සංසිඳනවා | සංසිඳුවනවා | සංහිඳවනවා | සංහිඳුවනවා | සනසනවා | සන්සිඳුවනවා | සමනය කරනවා | සමාදාන කරනවා
pacifying=ශාන්තිකර
pacing=පියවර මැනීම
pack=අඩුක් කරනවා | අසුරනවා | අසුරුව | අහුරනවා | අහුරා සකස් කරනවා | ඇහුරුම | කඩදාසි කුට්ටම | කුට්ටම | කූට්ටම | පොදිය | මිටිය | රංචුව | රැළ | වයනය කරනවා | හසුරනවා
pack-bull=තවලම
pack-horse=තවලම් අශ්වයා
pack-man=පොට්ටනි වෙළෙන්දා
pack-thread=සෙල්ගාර
package=අසුරුව | ඇසුරුම | පැකේජය | පොදිය | බඩු මිටිය | සමුද්ගය
packaging=ඇසුරුම | ඇසුරුම් පෙට්ටිය | ඇසුරුම්කරණය | ඇහුරුම | සමුද්ගකරණය
packed=අහුරන ලද | තදබද වූ
packet=කුඩා මිටියක් | පැකැට්ටුව
packet-boat=තැපැල් ගෙනයන නැව
packet-steamer=තැපැල් ගෙනයන නැව
packing=අසුරවුව | ඇසුරුම | ඇසුරුම් ද්‍රව්‍ය | ඇහිරීම | ඇහිරුම | ඇහුරුම | ඇහුරුම් | ඇහුරුව | පැකීම | සන්නිපාතනය
packman=තොරම්බල් කාරයා
packs=ඇහුරුම්
pact=කතිකාව | ගිවිසුම | ප්‍රමතිය | පොරොන්දුව
pad=උපධානය | කොට්ට සේ සාදනවා | කොට්ටය | පෝරු දමා අහුරනවා | හෙමින් ඇවිදගෙන යනවා
pad-show=මණ්ඩපීය දර්ශනය
padder=විතරණය
padding=පිරවීමට යොදන ද්‍රව්‍යය | පිරවුම | පෝරු | පෝරු දැමීම
paddle=ඉදිරියට යනවා | කළුව | පත්ත | හබල | හබල්ගානවා
paddle-steamer=හබල් රෝද සහිත යාත්‍රාව
paddle-wheel=හබල් රෝදය
paddock=ගෙම්බා | මැඩියා
paddy=අයිරිෂ්කාරයා | ගොයම් | බැත | වී
paddy-field=කුඹුර | වෙල
padlock=ඉබ්බා | ඉබි යතුරු දමනවා | ඉබියතුර
padre=පාදිරි තැන
paean=කෞමාරභෘත්‍යය | ජයගීතය | ස්තුතිගීතය | ස්තෝත්‍රය
paediatrics=කෞමාරභෘත්‍යය | බාලචිකිත්සාව
paediotrophy=බල පෝෂණ ශාස්ත්‍රය
paedogenesis=ශිශුකතාජනනය
paedophilla=කුඩා දරුවන් කෙරේ දක්වන කාමාශාව
paella=ස්පාඤ්ඤයේ බත්වලින් සාදන ආහාර විශේෂයක්
paeudosolution=ව්‍යාජ ද්‍රාවණය
paffian=පැපියානුව
pagan=අශිෂ්ට | අශිෂ්ටයා | අසද්ධර්මසේවියා | මිථ්‍යාග්‍රාහියා | මිථ්‍යාදෘෂ්ටිකයා | මිසඇදැහියා
paganism=අසංස්කෘතිය | අසද්ධර්මසේවනය | මිථ්‍යාදෘෂ්ටි දේවතාවන් ඇදහීම | මිථ්‍යාදෘෂ්ටිය
page=ඇබිත්තයා | කුඩා සේවකයා | කූඤ්ඤය | කොල්ලා | පිටවල් ලකුණු කරනවා | පිටු කරනවා | පිටුව
pageant=උත්සව සහිත පෙරහැර | සංදර්ශනය
pageantry=උත්සවශ්‍රීය | ශෝභාලංකාරය
paginate=පිටුවල අංක යොදනවා
pagination=පිටු අංකනය | පිටුවල අංක යෙදීම
paging=පිටු කිරීම
pagoda=චීනයේ චෛත්‍යය | චීනයේ දාගැබ | චේතිය | චෛත්‍යය | පගෝදිය | බුරුමයේ චෛත්‍යය | බුරුමයේ දාගැබ | ස්තූපය | සෑය
pah=අසතුට පළකිරීමට යෙදෙන වචනයක්
paid-up=ගෙවා නිම කළ
paidophilia=කෞමාර කාමය
pail=කුඩා බාල්දිය
pain=ඇදුම් කනවා | ඇදුම් දෙනවා | ඇම්ම | ඇවිලිල්ල | කකියනවා | කඩුත්තුව | කැවෙනවා | ගාය | දඬුවම | දුහ්ඛ වේදනාව | දුහ්ඛය | දොම්නස | රිදවනවා | රිදීම | රිදුම | රිදෙනවා | රුජා | රුජාව | රුදා | වද | වදක | වධක | විනිපාත | වේදනා | වේදනා ඇති කරනවා | වේදනාව | හිරිහැරය
painful=තපනීය | පීඩාකර | වේදනා සහිත | වේදනාකාරී
painless=නීරජ
pains=බඩේ රුදාව | රුජාව | විළිරුජාව | වෙහෙස
painstaking=වෙහෙසී වැඩ කරන | වේදනාකර
paint=අඳිනවා | අල්ලියාදු | ආලේපය | තීන්ත | තීන්ත ගානවා | පින්තාරු | පින්තාරු කරනවා | පින්තාරු තීන්ත | චිත්‍රණය කරනවා | චිත්‍රයක් අඳිනවා | වයිති | වර්ණකය | සායම | සායම් ගානවා
painter=තීන්තදෝරුවා | පින්තාරු කරන්නා | පින්තාරුකරු | චිත්‍රකාරයා | චිත්‍රශිල්පියා | සිත්තරා
painterly=චිතරූපී
painting=ආලේපනය | චිත්‍ර | චිත්‍ර කර්මය | චිත්‍ර කර්මාන්තය | චිත්‍ර කලාව | චිත්‍රණය | චිත්‍රය | පින්තාරු | පින්තාරු කිරීම | පින්තාරුව | පෙතිකඩ | සිත්තම | සිතුයම | සිතුවම
pair=ඈඳුත්ත | කුට්ටම | කුට්ටම් වශයෙන් යෙදෙනවා | කුට්ටම් වශයෙන් යොදනවා | කූට්ටම | ජෝඩු ගැහෙනවා | ජෝඩුව | දෙක දෙක තබනවා | යුගල | යුගලය | යුගල් වශයෙන් තබනවා | යුගළය | යුග්මය | යුවල
paired=යුග
pairing=යුගලීම | යුග්මනය
pairing-cell=ජන්මාණුව
pairing-time=කුරුල්ලන් සංවාසයෙහි යෙදෙන කාලය
paisley=සුවිශේෂ නිමහුම් ලක්ෂණ ඇති
paison=වහ
pak=පකිස්තාන් ජාතිකයා
pal=යාළු වෙනවා | යාළුවා
pala=මහා අල්තාර මණ්ඩපය
palace=මන්දිරය | මාලිගය | මාලිගාව | මාළිගය | මාළිගාව | රජ වාසල | රජගෙදර | රජගෙය | රජුගේ | රාජ භවන | වහසල | වාසල | වාහල
paladin=වීර ගති ඇති පුද්ගලයා
palaeaceous=තුෂාකාර | පේලයාකාර
palaebotany=පුරෝද්භිද විද්‍යාව
palaegaea=පුරාණ ලෝකය
palaeo=ආදි කාලයේ | පුරාණ කාලයේ
palaeo-geography=පුරා භූගෝල විද්‍යාව
palaeoanthropology=පුරාමානව විද්‍යාව
palaeobotanist=පුරෝද්භිද විද්‍යාඥයා
palaeobotany=පුරෝද්භිද විද්‍යාව
palaeocene=පුරාතන යුගයක මුල් අවධියට අයත්
palaeogeic=පුරාභූමික
palaeography=පුරා ලිපි විද්‍යාව | පුරාක්ෂර විද්‍යාව | පුරාණ ලේඛන ශාස්ත්‍රය
palaeolithic=පුරාශිලා
palaeontology=පාෂාණිධාතු විද්‍යාව | පාෂාණිභූත ධාතුශාස්ත්‍රය | පුරාව විද්‍යාව
palaeophytology=පුරෝද්භිද විද්‍යාව
palaeotropic=පුරාභිවර්තනික
palaeotypal=පුරාදර්ශ
palaeozoic=පැරණිම ක්‍රමවත් දිවිපැවැත්මක් තිබූ භූගෝලීය යුගය | පේලියොසොයික | පේලීයොසොයික
palais=නැටුම් ශාලාව
palankeen=කූණම | දෝලාව | පල්ලැක්කිය | සිවිගේ
palanquin=ඊල | ඔවිලි | කූණම | දෝලාව | දෝලිය | දෝළිය | පල්ලැක්කිය | පැල්ලක්කිය | සිවිකාව | සිවිගේ | හිදල | හිදල් | හිදොලුව | හොවිල්ල | හෝවිලි යානාව
palatable=කෑමට ප්‍රිය | රසවත් | රුව උපදවන
palatal=තාලුජ
palate=තල්ල | රුවය
palatial=අති විශාල | ප්‍රාසාදරූපී | මාලිගාරූපී | මාලිගාවක් වැනි
palatinate=ප්‍රදේශය භාර වංශාධිපතියා
palatine=වංශාධිපතියෙකුගේ අණසකට යටත්
palaver=ඉච්චා බස් කියනවා | චාටු බස් | වැදගැම්මකට නැති කතාබහ | සාකච්ඡා පවත්වනවා | සාකච්ඡාව
pale=අවපත්‍රය | අළු | උපතුෂය | කොටුව | දීප්තියෙන් අඩු | නිෂ්ප්‍රභ කරනවා | නිෂ්ප්‍රභ වෙනවා | පාණ්ඩු වර්ණ | පිපිහළු | පේලයාව | වැට | වැට ඉන්න | සීමාව | සීමිත ප්‍රදේශය | සුදුමැලි | සුදුමැලි වෙනවා
palea=අවපත්‍රය | උපතුෂය | පේලයාව
paleaceous=තුෂාකාර | පේලයාකාර
paleola=තුෂිකාව
paleolate=තුෂිකා සහිත
paleontology=පාෂාණීය ධාතු විද්‍යාව
paleopsychology=පුරා මනෝවිද්‍යාව
palet=අවපත්‍රය | උපතුෂය | පේලයාව
palette=පලත්ත | වර්ණ ඵලකය | සිත්තරාගේ සායම් ලෑල්ල
palfrey=කුඩා අශ්වයා
pali=පාලි | පාලිය | පාළි | පෙළ | මගද | මගධ | මාගධ | මූලභාෂාව
palimpsest=අලුත් දේ ලිවීම සඳහා කොටසක් මැකූ පැරණි ලියවිල්ල | පැලිම්ප්සෙස්ට් | පුනර්ලිඛිත අත්පිටපත
paling=වැට
palingenesis=පුනර්ජනනය | පුනර්ජීවය | පුනර්වය | පුරාවර්තනය | පුරෝද්භවය
palingenetic=පුරෝද්භවිත
palingeny=පුරෝද්භවය
paliotto=අල්තාර තිරය
palisade=ගරාදි වැට | දඬුවැට
pall=ඝන වැස්ම | නීරස වෙනවා | පිරිහීමක් වෙනවා | හීන වෙනවා
pall-bearer=දෙණ භාරව යන්නා
palladian=ඇතීනියානු | පැලේඩියානු
palladium=ආරක්ෂාව | ඇතීනා රුව | ඉෂ්ටදේවතා රූපය | ඉෂ්ටදේවතාවා | පැලේඩියම | පැලේඩියම්
paller=පාණ්ඩරය
pallesthesia=වේප වින්දනය
pallet=කලාලය | තටුව | තැටිය | පැදුර | පිදුරු කුලිච්චම
palliasse=පිදුරු කුලිච්චම
palliate=දෝෂය අඩු කරනවා | ලඝු කරනවා | වේදනා අඩු කරනවා | වේදනාව අඩු කරනවා | සැහැල්ලු කරනවා
palliative=අඩු කරන | වේදනා නාශක | සහනය කරන | සැහැල්ලු කරන
pallid=පාණ්ඩු වර්ණ | සුදුමැලි
pallium=ප්‍රාවරණය
pallor=පාණ්ඩු පාට | සුදුමැලිකම
pally=යාළු | සුහද
palm=අත්ල | අල්ල | අල්ලක ප්‍රමාණය | අල්ලස් | අල්ලෙහි සඟවාගන්නවා | ජයකොන්තය | තාලවර්ගයේ ගස | තෘණද්‍රුම
palm-sunday=ගොබ් ඉරිදා
palmae=තාලකුලය
palmar=අතුල්
palmate=අතක ඇඟිලි මෙන් හැඩ ඇති | පාණිවත්
palmatifid=මිතපාණී
palmatipartite=අර්ධපාණි
palmatisect=පාණිච්ඡේද
palmelloid=පැල්මෙලාකාර
palmer=තල් අත්තක් අතින් ගත් වන්දනාකාරයා
palmette=පුස්කොල රටාව
palmist=හස්ත රේඛා ශාස්ත්‍රඥයා
palmistry=සාමුද්‍රික | සාමුද්‍රික ශාස්ත්‍රය | සාමුද්‍රිකා | සාමුද්‍රිකාශාස්ත්‍රය | සාමුද්‍රිතය | හස්ත රේඛා ශාස්ත්‍රය | හස්තරේඛා ශාස්ත්‍රය
palmitin=පාමිටින්
palmitto=කුඩා තාලවර්ගයේ ගස
palmy=සමෘද්ධිමත් | සශ්‍රීක
palmyra=තල් | තල් ගස | තාල
palmyra-fan=වටාපත
palmyra-umbrella=තල්පත | තලාත්ත
palp=පහසනවා
palpable=අත ගා බැලිය හැකි | අතගා බැලිය හැකි | ප්‍රකට | පැහැදිලි | ස්පර්ශ කළ හැකි | ස්පෘශ්‍ය
palpate=නාඩි බලනවා | පහසනවා
palpebral=පක්ෂ්ම | වර්ත්ම
palpitate=ස්පන්දනය වෙනවා
palpitation=අහිස්පන්දය | තිගැස්සිය | ස්පන්දනය
palsied=අංශභාගයෙන් පෙලෙන
palsy=අංශභාගය | පක්ෂාඝාතය | මහත් දුර්වල භාවය
paltry=ඉතා සුළු | තුච්ඡ | නීච
paludal=වගුරු
paludine=වගුරු
palustrine=වගුරු
palvinulus=උපධානිකාව
pamaquine=පැමක්වින්
pampas=දකුණු අමෙරිකාවේ විශාල තැනිතලා බිම්පෙදෙස් | පැම්පාස්
pamper=වැඩි කරුණාව දක්වනවා | වැඩි සැප දෙනවා
pampero=පැම්පෙරෝ සුළඟ
pamphlet=කුඩා පොත | පත්‍රිකාව | පුස්තිකාව | පොතිත්ත
pamphleteer=පත්‍රිකා රචකයා
pan=ඇතිලිය | කඨෝර ස්තරය | කඨෝරය | කබල | තාච්චුව | තැටිය | මැණික් ආදිය ගරනවා | සර්ව | සර්ව | හට්ටිය
pan-entheism=ඊශ්වරාංශූවාදය
pan-objectivism=සර්වාස්තිවාදය
pan-out=ක්‍රමයෙන් සකස් වෙනවා
pan-pipe=සංගීත භාණ්ඩයක්
panacea=සර්වරෝගනාශකය | සියලු ලෙඩට බෙහෙත
panache=ආඩ්‍යතාව
panam=පණම
panama=පන් තොප්පිය
panatella=හීන් දිග සුරුට්ටුව
pancake=ඉතා තුනී රොටිය | ලැවරිය | වෙල්ලවැහුම
pancarditis=සාර්වකන්තුදාහය
panchayat=පංචායත්
panchromatic=සර්වවර්ණ
panchymeningitis=නිවිඩාවෘතිදාහය
panclimax=මහෝත්කර්ෂය
pancreas=අග්න්‍යාශය | ඇල දිව
pancreatitis=අග්න්‍යාශදාහය
panda=පැන්ඩා
pandal=තොරන
pandemic=වසංගතය
pandemonium=ජනක්ෂෝභය | මහා කෝලාහලය | යකුන් නටන පිටිය | සංකුලය
pander=අලුකුත්තේරුවා | කූට්ටාලියා | ගණිකාව | තැරැව්කාරයා | පිම්පියා | යටත් වෙනවා
pandit=උගතා | පණ්ඩිතයා
pandol=තොරණ
pandurate=රවිකිඤ්ඤාකාර
panduriform=රවිකිඤ්ඤාකාර
pane=ඇහැටිය | බෝල මිටිය | වීදුරු තහඩුව
panegeric=ප්‍රශස්තිය
panegyric=ගුණවර්ණනාව | ප්‍රශස්තිය | විරුදය | ස්තුතිපාඨය
panegyrical=වර්ණනාත්මක
panegyrise=උතුම් ලෙස වර්ණනා කරනවා
panegyrist=ප්‍රශස්තිකාරයා | වන්දීභට්ටයා | විරුදකාරයා | වේතාලිකයා
panel=කැටයම් ලෑල්ල | ජනේලය | ජූරිසභාවේ නම් වට්ටෝරුව | ජනෙල් යොදනවා | ජනේලය | පලුව | බන්දේසිය | මඬල | මණ්ඩලය | ලේඛනය
panelling=ජනේල ඇල්ලීම | පනේල වැද්දුම
panellist=මණ්ඩලයක සාමාජිකයා
pang=බලවත් වේදනාව | මහත් දුක | රුදාව | හදිසි වේදනාව
pangenesis=සර්වජනනය
pangens=සර්වාංශු
pangolin=කෘමීන් කන සතෙක්
panic=කුලප්පුව | දවල් තරු පේනවා | භීතිය | සංත්‍රාසය | සන්ත්‍රාසය | සන්ත්‍රාසයට පත් වෙනවා | හදිසි මහත් භය
panicky=සන්ත්‍රස්ත
panicle=ලිහිල්ව බැඳුණු මල්පොකුරු | සංයුක්ත ඒකාක්ෂය
panjandrum=දොම්බරයා | මහ බක්කා
panlogism=සර්වන්‍යායවාදය
panmixia=සර්වමිශ්‍රණය
pannage=ඌරු ගොදුරු බිම
pannier=තවලම් කූඩය | පැනියරය
panning=ගැරීම
panobjectivism=සර්වාස්තිවාදය
panoplied=සන්නද්ධ
panoply=සම්පූර්ණ සන්නාහය | සර්වාංගකවචය
panorama=පරිදර්ශනය | සමස්ත දර්ශනය | සර්වදිශාදර්ශනය
panoramic=පරිදර්ශක | හාත්පස පෙනෙන
panplain=සමහන් තැන්න
panplanation=සමහන් තැනි සෑදීම
panpneumatism=සර්වාත්මවාදය
panpsychicism=සර්වමනෝවාදය
panpsychism=සර්ව මනෝවාදය
pansy=කාන්තාවක බඳු පිරිමියා
pant=හති දමනවා | හති දැමීම
pantachromatic=නානාවර්ණ
pantachromism=නානාවර්ණතාව
pantaloon=කෝලමා | පන්තලෝනා | බිම්මන්නා
pantaloons=කලිසම් වර්ගයක්
pantechnicon=බඩු ගබඩාව
pantheism=සර්වදේවවාදය | සර්වේශ්වරවාදය
pantheist=සර්වේශ්වරවාදියා
pantheistic=සර්වේශ්වරවාදී
pantheon=දේව මණ්ඩලය | මුළු දේවතා සමූහය | විශ්ව දේවාලය | සර්වදේව මණ්ඩලය | සර්වදේවගණය | සර්වදේවාලය | සියලු දේව සභාව
panther=අඳුන් දිවියා
pantheress=අඳුන් දිවි දෙන
panties=කාන්තා යට ඇඳුම්
pantihose=කාන්තා යට ඇඳුම් විශේෂයක්
pantille=උළු කැටය
panting=හතිය | හැති
pantocaine=පැන්ටොකේන්
pantograph=කථකලි නාට්‍යය | පැන්ටොග්‍රාපය | පැන්ටොග්‍රාපිය | පැන්ටොග්‍රා‍‍ෆීය | සිතියම් කෙටුම්පත් යන්ත්‍රය
pantomime=අභිරූපණය | කථකලි නාට්‍යය | පැන්තොමයීම
pantomine=නිහැරැඟිය | මුගරැඟිය
pantropic=සාර්වනිවර්තන
pantry=කෑම තබන ගබඩාව | කෝප්ප | පිඟන්
pants=කලිසම්
pap=අල්ලුකඩ | තනපුඩුව | තලපය
papa=අප්පා | පප්පා | පියා
papacy=පාප් පදවිය
papagayo=පැපගායෝ සුළඟ
papain=පැපේන්
papal=පාප්
papaver=පැපවර්
papaw=ගස්ලබු | පැපොල්
papaya=ගස්ලබු | පැපොල්
paper=කඩදාසි | කඩදාසි අලවනවා | කඩදාසි කොළය | කඩදාසිය | කඩදාසිවලින් වසනවා | කඩදාසිවලින් සෑදූ | පත | පත්‍රය | ප්‍රශ්න පත්‍රය | මුදල් නෝට්ටුව | ලියවිල්ල
paper-army=ව්‍යාජ හමුදාව
paper-knife=කඩදාසි කපන පිහිය
paper-money=මුදල් නෝට්ටු
papers=කඩදාසි | ලියකියවිලි
paperwork=ලිපි කටයුතු
papery=කඩදාසියක් බඳු
papier-mache=කඩදාසි කල්කය
papiilary=පුඩු හැඩැති
papilionaceous=සමනල
papilla=කුඩා තන පුඩුව | පැපිලාව | පිටිකාව
papillaedema=පැපිලිඩිමාව
papillar=පිටීකා
papillary=පිටීකා
papillate=පිටීකා සහිත
papilliferous=පිටීකා සහිත
papilliform=පිටීකාකාර
papilloma=පැපිලෝමාව
papillose=පිටීකා සහිත
papist=පාප්ගේ ගෝලයා
papoose=උතුරු ඇමරිකා ඉන්දියානු ළමයා | පාපූස්
pappous=බූමණි සහිත
pappus=බූමණිය
paprika=රතු ගම්මිරිස්
papuan=පැපුවානු
papule=පැපූලය
papyraceous=කඩදාසි වැනි
papyrology=පැපිරස්වල ලිවීමේ විද්‍යාව
papyrus=පැපිරස් | පැපිරි කඩදාසි | පැපිරි ලේඛන | පුරාණයේදී කඩදාසි තැනීමට යෙදූ පන් වර්ගයක් | බට වැනි ජලජ ශාකයක්
par=සම | සම මිල | සමකම | සමකය | ස්වාභාවික සනීපය | සාම්‍යය
para=ඔබ්බෙන් | ලියවිල්ලක කොටසක් | ලුහුඬු ප්‍රවෘත්තිය | වාක්‍යඛණ්ඩය
parabasis=අපේත භාෂණය
parabituminous=පැරාබියුමන්
parable=උපදේශ කථාව | උපමා කථාව | දෘෂ්ටාන්ත කථාව | දෘෂ්ටාන්තාලාපය
parabola=අනුවෘත්තය | පරාවලය | පරාවලයය | පැරබලය | සමකලය
parabolic=පරාවලයික
parabolical=පරාවලයික
paraboloid=පරාවලයාකාරය | පරාවලයාභය
paraboloidal=පරාවලයාභ | පරාවලයාහ
paracellulose=පැරාසෙලියුලෝස්
paracentesis=පරාව්‍යධය
paracetamol=අහස්කුඩය | පැරෂුටය | පැරසිටමෝල්
parachor=පරාකෝරය | පැරාකෝරය
parachromatin=ලයිනින්
parachromophoric=පරිවර්ණකධර
parachronism=කාලඅපරතාව
parachute=අහස්කුඩය | පැරෂුටය | පැරෂූටය | වායුච්ඡත්‍රය
parachutist=පැරෂුට් භටයා
paraclete=සරණාහ්වානිත
parade=උඩඟු ප්‍රදර්ශනය | පෙරෙට්ටුව | පෙළට ගමන් කරනවා | පෙළපාළිය | යුඬ පෙලපාලි දක්වනවා | විජෘම්භනය | සරම | සරඹ
parade-ground=යුද්ධාභ්‍යාස භූමිය
paradigm=ආදර්ශ වරනැඟීම | සුසමාදර්ශය
paradise=ඒදන් උයන | පරාදීසය | පාරාදීසය | ස්වර්ගය
paradisiac=පාරාදීසයෙහි වූ
paradisiacal=පාරාදීසයෙහි වූ
paradox=තේරුම් ගැනීමට දුෂ්කර තැනැත්තා | ද්වෛධය | විරුද්ධභාසය | විරුද්ධාභාසය | විරෝධාභාසය | විරෝධාහාසය
paradoxical=තේරුම් ගැනීමට දුෂ්කර | විරෝධාභාසී
paraesthesia=පරාවින්දනය | පැරස්තීසියා
paraffin=පැරපිනය | පැරපින් | පැරින් තෙල්
paraffin-oil=පැරපින් තෙල්
paraffin-wax=පැරපින් ඉටි
paraffins=පැරපින
paragon=උතුම් ආදර්ශය | ශ්‍රේෂ්ඨ වස්තුව
paragoric=පාරගොරික්
paragraph=ඡේදය | ලියවිල්ලක කොටසක් | ලුහුඩු ප්‍රවෘත්තිය | වාක්‍යඛණ්ඩය
paraheliotropism=පාරසෞරාවර්තනය
parahelium=පැරාහීලියම්
parahydrogen=පැරාහයිඩ්‍රජන්
parakeet=බටු ගිරවා
paraldehyde=පැරල්ඩිහයිඩ්
paralinin=පැරාලයිනින්
parallactic=අසම්පාතක
parallax=අසම්පාතය
parallel=මාන්තර | සමකොට තකනවා | සමාන | සමාන්තර | සමාන්තර රේඛාව | සමාන්තරානිකය | සරල සමාන්තර | සාම්‍යය
parallelepiped=ඝනකාභය | සමාන්තරානීකය
parallelism=සමාන්තරත්වය | සමාන්තරතාව | සමාන්තරවාදය | සාම්‍යය
parallelogram=සමාන්තර චතුර්භුජය | සමාන්තරාස්‍රය
parallelosterism=සමාන්තර අවයවිකතාව
parallelotope=සමාන්තරාස්‍යය
paralogia=පරාවචනය
paralogism=තර්කාභාසය
paralyse=කොර කරනවා
paralysis=අංශබාගය | අංශභාගය | අඝාතය | ක්‍රියාශක්තිය නැතිවීම | පක්ෂාඝාතය | පරාශ්ලතය | පරාශ්ලථය
paralytic=අංශබාග රෝගය වැළඳුණු | අංශබාග රෝගියා
paralyze=පක්ෂඝාත කරනවා | බල නැති කරනවා
paralyzer=පරාශ්ලථකරය
paramacium=පැරමීසියම
paramagnetic=අනුක්ෂේත්‍ර චුම්බක | අනුචුම්බක
paramagnetism=අනුක්ෂේත්‍ර චුම්බකත්වය | අනුචුම්බකත්වය
paramedical=පරිපූරක වෛද්‍ය
parameridian=පාරමාධ්‍යය
parameter=ගංගා චක්‍රයේ පරාමිතිය | පරාමිතිය
parameterization=පරාමිතිකරණය
parametric=පරාමිතික
paramillitary=යුදහමුදා බළඇණිවලට සමාන
paramnesia=පරාස්මෘතිය
paramoecium=පැරමීසියම
paramorphism=පරරූපතාව
paramount=අත්‍යත්කෘෂ්ට | පරම | පරමතම | ප්‍රමුඛ | සියල්ලට ප්‍රධාන
paramountcy=පරමතමත්වය
paramour=එද්දලයා | ජාරයා | ජාරි | ජාරිණී | සොර අඹුව | සොර සැමියා | සොරසැමියා
paramylum=පැරාමයිලම්
parangi=පරංගි
paranoea=මතිභ්‍රමය
paranoia=පීඩනෝන්මාදය | මතිභ්‍රමය
paranoid=මානසික විකෘතිභාවයක් ඇත්තා
paranormal=සම්මත විද්‍යා ගවේෂණවලට පරිබාහිර වූ
paranosic=පරාලාභය
parantheses=අන්තර්වාක්‍යය
parapbasia=පරාභාෂ්‍යය
parapectin=පැරාපෙක්ටීන්
parapet=තාප්පය | ප්‍රාකාරය | බිත්තිය
paraph=අක්ලකර
paraphemia=පරාභාණය
paraphernalia=උවාරණ | මෙවලම්
paraphimosis=අපරිවර්තිකතාව | පරාරෞධ්‍යය
paraphonia=පරාස්වනය
paraphrase=අනුවාදය | අර්ථෝද්ධාරය | භාව සන්නය | සන්න කරනවා
paraphrastic=අනුවාදාත්මක
paraphrenia=පරාමනස්‍යය
paraphyllium=පාරපත්‍රය
paraphysics=පරාභෞතිකය
paraphysis=පරාපිසිය | පාරපිසිය | වඳරෝමය
paraplasm=පාරප්ලාස්මය
paraplegia=දෙපාපණ නැතිවීම | පරාඝාතය
paraplegic=දෙපාපණ නැතිවුණු රෝගියා
parapsychics=පරාමනෝවිද්‍යාව
parapsychology=පරාමනෝවිද්‍යාව | පාරමනෝවිද්‍යාව | සාමාන්‍ය මනෝවිද්‍යාවෙන් ග්‍රහණය නොවන මනෝ ක්‍රියාකා
paraquet=බටු ගිරවා
pararhyme=අඩ එළිසමය
parasalene=බොරු හඳ
parasite=ඇහැටුව | පරපුටු | පරපුටුවා | පරපෝෂිතය | පරපෝෂිතයා | පිලිලය | පිළිල | පිළිලය | වන්දක | වන්දාක
parasitic=පරපෝෂිත
parasitical=පරපෝෂිත
parasiticide=පරපෝෂිතනාශකය
parasitism=පරපෝෂිතතාව
parasol=ඡත්‍ර | ඡත්‍රය | සත | සැත | සූර්යාවරණය
paraspermatium=පාරපුමණුව
parastichy=පාරපංක්තිකය
parasympathetic=ප්‍රත්‍යානුවේගී
parasyphilis=පරෝපදංශ
parataxis=දුස්සමාධානය | පරාවින්‍යාසය
parathormone=පැරතෝමෝන්
parathymia=පැරතිමියාව
parathyroid=පරාඵරාභය | පැරතයිරොයිඩ්
paratonic=පරතේජක
paratracheal=පරිවාහකාභ
paratrooper=අහස්කුඩ හමුදාවේ භටයා | පැරෂුට් හමුදාවේ භටයා
paratroops=අහස්කුඩ හමුදා | පැරෂුට් හමුදා
paratype=පාරදර්ශය | පාරාදර්ශය
paratyphoid=උණසන්නිපාතයට සමාන ලෙඩක්
parboil=යන්තම් තම්බනවා
parcel=ඔතා බඳිනවා | කොටස | කොටස් කරනවා | පාර්සලය | පොට්ටනිය | පොත් කරනවා | පොදිය | මිටි බඳිනවා
parch=කර කරනවා | කර වෙනවා | සම්පූර්ණයෙන් වේළනවා | සම්පූර්ණයෙන් වේළෙනවා
parched=කර වූ | පුලුටු | වියළි
parchment=පාච්මන්ට් | පාර්ච්මන්ට් | පාර්ච්මන්ට් කඩදාසි | සම් වැනි කඩදාසි | හම්පත
pard=දිවියා
pardon=කමනවා | කමාකරනවා | ක්ෂමා කරනවා | ක්ෂමා දානය | ක්ෂමාදානය | ක්ෂමාව | සමාකරනවා | සමාව | සමාව දීම | සමාව දෙනවා
pardonable=ක්ෂමාපණීය | සමා කළ හැකි | සමාව දිය හැකි
pare=කපා හරිනවා | රහිනවා | සසිනවා | සහිනවා
paregoric=කපුරු යොදා සුවඳවත් කරන අබිං
parenchyma=මෘදුස්තරය
parent=ජනක | ජනකයා | පියා හෝ මව | පූර්වදේවතා | මව්පිය | මුල් | මූලකාරණය | මූල්‍ය | හේතුව
parentage=අන්වය | කුලපරම්පරාව | පෙළපත | මව්පිය බව | මාතෘපිතෘත්වය | වංශය
parental=පියා පිළිබඳ | මව පිළිබඳ | මව්පිය | ස්නේහවන්ත
parentheses=වරහන් | සුළු වරහන්
parenthesis=බහාලන ලද වාක්‍යය | වරහන් | වරහන් යෙදූ කොටස | වරහන් හෝ සුළු වරහන් තුල විස්තරකය | විස්තරකය
parenthetic=වරහන් යෙදූ
parenthood=පිතෘත්වය | මාතෘත්වය
parents=දෙගුරු | මව්පිය | මව්පියෝ
parergon=අපවෘත්තිකය
paresis=පරාශ්‍රංසය | පරාස්‍රංසය | මන්දාඝාතය
paresthesia=පරාවින්දනය | පැරස්තීසියා
parfait=උස් වීදුරු බඳුන්වල බහාලන පුඩිං විශේෂයක්
parge=බදාම ගානවා
parget=කපරාරු කරනවා
parhelion=බොරු ඉර
pariah=චණ්ඩාලයා | නීචයා | පරයා
pariah-dog=අවලම් බල්ලා
parianth=පරිපුෂ්පය
parichnos=පරික්නොස
paricycle=පරිචක්‍රය
parietal=කුඩ්‍යීය | පාර්ශ්වික | භික්තික
parietes=කුඩ්‍ය
paring=සැහීම
paripinnate=සමපක්ෂ
parish=කෝරළයක කොටස | පත්තුව | වසම
parishioner=එහි වැසියා | වසම වැසියා
paritta=පිරිත්
parity=සමතලතාව | සමත්වය | සමතාව | සමානත්වය | සාම්‍යය
park=උද්‍යානය | උයන | ගාල් කරනවා | නවතනයනවා | නවතුව | රියගාල | වනෝද්‍යානය | විශාල පිට්ටනිය
parka=ඇස්කිමෝවරුන්ගේ ජැකැට්ටුව
parking=නවතනය කරනවා
parkinsonism=පාර්කින් සොනියාව
parkland=උයන්බිම | පොතාන බිම | විවෘත තණපිටිය
parlance=කථා ව්‍යවහාරය | නිසේවිතය | භාෂා ව්‍යවහාරය | ව්‍යවහාරය
parley=කතාබස් කරගන්නවා | කතාබහ | මන්ත්‍රණය | සාකච්ඡා කරනවා | සාකච්ඡාව
parliament=පාර්ලිමේන්තුව | පාර්ලිමේන්තුව මේන්තුව | මහජන මන්ත්‍රීමණ්ඩලය
parliamentary=පාර්ලිමේන්තුව පිළිබඳ වූ | පාර්ලිමේන්තුවට අයත්
parlor=සාලය
parlour=ගෙයි ඇතුළේ සාලය | සාලය
parlour-maid=කෑම මේසයෙහි සේවය කරන මෙහෙකාරී
parlour-tricks=විනෝදාත්මක හපන්කම්
parlous=අනතුරු සහිත | නොසතුටුදායක
parmesan=තද කේජු විශේෂයක්
parochial=කට්ටලීය | කුඩා ප්‍රදේශයකට අයත් | කෝරළබද | ග්‍රාම්‍ය | පටු | පත්තුවකට අයත් | ප්‍රාදේශීය | පෙදෙසි | වසමගත
parochialism=පෙදෙසිවාදය | විකට වශයෙන් අනුකරණය කරනවා
parochialization=කට්ටලිකරණය
parody=සරදම | හාසකානුකරණය
paroecious=පාරගෘහී | පාරෛකගෘහී
paroicous=පාරගෘහී | පාරෛකගෘහ
parol=කටවචන | ප්‍රාවාවක
parole=කටවචන | ප්‍රාවාවක | පිළිණ | මුර වචනය | වාවක ප්‍රතිඥාව | වාවක ප්‍රතිඥාවක් දෙනවා
paronomasia=ශ්ලේෂ | ශ්ලේෂාලංකාරය
paronomesia=ශ්ලේශෝක්තිය
paroquet=බටු ගිරවා
parotid=කනට සමීප
parotitis=පරාශ්‍රොතදාහය
parousia=උපලබ්ධිය
paroxysm=ආවේගය | තද ආලය | තද කෝපය | තද වේදනාව | පරාශිතය
parquet=ලෑලි පොළොව
parquetry=යමිකිසි මෝස්තරයක් අනුව බිම ලී කැබලි ඇල්ලීම
parr=සැමන් මත්ස්‍යයා
parrakeet=බටු ගිරවා
parricidal=පියා මරන ලද
parricide=උතුමකු මැරූ තැනැත්තා | පිතෘ ඝාතක | පිතෘඝාතකයා | පිතෘඝාතනය | පියා මැරූ තැනැත්තා | මව මැරූ තැනැත්තා | රජකු මැරූ තැනැත්තා
parrot=අළු ගිරවා | ගිරවා | ගිරා | සුව
parry=පහර වළකනවා | මඟහැරීම
parse=ව්‍යාකරණ විග්‍රහ කරනවා
parsec=පාර්සෙක් මිම්ම | පාසිකය
parsee=පාර්සි ජාතිකයා
parsimonious=සකසුරුවම් ලෙස
parsimony=අරපරිස්සම | මසුරුකම | සකසුරුවම
parsley=රට අසමෝදගම්
parsnip=එළවළු විශේෂයක් | පැළෑටි විශේෂයක්
parson=පළාතක් බාර දේවගැතිතැන
parsonage=දේවගැති නිවාසය
part=අංගය | අඩ | ඒකකය | ඒකදදේශය | කඩනවා | කණ්ඩය | කැඩෙනවා | කෑල්ල | කොටස | කොට්ඨාසය | ඛණ්ඩ | පංගුව | පක්ෂය | ප්‍රදේශය | පේරුව | බික | බියල්ල | බෙදනවා | බෙදෙනවා | බේ | භාගය | භූමිකාව | යුතුකම | වැඩේ | වෙන් කරනවා | වෙන් වෙනවා | වෙන්ව යනවා | ස්කන්ධ
part-heard=අඩක් ඇසූ
part-owner=අඩ අයිතිකරු | කොටසක් අයිතිකාරයා
part-payment=අඩක් ගෙවීම | කොටසක් ගෙවීම | කොටස් වශයෙන් ගෙවීම
part-performance=අඩක් ඉටු කිරීම | භාගික ඉටුකිරීම
part-song=කීපදෙනෙක් එක්ව කොටස් වශයෙන් කියන ගීතය
partake=අනුමෝදන් වෙනවා | භුක්ති විඳිනවා | සහභාගී වෙනවා
parterre=රංගන භූමිය
parthenocarpy=පාතෙනොඵලනය
parthenogamte=පාතෙනොජන්මාණුව
parthenogenesis=කෞමාරෝද්භවය | පාතෙනෝද්භවය | සපපාතික උත්පත්තිය
parthenogenetic=කෞමාරෝද්භවිත | පාතෙනෝද්භවිත
parthenogeny=කෞමාරෝද්භවය | පාතෙනෝද්භවය
parthenogonidium=පාතෙනොගොනීඩිය
parthenon=පාතිනන් දෙව් මැදුර
parthenospore=පාතෙනොබීජාණුව | පාතෙනොස්පෝරය
parthian=අවසාන | ඉවත්ව යාමේදී කරන
partial=අගති සහිත | අඩ | අඩවශයෙන් | අර්ධ | අසම්පූර්ණ | ආංශික | ආංශිකය | කොටස් වශයෙන් | පක්ෂග්‍රාහී | පක්ෂපාතී | පාර්ශ්වික | භාගික වශයෙන් | භින්න
partiality=ඇල්ම | පක්ෂග්‍රාහිත්වය | පක්ෂභජනය | ළැදිකම
partially=අඩවශයෙන් | පක්ෂභජනයෙහි යෙදී | මඳක් | ස්වල්ප වශයෙන්
partials=ආංශික සහභාග
participant=සහභාගියා | සහභාගීව ක්‍රියා කරන්නා | හවුල්කාරයා
participate=අනුමෝදන් වෙනවා | සහභාගි වෙනවා | සහභාගී වෙනවා | හවුල් වෙනවා
participation=සහභාගි වීම | සහභාගිත්වය | සහභාගිවීම | සහභාගීත්වය
participator=සහභාගීව ක්‍රියා කරන්නා | හවුල්කාරයා
participial=කෘදන්තමය
participle=කෘදන්තය
particle=අංශුව | අණුව | ඉතා කුඩා කොටස | පොඩිස්ස | ලවය | ලේශය
particoloured=වර්ණ දෙකකින් යුතු
particular=තොරතුර | පරීක්ෂා්‍කාරී | ව්‍යක්තික | විශේෂ | වෛශෙෂික | සවිස්තර | සාමාන්‍ය නොවූ | සිත් ගැනීමට දුෂ්කර | සුවිශේෂ | සුවිශේෂය
particularism=සුවිශේෂතාව
particularity=විශේෂතාව | විස්තරාත්මකත්වය
particularize=නම් වශයෙන් දක්වනවා
particularly=ප්‍රධාන වශයෙන් | විශේෂයෙන්ම | විස්තර ලෙස
particulars=විස්තර තොරතුරු
particulate=අංශුමය
parting=කොණ්ඩය බෙදා පීරීම | බෙදීම | වෙන් කිරීම | වෙන් කිරීම | වෙන් වුණු | වෙන්වයාම | සීමන්තය | සීමාව
partiot=දේශප්‍රේමියා
partisan=පක්ෂග්‍රාහී | පක්ෂභජනය | පක්ෂවාදියා | පක්ෂවාදී | පාක්ෂික | පාක්ෂිකයා | සපක්ෂ
partisanship=පක්ෂභජනය | පාර්ශව ගතිය
partition=ආවාරය | ඉම | කොටස් කරනවා | බෙත්ම | බෙදා වෙන් කරනවා | බෙදා වෙන් කිරීම | බෙදීම | බෙදුම | විබෙදුම | විභාග | විභාගය | විභාජකය | විභේදනය | වෙන්කිරීම
partition-case=බෙදුම් නඩුව
partitive=විභාගදර්ශක
partly=අඩවශයෙන් | පංගු වශයෙන් | පංගුවක්
partne=හවුල්කරු
partner=කොටස්කාරයා | භාගියා | භාර්යාව හෝ පුරුෂයා | සහකාරයා | සහකාරිය | හවුල් නළුවා | හවුල් නිළිය | හවුල් ව්‍යාපාරිකයා | හවුල්කරු | හවුල්කාරයා
partners=හවුල්කරුවෝ
partnership=සම්බන්ධය | සහකාරකම | සහභාගිත්වය | හවුල | හවුල් ව්‍යාපාරය | හවුල්ව්‍යාපාරය
partnerships=හවුල් ව්‍යාපාර
partridge=චකෝරයා
parturient=වැදීමට ආසන්න
parturition=ප්‍රසවය | ප්‍රසූතිය | වැදීම
party=උත්සවය | කට්ටිය | කණ්ඩලම | කණ්ඩායම | කයිය | තැනැත්තා | තැනැත්තී | පංගුකාරයා | පක්ෂය | පක්ෂය | පාක්ෂිකයා | පාර්ශ්වකරු | පාර්ශ්වය | සමූහය | සාදය | හාදයා
party-man=පාක්ෂිකයා
party-spirit=පක්ෂයට ඇති ළැදිකම | පාර්ශ්ව ගතිය
party-wall=මැද බිත්තිය
parurition=ප්‍රසූතිය
parvenu=අලුත් පෝසතා
pas=නැටුමෙහි පියවරක්
pascal=පැස්කල්
paschal=පාස්කු කාලයට සම්බන්ධ
pasha=තුර්කියේ උසස් නිලධාරියා
pashto=පෂ්ටෝ භාෂාව
paspalum=අමු
pasque-flower=ඇනිමනි විශේෂයක්
pass=අතහැර යනවා | අතින් අතට දෙනවා | අතින් අතට යනවා | අවසර පත්‍රය | අවස්ථාව | ආක්‍රාන්ත වෙනවා | ඉකුත්ව යනවා | ඉවත්ව යනවා | එතරව යනවා | කපොල්ල | ගත කරනවා | දුර්ගය | නැතිවී යනවා | පනවනවා | පසු වී යනවා | පසුකරනවා | පසුකොට යනවා | පාස්පත | මඟහැර යනවා | යනවා | යවනවා | සමථ වෙනවා | සමර්ථවූ සේ පිළිගන්නවා | ස්ථීර කරනවා | ස්ථීර වෙනවා | සිද්ධ වෙනවා | සුදුසු යයි පිළිගන්නවා
pass-degree=සාමාන්‍ය උපාධිය
pass-word=මුරවවනය
passable=එතර වියහැකි | තරමක් සතුටුදායක
passage=එගොඩවීම | ගමන | ගමනය | ගමන් ගාස්තුව | ගමන් මඟ | තත්ත්වයෙන් මාරුවීම | පාඨය | පාර | පැනවීම | මඟ | මාර්ගය | යාම | යාම ඊම | ස්ථානයෙන් මාරුවීම | ස්ථීර කිරීම | හුමාල මඟ
passe=යල් පැනපු
passed=අතික්‍රාන්ත
passenger=ගමන් කරන්නා | පථික | මඟියා
passerine=කාකගණයට අයත් | කාකගණයට අයත් පක්ෂියා
passes=යැවුම්
passim=හැම තැන
passing=අස්ථීර | පසුකොට යාම | බොහෝ සේ
passion=කාමය | කාමාශාව | දුක්ප්‍රාප්තිය | දුහ්ඛය | මද | මහත් ළැදිකම | රාගය | ලාලසාව
passion-play=පාස්කු නාට්‍යය | පාස්කු සංදර්ශනය
passionate=ලාලසී | සරාගී
passionionate=බලවත් හැඟීමෙන් යුත් | රාගාධික
passionless=අනාසව | විරාගී
passionlessness=විරාගය
passive=අකර්මණ්‍ය | අකර්මන්‍ය | අක්‍රිය | ආකර්මණ්‍ය | ඉවසිලිවන්ත | නිෂ්ක්‍රිය | විරෝධයක් නොදක්වන
passivism=නිෂ්ක්‍රියවාදය
passivity=අකර්මණ්‍යතාව | අකර්මන්‍යතාව | අක්‍රියතාව | ක්‍රියාවිරහිතව ඉවසීම
passkey=දොරවල් රාශියක් ඇරිය හැකි යතුර
passometer=පියවරමානය
passover=උපරිගමන් මංගල්‍යය | යුදෙව් පාස්කුව | යුදෙව්වන්ගේ පාස්කුව
passport=ගමන් බල පත්‍රය | පාර පත්‍රය | පාරපත්‍රය | විදේශ ගමන් බලපත්‍රය
password=මුර පදය | මුර වචනය | මුරපදය
past=අතීත | අතීතය | ඉකුත් වූ | ඉවත්ව | තුන්කල | පසු වූ | පසුකොට | යට | යට ගිය
pasta=පිටි මෝලිය
paste=අලවනවා | ආලේපය | ඇනූ පිටි | උදපේෂය | කල්කය | තලප | තලපය | පාප්ප | වතුර මුසු පිටි | විලේපය
pastel=පාට හුණු | පාටකූරු | පැස්ටල්
pastelist=පැස්ටලිකයා | චිත්‍ර කාරයා
pastern=අශ්වයාගේ කකුලේ පහල පුරුක
pasteurization=පැස්චරීකරණය | පැස්ටරීකරණය
pasteurizer=පැස්ටරීකාරකය
pasticcio=සංග්‍රහනුකරණය
pastiche=ප්‍රසිද්ධ ලේඛකයෙකුගේ කලා නිර්මාණ උසස් අයුරින් එළ | සංග්‍රහනුකරණය
pastil=බෙහෙත් පෙත්ත
pastille=බෙහෙත් පෙත්ත
pastime=විනෝදක්‍රියාව | විනෝදාංශය
pasting=ඇලවීම | ඇලීම
pastor=ආගමික උපදේශකයා | පාදිලි උන්නාන්සේ
pastoral=එඬේරුන්ගේ විතය හා සම්බන්ධ | ගම්බද | ග්‍රාමීය කාව්‍යය | ගැමි
pastorate=ආගමික උපදේශක පදවිය
pastose=ඝනාලේපිතය
pastrami=දුම්ගැසූ ගවමස්
pastry=පස්තෑල | පිටිකෑම
pasturage=තණ කැවීමේ අයිතිය | තණ කෑම | තණබිම
pasture=ගොදුරු බිම් | තණ කඩා කනවා | තණ කවනවා | තණ බිම
pasty=උදපේෂරූපී | පාප්පරූපී | පිටි වැනි | පිටි සහිත | සුදුමැලි
pat=අතින් තට්ටු කරනවා | අතින් තට්ටු කිරීම | ඉතා සුදුසු සේ | ටක්කෙට | හරියට හරි
patana=පතන
pataphysics=අතිපාරභෞතිකවාදය
patch=අණ්ඩ | අණ්ඩ දමනවා | අණ්ඩය | අනුපොකුර | උපනාහය | පරිමාව | බිස්ස | සරිමාව
patch-work=අණ්ඩ දැමීම | යන්තමින් කරන ලද්ද
patching=උපනහනය | උපනැහීම
patchy=අණ්ඩ සහිත | නොමනා | පැල්ලම් සහිත
pate=ඉස්මුඳුන | මස්වලින් සැදූ තලපය
patella=කටාහකය | දණ පොල් කටුව | දණ පොලොත්ත
patent=ආරක්ෂක බලපත්‍රය | කාටත් පෙනෙන | නිර්මාණ බලපත්‍රයක් ලබාගන්නවා | පසක්නා | ප්‍රකට | ප්‍රත්‍යක්ෂ | ප්‍රත්‍යක්ෂණය | පේටන්ට් | පේටන්ට් බලපත්‍රය | බලපත්‍රයකින් ආරක්ෂිත | ව්‍යාත්ත | විස්තීර්ණ | ස්වාධිකාරය
patent-leather=විශේෂයෙන් ඔප දමන ලද හම
patented=ප්‍රත්‍යක්ෂණීකෘත | සවාධිකාරී
patentee=ප්‍රත්‍යක්ෂණලාභියා | බලපත්‍රයක් ලැබූ තැනැත්තා | ස්වාධිකාර හිමියා | ස්වාධිකාරධාරී
patently=ප්‍රකටව | පැහැදිලිව
pater=අප්පොච්ව
paternal=දයාවන්ත | පිතෘ පාර්ශ්ව | පිතෘක | පිය පස | පියපක්ෂයෙහි වූ | පියපස | පියා පිළිබඳ | පියාට අයිති | පියෙකුට සමාන
paternalism=පීතෘමූලිකවාදය
paternalistic=පිතෘ සදෘශ | පිතෘකල්ප
paternity=පිතෘත්වය | පිය බව
paternoster=දෙවි ස්වාමීන්ට කරන යාච්ඤාව | විල් වැළ
path=අඩි හප්පනවා | අඩිපාර | අයන | චරිතය | පථය | පෙත | මං | මංතලව්ව | මග | මඟ | මාර්ගය | හසර
pathan=පාකිස්ථානයේ ජනකොටසක්
pathetic=අනුකම්පා උපදවන | දුක්ඛිත | ශෝකජනක | සානුකම්ප්‍ය
pathetious=ශංඛක ස්නායුව | සංවේග ස්නායුව
pathfinder=ගවේෂකයා
pathless=දුර්ගම | යාමට දුෂ්කර
pathochemistry=ව්‍යාධි රසායන විද්‍යාව
pathogen=රෝගකාරක බීජය
pathogenesis=ව්‍යථජනනය
pathogenic=ව්‍යාධිජනක
pathogenous=ව්‍යාධිජනක
pathography=ව්‍යථ ශාස්ත්‍රය
pathological=රෝග විනිශ්චය පිළිබඳ වූ | ව්‍යාථ වේදීය
pathology=රෝග විනිශ්චය | ව්‍යථ වේදය | ව්‍යථවේදය | ව්‍යාධි විද්‍යාව | ව්‍යාධිවේදය
pathoneurosis=ව්‍යථ නියුරෝසියාව
pathonometrics=ව්‍යාධිමිතිකය
pathophobia=ව්‍යාධි භීතිකාව
pathos=අනුකම්පා උපදවන ගුණය | කරුණා රසය | කාරුණ්‍යය | දුහ්ඛය
pathway=අඩිපාර | චරිතය | මග | මාර්ගය
patience=ඉවසිල්ල | ඉවසීම | ක්ෂාන්තිය
patient=අසනීපකාරයා | ආතුරයා | ඉක්මන් නොවන | ඉවසිලිමත් | ඉවසිලිවන්ත | රෝගාතුර | රෝගාතුරයා | රෝගියා | ලෙඩ්ඩු | ලෙඩා
patimaghara=ප්‍රතිමාඝරය | පිළිමගේ
patina=චදිමය | තඹ පෙද | තඹ පෙඳ | පල්මානික්කම් බැඳීම
patio=නිවසකට යාබදව ඇති වහලක් නැති කොටස
patiolulate=සවෘන්තික
patisserie=කැවිලි වෙළෙන්දාගේ සාප්පුව
patois=ප්‍රාදේශීය ගැමියන්ගේ භාෂාව
patriarch=කුලදෙටුවා | ගනපිතෘ | නිකායේ ප්‍රධානියා | පිතෘමූලිකයා | පූජකපිතෘ | බොහෝ වයස්ගත තැනැත්තා
patriarchal=පාදිලිතැනගේ නිල නිවාසය | පිතෘමූලක | පියදෙටු
patriarchate=පිතෘ ශාසනය
patriarchy=කුල ජ්‍යෙෂ්ඨවාදය | පීතෘමූලිකත්වය
patrician=කුලීනයා | පුරාණ රෝමයෙහි කුලීනයා | වංශාධිපති | වංශාධිපතියා
patricidal=පිතෘඝාතක
patricide=පිතෘ ඝාතක | පිතෘ ඝාතකයා | පිතෘඝාතකයා | පියා මැරීම
patrilateral=පිතෘ පාර්ශ්විය
patrilineage=පියපෙළ අන්වය
patrilineal=පිතෘ වංශීය | පියපෙළපත්
patrilocal=පිතෘවාසරික | පිතෘවාසික | පියපස පදිංචි
patrimonial=පිතෘ ප්‍රවේණිය | පිතෘප්‍රාප්ත
patrimony=ප්‍රවේණිය | පිතෘප්‍රාප්තිය | පිය උරුමය
patriot=ජාතිමාමකයා | ජාතිහිතෛෂියා | දේශප්‍රේමියා | දේශමාමක | ස්වදේශාභිමානියා
patriotic=ජතිහිතෛෂි | ජාතිමාමක | ජාතිහිතෛෂි | දේශප්‍රේමී | දේශමාමක | ස්වදේශානුරාගී
patriotism=ජාත්‍යාලය | දේශප්‍රේමය | දේශානුරාගය | ස්වදේශාලය
patripotestal=පිතෘප්‍රාධිකාරී
patristic=මුල් ක්‍රිස්තියානි පරපුරේ ලේඛකයන්ට අයත්
patristics=පිතෘද්දේශය
patrol=මුර සංචාරය | මුර සංචාරය කරනවා | මුරසංවාරය
patron=අනුග්‍රාහක | අනුග්‍රාහකයා | අනුශාසකයා | ආරක්ෂකයා | උපකාරකයා | පාලකයා
patronage=අනුග්‍රහය | අනුග්‍රාහය | ආශ්‍රය | උපකාරය | සංවර්ධනය
patronize=අනුග්‍රහ කරනවා | අනුග්‍රහය දක්වනවා | ආශ්‍රය කරනවා | උපකාර කරනවා
patronizing=තමාගේ ලොකුකම් දක්වන
patronymic=ගේ නම | ගෝත්‍රනාමය
patten=ලී සෙරෙප්පුව
patter=ඉක්මනින් කියන ගීතය | ඉක්මනින් කියන වාක්‍යය | නොනැවත කරන කතාව | පටපටනය
pattern=අලංකාරය | අළුව | ආකාරය | ආදර්ශය | නිදර්ශනය | පතරොම | මාදිරිය | මෝස්තරය | රටාව | ලීලාව | වාත්තුමල
patterned=රටාගත
patternmaking=වාත්තුමල් සෑදීම
patty=පස්තෑලය
pauce=සැතපුම
paucital=ටික දෙනකු බැඳෙන | ස්වල්පීය
paucity=අල්පත්වය | හිඟකම
paul=අඩය | දිවත
paunch=බඩ
pauper=අසරණයා | දරිද්‍රයා | දිළින්දා | නිදැනියා | හිඟන්නා | හිඟමනට පත් කරනවා
pauperies=සතුන් මඟින් හානිය
pauperism=දරිද්‍රතාව | දිළිඳුකම | දුගී බව
pauperize=දිළිඳු බවට පත් වෙනවා
pause=නැවතිල්ල | නැවතීම | යතිය | විරාමය
pavane=නැටුමක්
pave=බිම ගල් ගඩොල් ආදිය අතුරනවා
pavement=ඇතිරිය | පදික වේදිකාව | පදිකවේදිකාව | පාදිකාව
paver=අතුරනය
pavilion=ක්‍රීඩා මණ්ඩපය | මණ්ඩපය | මහල
paving=ඇතිරීම | ගල් ඇල්ලීම | ගල් ඇල්ලූ බිම
pavior=අතුරන්නා | අතුරුව | ඇතුරුම් ගල
pavlova=කේක් විශේෂයක්
paw=අණ්ඩ | අත
pawky=උපායෙහි දක්ෂ
pawl=අඩය | දිවත | බල්ලා
pawn=අක්ෂය | ඇල වශයෙන් දෙනවා | උකස | උකස් කරනලද දේ | උකස් කරනවා | උකස් බඩුව | උකස් වශයෙන් දෙනවා | දාදු ක්‍රීඩාවෙහි ඉත්තා | පණනය කරනවා | පණිතය | බඩු උකස් කරනවා
pawnbroker=උගස් බඩු ගන්නා
pawnee=පණනලද්දා | බඩු උකස්ලාභියා | බඩු උකස් ලාභියා
pawner=පණනදායකයා | බඩු උකස් දායකයා | බඩු උකස් කරන්නා
pawning=උකස් තැබීම | උගස් තැබීම
pawnshop=කිත්තන්ගේ
pay=කුලිය | කෙළිනවා | ගෙවනවා | පඩිය | ප්‍රතිඵල වශයෙන් දෙනවා | වාසි ලැබෙනවා | වැටුප
pay-day=පඩි දෙන දිනය
pay-period=ගෙවුම් කාල සීමාව
payable=ගෙවිය යුතු | ගෙවිය හැකි | ගෙවියයුතු
payback=පිළිලදුව
paye=උපයන විට ගෙවීම
payee=ආදායක | ආදායකයා
payer=ගෙවන්නා
paying-in-slip=මුදල් ගෙවුම් තුණ්ඩුව
payload=අදායම් ගෙනෙන ගුවන් බඩු | අයබර
paymaster=ගෙවීම් නිලධාරියා
payment=ගතමනාව | ගාස්තුව | ගෙවිල්ල | ගෙවීම
payments=ගෙවීම්
payola=අල්ලස
payroll=පඩිපත | සේවක පඩි ලැයිස්තුව
pays=පේයි
paywright=නාට්‍ය කර්තෘ
pctinase=පෙක්ටිනේස්
pdl=පවුන්ඩලය
pea=මෑ හෝ මුංඇට | රට මෑ
pea-hen=සෙබඩ
pea-jacket=නාවිකයාගේ උඩු කබාය
peace=කලබල නැති බව | ගිවිසුම | නිශ්චලත්වය | ශමථ | ශාන්තිය | සමගිය | සමාදානය | සාම | සාමදානය | සාමය
peace-offering=සාම ත්‍යාගය
peaceable=ශාන්ත | සමාදානයට කැමති
peaceful=ශාන්ත | සමාදානයෙන් සිටින | සාමකාමී
peacefully=සෙමෙන්
peach=ඔත්තු කියනවා | පීච් නම් පළතුර | රහස් එළිදරවු කරනවා | ලක්ෂණ ලමිස්සී
peacock=මයුර | මයුර පැහැය | මයුරා | මයූරයා | මියුරු | මොදර | මොනර | මොනරා | ශිඛි | සිඛි | සීකි
peacockblue=දීප්තිමත් නිල් කොළ පාට
peafowl=මොනරා | මොනරී
peak=ඉතා උසස් තැන | කුළ | කූටය | ගල්කුළ | තුඩ | මුදුන | ශිඛරය
peak-load=උච්ච භාරය | උපරිම බර | උපරිම භාරය | විදුලි බලයෙහි ඉතා වැඩි ඉල්ලුම
peaked=මුඳුනක් ඇති | ශීඛරයක් ඇති | සකුළු
peakedness=සකුළුව
peakish=ලෙඩින් | සුදුමැලි
peaky=ලෙඩින් | සුදුමැලි
peal=ගර්ජනාව | නින්නාදය | මහත් වූ හඬ
pean=ඇහැටිය
peanut=රටකජු
pear=පෙයර්
pear-shaped=පෙයාර් හැඩ | පේර හැඩ
pearl=ඉතා අගනා දෙයක් | මුක්ත | මුතු | මුතු ඇටය
pearl-fisher=මුතු කිමිදින්නා
pearl-oyster=මුතු බෙල්ලා
pearl-string=මුතුපට
pearly=මුතු වැනි දීප්තිමත්
peasant=කුලී ගොවියා | ගැමියා | ගොවියා | පිටිසර වැසියා
peasantry=කුලී ගොවි ජනතාව | ගැමි ජනතාව | ගොවි ජනතාව | ගොවි ජනයා
pease=පීස්
peat=කෘමියා | පීට් | ර්ණක
pebble=ගල් කැටය | බොරලු | බොරලු ගල | බොරළු කැටය | ලෙඩ්ඩු
pebbles=කැට | පෙබලු
pebbly=බොරලු සහිත
pecan=ගෙඩි විශේෂයක්
pecapture=නැවත අල්ලා ගැනීම
peccable=පවට නැමුණු
peccadillo=සුළු වරද
peccant=වරද කරන | වරදෙහි බැඳුණු | සදොස්
peccary=වල් ඌරා
peccatophobia=පාප භීතිකාව
peck=අවුළා ගන්නවා | ඇහිඳ කනවා | ඉතා ටිකක් කනවා | ඉඹිනවා | කෙටීම | ගල්වලින් ගසනවා | ගොඩක් | චඤ්චූව | තුඩෙන් කොටනවා | පැකය | හොට ගහනවා | හොටෙන් දෙන පහර | හොටෙන් පහරදීම
pecker=නහය | හොටෙන් කොටන්නා
peckish=ටිකක් බඩගිනි ඇති
pecopteroid=පීකොප්ටෙරිසාකාර
pectase=පෙක්ටේස්
pectic=පෙක්ටික්
pectin=කාබෝහයිඩ්‍රේට විශේෂයක් | පෙක්ටින්
pectinaceous=පෙක්ටින් වැනි
pectinate=කංකතාකාර
pectization=ජල්ලිකරණය
pectocellulose=පෙක්ටොසෙලියුලෝස්
pectograph=පෙක්ටොරේඛය
pectography=පෙක්ටොරේඛ විද්‍යාව
pectoneus=කංකතකය
pectoral=උර | ළය | ළය පිළිබඳ වූ
pectose=පෙක්ටෝස්
peculate=වංචාවෙන් ගන්නවා
peculation=මුදල් වංචා කිරීම
peculiar=අමුතු | අරුම | අව්‍යාපී | තමාගේ ම වූ | පුදුම | විශේෂ | සාමාන්‍ය නොවූ
peculiarity=අරුමය | විශේෂය
peculiarly=විශේෂයෙන්
peculium=පෙකියුලියම | බාලයකු සතු පෞද්ගලික දේපල
pecuniary=මුදල් පිළිබඳ වූ | මූල්‍යක
pedagogics=ශික්ෂණ ශාස්ත්‍රය
pedagogue=අහංකාර උගතා | ශික්ෂක
pedagogy=ශික්ෂණ ශාස්ත්‍රය
pedal=පදිකය | පයින් පාගනවා | පාකඩ | පාදයට අයිති | පාදික | පාදිකය | පාපදිකය
pedalfer=පෙඩැල්පර
pedalling=පැදවීම
pedant=උගත්කමින් අහංකාරව සිටින්නා | පණ්ඩිතමන්‍යයා | පණ්ඩිතම්මන්‍යයා
pedantic=පණ්ඩිතමානී
pedantry=පණ්ඩිතමානී බව | විද්‍යාඩම්බරය
pedate=පාදාකාර | පාදාභ
pedately=පාදාකාරවත්
pedding=ඉතා සුළු
peddle=ගෙවල් ගානේ බඩු විකුණමින් යනවා
peddler=තොරොම්බල්කාරයා
pederast=සමලිංගික සේවනයේ යෙදෙන්නා
pederasty=කෞමාර මෛථුනය
pedesis=බ්‍රවුනීය සංචලනය
pedestal=කුලුනක අඩිය | ප්‍රතිමාතලය | පාදස්තලය | පාදස්ථලය | පිළිමයක අඩිය
pedestrian=නීරස | පදිකයා | පයින් යන | පයින් යන්නා
pedicel=තැරිය | නැට්ට | පුෂ්ප වෘන්තය
pedicellate=සවෘන්ත
pedicle=නැට්ට | වෘන්තය
pediculosis=සායූකය
pedigree=ගෝත්‍රය | පරපුර | පැටිකිරිය | පෙළපත | පෙළවැල | වංශාවලිය
pedigreed=උසස් පෙළපතකින් පැවතෙන | හොඳ වර්ගයේ
pediment=කුරෙන්තිය | ගොඩනැගිල්ලක පෝටිකෝවට උඩින් ඇති ත්‍රිකෝණාකාර | වේදිකා ගල | සලපිල
pedlar=කක්ෂපුට වාණිජ | තොරොම්බල්කාරයා
pedocal=පෙඩොකල්
pedology=පාංශු විද්‍යාව
pedometer=පාදමානය | පාවරමානය
pedophilia=කෞමාර කාමය
peduncle=දිග නටුව
peek=හොරෙන් බලනවා
peel=උලුප්පනවා | කූරුගානවා | පතුරු ගහනවා | පෙරන්ගානවා | පොත්ත | පොත්ත ගලවනවා | පොත්ත ගැලවෙනවා | පොතු අරිනවා | පොතු ගසනවා | රහිනවා | ලෙල්ල | ලොලනවා | වැයිරි ගහනවා | සසිනවා | සහිනවා | සිවිය | සිවිය ගලවනවා | සිවිය ගැලවෙනවා | සූරනවා | හොඳ කරනවා
peeler=පොලිස්කාරයා
peeling=පොතු ගැසීම | පොතු ගැහීම
peen=ඇහැටිය
peep=එබිකම් කරනවා | එබිකම් කිරීම | එබී බලනවා | එබී බලවා | එබෙනවා | කුකුළුපැටවකු මෙන් හඬනඟනවා | ප්‍රථම දර්ශනය | මතු වෙනවා | මීයකු මෙන් හඬනඟනවා | යන්තමින් බැලීම | සිදුරකින් බැලීම | හෙමින් එළියට එනවා
peer=එබිකම් කරනවා | තුල්‍යයා | වංශාධිපතියා | සමයා | සමිසුරු | සාමානයා
peerage=රදළ පෙළ | ශ්‍රේෂ්ඨතාව
peeress=වංශාධිපති කාන්තාව
peerless=අතුල්‍ය | අද්විතීය | අඳුරෙහි පරීක්ෂාවෙන් බලනවා | අසමසම | අසහාය | එබී බලනවා | ඕනෑකමින් බලනවා
peeve=නොරුස්සනවා
peeved=කෝප වුණු
peevish=නිතර වරද සොයන | නුරුස්සන | වහා කිපෙන | සිත් ගැනීමට දුෂ්කර
peewit=කරළා | කිරළා
peg=ඇණය | ඇණහිටවනවා | ඇබය | කරඇණය | කාදැත්ත | කූඤ්ඤය | කොක්ක | ඛීලය | නාදැත්ත | බීම අඩිය | ලී ඇණ වලින් සවි කරනවා | ලී ඇණවලින් සවි කරනවා
pegging=ඇණ හිටුවීම | ඇණහිටුවීම | කූඤ්ඤ ගැහීම
pein=ඇහැටිය
peine=බෝල මිටිය
pejorative=අවමානාත්මක
pejoritive=අවගුණ | අවභාණ
pekinese=චීනයේ උපත ලද කෙටි පා ඇති සුනඛ විශේෂයක්
pekoe=තේකොළ වර්ගයක්
pelagianism=පෙලෙගියානුවාදය
pelagic=සමුද්‍ර
pelargonium=මල් ගසක්
pelf=මුදල් | සල්ලිය බාගෙ
pelican=ඔටුමානා | කරවැල් කොකා
pelisse=ස්ත්‍රීන්ගේ දිග කබාය
pell-mell=අවුල් ලෙස | මහත් කලබලයෙන්
pellagra=පෙලග්‍රාව | සම ඇකිලී ශරීරය දිරා යන මාරාන්තික ඌනතා රෝගයක
pellet=උණ්ඩය | උණ්ඩිය | ගුළිය | මූනිස්සම
pellicle=ඡවිකාව | තුනී පටලය | සියුම් සම | හැව
pellicular=බන්ධන ක්‍රියාව
pellucid=අතිනිර්මල | ඉතා පැහැදිලි | විශද
pelmet=තිර නෙරුව
peloria=සංවිකෘතිය
peloric=සංවිකාර
pelorisation=සංවිකරණය
pelota=බිත්තිවලින් වට වූ ස්ථානයක බෝතලයක ආධාරයෙන් කෛ
pelt=එල්ල කරනවා | සත්ව හම
peltate=ඡත්‍රීය
pelvic=ශ්‍රෝණිය හා සම්බන්ධ
pelvis=උකුළු ප්‍රදේශය | වස්ති දේශය | ශ්‍රෝණිය
pen=කොටු කර තබනවා | කොටුව | පට්ටිය | පෑන | රචනා කරනවා | ලියනවා | ලේඛනිය | හංසධෙනුව
pen-name=ලේඛන නාමය
penal=දඬුවම් පිළිබඳ | දණ්ඩ | දණ්ඩක | දණ්ඩන | දණ්ඩනීය
penalise=දඬබත් කරනවා | දඬුවම් පමුණුවනවා
penalize=දඬුවම් කරනවා | දඬුවම් පමුණුවනවා
penalty=අච්චුව | දඬුවම | දඩ | දඩමුඩය | දඩය | දණ්ඩ | දණ්ඩනය | දන්ඩනය
penance=තපස
pence=පැන්ස | පැන්සය
penchant=අභිරුවය | ළැදිකම
pencil=තුලිකාව | තූලිකාව | තෙල්ල | පැන්සල | පැන්සලය | සටහන් කරගන්නවා
pendant=අවලම්බන | අවලම්බිත | අවිනිශචිත | එල්ලා වැටෙන | එල්ලෙන | එල්ලෙන ලාම්පුව | කඩුක්කම | කුණ්ඩලාභරණය | පැන්ඩනය | ලාම්පු රොත්ත
pendency=ලැඹියාව | ලැඹීම
pendent=අවලම්බන | අවලම්බිත | අවිනිශ්වත | එල්ලා වැටෙන | එල්ලෙන | එල්ලෙන ලාම්පුව | ඔලොඹු | කඩුක්කම | කුණ්ඩලාභරණය | තැල්ල | ලම්බක | ලාම්පු රොත්ත
pendentive=ඔලඹුව
pending=අතීරිත | තීන්දු නැති | තුරු | තෙක් | ලැඹෙන | විසදීමට තිබෙන | විසඳීමට තිබෙන
pendulous=අවලම්බ | අවලම්බන | එල්ලෙන | ඔලොඹු | ප්‍රලම්බ | පැද්දෙන
pendulum=අවලම්බය | බට්ටා
penduncle=මංජරි වෘන්තය
pene=ඇහැටිය
penelake=අඩ විල
penence=තපස් | තපස්චර්යාව
peneplain=අඩ තැන්න
peneplaination=අඩ තැනි හට ගැනීම
penetrable=ඇතුල් විය හැකි | සිදුරු කළ හැකි
penetrate=ඇතුල් වෙනවා | කා වැදෙනවා | කාවදිනවා | තේරුම් ගන්නවා | තේරුම් යනවා | පසාරු කරගෙන යනවා | විනිවිද යනවා | හාත්පස පැතිරෙනවා
penetrating=තීක්ෂ්ණ | විත්කන | විනිවිද යන | සියුම්
penetration=අවබෝධය | කාවැදීම | ගාහනය | තීක්ෂ්ණබුද්ධිය | විනිවිද යාම | විනිවිද යෑම | විනිවිදීම
penetrometer=විනිවිදුම්මානය
penguin=පෙන්ගුවින්
penicillate=පෙනිසිලාකාර
penicilliform=පෙනිසිලාකාර
penicillin=පෙනිසිලින්
penicillus=තුලිකාව
pening=ඇහැටියෙන් තැලීම
peninsula=අර්ධද්වීපය
peninsular=අර්ධද්වීප | අර්ධද්වීපික
penis=පිරිමිඇඟ | පුරුෂ ලිංගය | පුරුෂලිංගය | ශිශ්නය
penitence=පශ්චාත්තාපය | පසුතැවිල්ල | විපිලිසර
penitent=පසු තැවෙන්නා | පසුතැවෙන
penitential=පසුතැවිල් පිළිබඳ
penitentiary=චරිතශෝධනාගාරය | දඟගේ | දණ්ඩනාගාරය | සිරගෙය
penitrant=නිවේධකය
penknife=කුඩා දුනුපිහිය | පෑන පිහිය
penman=ලේඛකයා
penmanship=ලේඛන විද්‍යාව | ලේඛන ශෛලිය | ලේඛනශෛලිය
pennant=දිග | ධ්වජය | පටු කොඩිය | පතාකාව
pennate=පක්ෂවත්
pennies=පැන්ස
penniless=ඉතා දිළිඳු | තුට්ටුව අතේ නැති
pennon=දදය | දිග | ධ්වජය | නැව්වල තුන් හුලස් කොඩිය | පටු කොඩිය | පතාකාව
penny=පැන්සය
pennywort=ඇති ශාකයක්
penology=අපරාධ විද්‍යාව | දණ්ඩන විද්‍යාව | දණ්ඩන ශාස්ත්‍රය | දණ්ඩනවේදය
penpal=පෑනේ මිතුරා
pensile=අවලම්බ | එල්ලෙන
pension=පැන්ෂන් පඩිය | විශ්‍රාම වැටුප | විශ්‍රාම වැටුම | විශ්‍රාමිකය | වෛශ්‍රාමිකය
pensionable=විශ්‍රාම වැටුප් හිමි | වෛශ්‍රාමිකය හිමි
pensionary=විශ්‍රාම වැටුපට සම්බන්ධ
pensioner=විශ්‍රාමිකයා
pensioners=විශ්‍රාමිකයෝ
pensive=කල්පනාවෙහි යෙදුණු | නලංගුවූ | වන්තාපර
penstock=කොටු දොර
pent=කොටු කර තබන ලද
penta=පහ
pentabasic=පංචභාස්මික
pentabromide=පෙන්ටබ්‍රෝමයිඩ්
pentacarpellary=පංචාණ්ඩප
pentachloride=පෙන්ටක්ලෝරයිඩ්
pentacle=පස්කොන් තරුව | ලාංඡනයක් හැටියට භාවිත කරන රූපය
pentacyclic=පංචචක්‍රීය
pentad=පංචකය
pentadactylous=පංචකලාපී
pentadecagon=පංචදශාස්‍රය
pentagon=පංචකෝණය | පංචභුජය | පංචාස්‍රය | පංචාසූය | පස් පට්ටම
pentagram=පස්කොන | පස්කොන් තරුව
pentagrid=පංචජාලකය
pentagynia=පෙන්ටගිනියා
pentahydroxy=පෙන්ටහයිඩ්‍රොක්සි
pentaiodide=පෙන්ටඅයඩයිඩ්
pental=පංචකය
pentamerous=පංචාංක
pentameter=පස්මත් විරිත
pentandria=පෙන්ටන්ඩ්‍රියා
pentandrous=පංචරේණුක
pentapetalous=පංචදල
pentaphyllous=පංචපත්‍රී
pentapterous=පංචපක්ෂ
pentarch=පස්කොන්
pentastichous=පංචපංක්තික
pentateuch=පරණ තෙස්තමේන්තුවේ මුල් පොත් පහ
pentathlon=ඉසව් පහේ තරඟය
pentatomic=පංචපරමාණුක
pentatonic=ස්වර පහක් ඇති
pentavalent=පංචසංයුජ
pentecost=යුදෙව්වන්ගේ අස්වනු කපාගන්නා උත්සවය
penthouse=උපගෘහය | තනි පලයට හැදූ ගෙය | බිහිසියන
pentice=බිහිසියන
pentimento=ඉදහිය
pentnucleotide=පෙන්ට්නියුක්ලියොටයිඩ්
pentobarbiton=පෙන්ටොබාර්බිටොන්
pentode=පංචෝඩය
pentosan=පෙන්ටොසාන්
pentose=පෙන්ටෝස්
pentothal=පෙන්ටොතාල්
pentoxide=පෙන්ටොක්සයිඩ්
pentrough=කොටු දොරුව
penultimate=උපාන්ත | උපාන්තය | උපාන්ත්‍ය
penumbra=උපච්ඡායාව | උපඡායාව | ඡායාප්‍රාන්තය | බාලඡායාව
penurious=දුප්පත් | නියාලු | මසුරු
penury=අසරණභාවය | දිළිඳුකම
peon=කාර්යාල කාර්ය සහායක
peony=ශාකයක්
people=උදවිය | ජන | ජනතා | ජනතාව | ජනයා | ජාතිය | දන | පදිංචි වෙනවා | ප්‍රජාව | මහජනයා | රටවැසි සමූහයා | රටේ උදවිය | ලෝකයා | සෙනඟ
peoplised=ජනසතු
pep=උනන්දුව
pepetuation=ශාශ්වතීකරණය | සදාතනීකරණය
pepo=තක්කාරිය
pepper=ගම්බිරිස් | ගම්මිරිස් | ගම්මිරිස් කුඩු ඉහිනවා | ගම්මිරිස් යොදනවා | මරිච | වෙඩිතබනවා
peppercorn=ගම්මිරිස් කරල
peppermint=පෙපමින්ට් | මිංචි වර්ගයක්
peppery=ඉක්මනින් තරහ යන
pepsin=පෙප්සින්
peptase=පෙප්ටේස්
peptic=දිරවිය හැකි | පංචක | පෙප්ටික
peptidase=පෙප්ටිඩේස්
peptide=ඇමිනෝ අම්ල
peptisator=පෙප්ටයිස්කාරකය
peptization=පෙප්ටයිස් කිරීම
peptize=පෙප්ටයිස් කරනවා
peptone=පෙප්ටෝන්
per=බැගින් | මඟින් | විනිවිද | විසින් | සම්පූර්ණයෙන් | හාත්පස
peracidity=අතිආම්ලිකතාව
peradventure=බාගවේලාවට | සමහර විට
perambulate=එහා මෙහා ඇවිදිනවා | ඔබ මොබ යනවා
perambulation=පරිභ්‍රමණය
perambulator=අත දරුවන් තබා තල්ලුකරන රථය | දුරමානය | දූරමානය | වාරමානය
percale=වියන ලද කපුපිළී
perceive=තේරුම් ගන්නවා | දකිනවා | ප්‍රත්‍යක්ෂ කරනවා
percent=සියයට
percentage=ප්‍රතිශත | ප්‍රතිශතය | ප්‍රතිශෝධනය | සියයට ගණන
percentile=ප්‍රතිශතකය
percept=උපලබ්ධි ඵලය | සංඥාකය | සංඥාතය
perceptibility=සංජානනය කිරීම
perceptible=ඉන්ද්‍රියගෝචර | තේරුම්ගත හැකි | දැක්ක හැකි
perceptio=ග්‍රහණයෙන් අයත් වීම
perception=අනුබොධය | අනුබෝධය | අවබෝධය | දැකීම | ප්‍රග්‍රහය | ප්‍රත්‍යක්ෂඥානය | ප්‍රත්‍යක්ෂය | විභාවනය | විභාවනාව | වේදනා | වේදනාව | සංජානනය | හැඟීම
perceptive=ප්‍රත්‍යක්ෂඥානය හා සබැඳි
perceptual=සංජානක
perch=උසක ලගිනවා | උස් ආසනය | තබනවා | පක්ෂීන් ලගින තැන | පර්චස් එක | පිහිටුවනවා | ලගිනවා | ලැගුම | වහනවා
perchance=අහම්බෙන් | සමහර විට
perchloride=පර්ක්ලෝරයිඩ්
percipient=ප්‍රතිග්‍රාහක | හැඟීමක් ලබන තැනැත්තා
percolate=ඇතුළට කාන්දු වෙනවා | වෑස්සෙනවා
percolation=වෑස්සීම
percolator=කෝපි පෙරන උපකරණය | පෙරහන | වාස්සනය
percrystallization=පාරස්ඵටිකීකරණය
percurrent=පරසාරී
percussion=ආනිහනනය | එකට වැදීම | ඝට්ටනය | පිරිගැටුම | සමාඝාතය | සමාස්ථානය
perdistillation=පාර ආසවනය
perdition=විනාශය
perdurable=සදාතන
pere=පියා
peregrinate=තැනින් තැන යනවා | සැරිසරනවා
peregrination=දේශාටනය
peregrine=උකුස්සන් විශේෂයක්
peremptory=අනුල්ලංඝනීය | නියත | නියමබැඳි | වහා පිළිපැදිය යුතු
perennation=කාලතරණය
perennial=අවිරත | නිත්‍ය | නිරන්තර | බහුවාර්ෂක | බහුවාර්ෂකය | බහුවාර්ෂික | වර්ෂස්ථායි | වර්ෂස්ථායී | සනාතන
perennials=බහු වාර්ෂිකයෝ
perestroika=ප්‍රතිව්‍යහනය | පිරිස්ත්‍රොයිකාව
perfect=අඩුලුහුඬු නැති | අපණ්ණ | අශෛක්ෂ | නිර්දෝෂ | නිර්දෝෂභාවයට පත් කරනවා | පරිපූර්ණ | පරිපූර්ණ කරනවා | පරිසමාප්ත | පාරප්‍රාප්ත | ශ්‍රේෂ්ඨ | සම්පූර්ණ | සම්පූර්ණ කරනවා | සුසාධිත
perfectibility=පරිපූර්ණතාව | සංසාධ්‍යතාව
perfectible=පූර්ණ කළහැකි
perfection=උතුම් ගුණය | නිර්දෝෂතාව | පරිපූර්ණත්වය | පරිසමාප්තිය | පාරප්‍රාප්තිය | පාරමිතාව | පාරමී | ශ්‍රේෂ්ඨත්වය | සම්පූර්ණත්වය
perfectionism=පරිපූර්ණතාවාදය | පාරප්‍රාප්තිවාදය
perfectionist=සර්වතෝභද්‍ර වාදියා
perfervid=ඉතා උනන්දු ඇති
perfidious=ද්‍රෝහී
perfidy=ද්‍රෝහය | ද්‍රෝහිකම | විශ්වාසභංගය
perfoliate=පාරපත්‍රී
perforate=ඡිද්‍රණය | විදගෙන යනවා | විදිනවා | සඡිද්‍ර | සසිදුරු | සිදුරු කරනවා | සිදුරු කිරීම
perforated=සසිදුරු | සිදුරු සහිත
perforation=ඡිද්‍රණය | සිදුර | සිදුරු කිරීම
perforator=සිදුරුකුරුව
perforce=අවශ්‍යකම නිසා | බලාහත්කාරයෙන්
perform=අභිවහනය කරනවා | ඉටු කරනවා | ඉෂ්ට කරනවා | ඉෂ්ටකරනවා | කරනවා | ක්‍රියා කරනවා | රඟ දක්වනවා | රඟ පානවා | රඟදෙනවා | රඟනවා | රඟපානවා | සහභාගී වෙනවා | සිද්ධ කරනවා
performance=අනුයුංජනය | අභිවහනය | ආවරණය | ඉටුකිරීම | කරණය | කළ වැඩේ | ක්‍රියාකාරිත්වය | ක්‍රියාකාරී | ක්‍රියාව | කාරණය | කාර්ය ඵලය | කාර්ය සාධනය | කෘතිය | දර්ශනය | ප්‍රසංගය | රඟ දැක්වීම | රඟ පෑම | රැඟුම් දැක්වීම
performative=අභිවාහ්‍ය | ප්‍රතිඥා | සම්පාදක
performer=අභිවාහක | ඉටුකරන්නා | රඟපාන්නා | රැඟුම් ආදිය දක්වන්නා
performing=රඟ දක්වන
perfromance=කාර්යඵලය
perfume=විලවුන් | සුගන්ධය | සුවඳ කවනවා | සුවඳ ද්‍රව්‍ය | සුවඳ ද්‍රව්‍යය | සුවඳ විලවුන් | සුවඳ විහිදුවනවා
perfumer=සුවඳ සාදන්නා
perfumery=සුවඳ ද්‍රව්‍ය නිපදවන තැන | සුවඳ ද්‍රව්‍ය වෙළඳ සල
perfumes=සුවඳ විලවුන්
perfunctory=නොසැලකිලිමත්ව ක්‍රියා කරන
pergola=මල් වැලින් සැදි ආරුක්කුව
perhaps=බාගෙට | සමහර විට
perianal=පරිගුදය
perianth=පරිපුෂ්පය | පුෂ්පාවරණය | මලක මල් පෙති හා මණි පත්‍ර රැස
periaxial=පරිආක්ෂක
periblem=බාහිකජනකය
pericambial=පරිචක්‍රීය
pericambium=පරිචක්‍රය
pericardectomy=පරිකන්තුවිච්ඡේදනය
pericarditis=පරිකන්තුදාහය
pericardium=පරිකන්තුව | හෘත්කෝශය | හෘදය පටලය
pericarp=කෙමිය | ඵලාවරණය | බීජකෝශය
pericaulome=පරිස්කන්ධය
perichaetial=පරිකවච
perichaetium=පරිකවචය
perichrondium=පරිසෘක්තිය | පෙරික්‍රොන්ඩියම
periclinal=පරිතල
pericline=පර්යානතිය
pericycle=පරිචක්‍රය
pericyclic=පරිචක්‍රීය
pericycloid=පරිවක්‍රාභය
periderm=පරිචර්මය
peridial=පරිය
peridinin=පෙරිඩිනින්
peridiole=පරිඩියෝල
peridium=පරිඩිය
perigee=උපභූමිකය | චන්ද්‍රචාරයේ පෘථිවියට සමීපතම ස්ථානය | භූ සමීපකය
perigioea=පෙරිග්ලියාව
perigon=පරිකෝණය
perigone=පෙරිගෝනිය
perigonium=පෙරිගෝනිය
perigynium=පරිජායාංගය
perigynous=පරිජායාංගී
perigyny=පරිජායාංගතාව
perihelion=අපහේලිකය | උපහේලිකය | ග්‍රහ තාරකා අතර පෘථිවියට සමීපතම තැන | සූර්ය සමීපකය
peril=උපද්‍රවය | මහත් අනතුර
perilous=උපද්‍රව සහිත | සෝපද්‍රව
perils=උවදුරු
perilymph=පරිවසා
perimedullary=පරිමජ්ජා
perimeter=නගර ප්‍රාකාරය | පරිමාපකය | පරිමිතය | පරිමිතිය | මුළු මායිමෙහි දිග | වටප්‍රමාණය | වටය | සමස්ත පරිධිය
perimetry=පරිමාතය
perine=පෙරීනය
perineorrhaphy=විටප සීවනය
perineum=අදෝභගය | විටපය
perinium=උඩුසිවිය
period=අවධිය | ආවර්තය | ඔසප්වීම | කාල පරිච්ඡේදය | කාලච්ඡේදය | කාලපරිච්ඡේදය | කාලය | කාලාන්තරය | කාලාවධිය | කාලාවර්තය | දවස | දශාව | දසාව | යුගය | වකවානුව | වාරය | සමය | සම්පූර්ණ වගන්තිය
periodic=අවර්තක | ආවර්තක | ආවර්තකය | ආවර්තිත | කලින් කල සිදුවන | කාලාවර්තක | නියමිත අවස්ථාවන්හි සිදුවන | සාමයිකව සිදුවන
periodical=ආර්තවික | කලින් කල සිදුවන | කලින්කල | නියමිත අවස්ථාවන්හි සිදුවන | වාර සංග්‍රහය | වාර සඟරාව | වාරිකය | විටින්විට | සාමයිකව සිදුවන
periodically=කලින් කල
periodicity=ආවර්තිකතාව | ආවර්තිකාව | ආවර්තිතාව | නියමිත කාලයෙහි සිදුවීම | වාර නියමය | සිදුවන බව
periodogram=ආවර්තරේඛය
periods=ආවර්ත | කාලච්ඡෙද
perioeci=පරිවාසි ජනයා
periosteum=පර්යස්ථිය
peripatetic=පරිපථන | භ්‍රමණශීලී
peripatetics=පරිපථන විද්‍යාව | පරිපථනවාදීහු
peripatos=පරිපථය
peripety=පරිවර්ථනය
peripheral=නොවැදගත් | පර්යන්ත | පර්යන්තය | පරිධියට අයිති | පිරිවැටි
periphery=පර්යන්තය | පරිධිය | පරියන්තය | පරිවරණය | පිරිවැටිය
periphrasis=චක්‍රීය භාෂාව | චක්‍රීයත්වය | වක්‍රෝක්තිය | වාග්ප්‍රපඤ්චය
periphrastic=වක්‍ර | ව්‍යංග
periphysis=වඳරෝමය
periplasm=පරිප්ලාස්මය
periscope=පරීක්ෂය | පාරිදර්ශකය
perish=දිරාපත් වෙනවා | නැතිවී යනවා | මැරෙනවා | වැනසෙනවා
perishable=ඉක්මනින් නරක්වන | කලක් තබාගත නොහැකි | නරක් වන සුළු | නරක්වන සුලු | නශ්‍ය | නාශනශීලී
perisher=කරදරකාර කොළුවා
perishing=ඉසිලිය නොහැකි
perisperm=පරිපෝෂය
perispermic=පරිපෝෂ සහිත
perisphere=පරිගෝලය
perispore=පරිපෝෂය | පෙරිස්පෝරය
peristalsis=පරින්‍යස්තනය | බඩවැලෙහි හැකිළීම හා දිගහැරීම
peristome=පරිපුටය
perithecium=පලිඝකාව
peritoneum=අන්ත්‍රාවරණය | කුක්ෂිපටලය | පරිතානය
peritonitis=අන්ත්‍රාවරණය ඉදිමීම | පරිතාන ප්‍රදාහය | පරිතානදාහය | පෙරිටනයිටිස්
peritrichous=පරිකේෂර
perityphilitis=පරිනිභෘතකදාහය
perivous=පාරගම්‍ය
periwig=හවරිය
periwinkle=මිනීමල් | සොහොන්මල්
perixylic=පරිශෛලමීය
perjorative=අපකර්ෂී
perjure=දිවුරා බොරු කියනවා | බොරු දිවුරනවා
perjurer=බොරු දිවුරන්නා
perjury=අසත්‍ය සාක්ෂ්‍යය | දිවුරා බොරු කීම | බොරු සාක්කි කීම | බොරු සාක්කිදීම | මුසා සාක්කිය | මුසාසාක්කිය
perk=අහංකාර ලෙස හැසිරෙන | උඩඟු
perky=අහංකාර ලෙස හැසිරෙන | උඩඟු
perlocution=භාෂණඵලය
perlocutionary=භාෂණඵලමයී
perlodicity=ආවර්තිතාව
perm=කොණ්ඩය රැලි ගන්වනවා
permafrost=නිත්‍ය තුහින | සැමදා හිමට යට වූ පස්
permalloy=පාරමිශ්‍රලෝහය
permanence=නිත්‍යතාව | ස්ථිරත්වය | ස්ථීරත්වය
permanency=නිත්‍යවාසය
permanent=අක්ෂය | කල් පවතින | ථාවර | ධුව | නිත්‍ය | චිරස්ථායී | වෙනස් නොවන | ස්ථාවර | ස්ථිර | ස්ථිරසාර | ස්ථීර
permeability=පාරගම්‍යතාව
permeable=උරාගන්නා | කාවැදිය හැකි | ප්‍රවේශ්‍ය | පාරගම්‍ය
permeameter=පාරගම්‍යතාමානය
permeance=පාරගමනය
permeate=පාරගමනය | පැතිරෙනවා
permeating=පාරගාමී
permeation=උරා ගැනීම | පාරගම්‍යතාවය | පැතිරීම
permian=ආදි යුගවලට සම්බන්ධ
permillage=ප්‍රතිසහශ්‍ර | ප්‍රතිසහශ්‍රය | ප්‍රතිසහස්‍ර | ප්‍රතිසහස්‍රය
permille=ප්‍රතිසහශ්‍රකය
permissible=අනුදත් | අනුදනු | අවසර දියහැකි | අවසර ලැබිය හැකි | අවසරය | ඉඩ ඇති | බලය
permission=අනුමතය | අනුමතිය | අවකාශය | අවසරය | වරම | වරය | සමනුඥානය
permissive=අනුඥාත | අනුදත් | ඉඩ ඇති | නිර්බාධ
permit=අනුදන්නවා | අනුදනු පත | අවකාශ දෙනවා | අවකාශ ලැබෙනවා | අවසර දෙනවා | අවසර පත | අවසර පත්‍රය | අවසර ලැබෙනවා | ප්‍රවේශපත්‍රය | බල කඩදාසිය | බලපත්‍රය
permitivity=පාරවිද්‍යුත් නියතය
permitted=අනුදත්
permittivity=පාරවේද්‍යතාව
permofrost=නිත්‍ය තුහින
permutable=හුවමාරු කළ හැකි
permutation=අංකපාශය | නිමේයය | විපරිණාමය | සංකරණය
permuters=විපරිවර්තීය පද
pernicious=අනර්ථ ගෙන දෙන | ඝාතක | විනාශදායක | විනාශදායී
pernickety=සුළු වැරදි දක්නා
pernocton=පර්නොක්ටොන්
peroration=උපසංහාරය
peroxidase=පෙරොක්සිඩේස්
peroxide=ඔක්සිජන් අඩංගු සංයෝගයක් | පෙරොක්සයිඩ්
perpendicular=ආලම්බ | ලම්බ | ලම්බක | ලම්බකය | ලම්බය | ලම්බාකාර | ලම්බාකාරව පිහිටි රේඛාව | ලම්භකය
perpetrate=නරකක් කරනවා | වරදක් කරනවා
perpetration=අපරාධ කිරීම
perpetrator=අපරාධ කාරයා
perpetual=නිත්‍ය | නිරන්තර | නිරන්තර සේ පෙනෙන | නොනැවත පවත්නා | සදාකාලික | සදාතන
perpetuate=චිරස්ථායී කරනවා
perpetuity=අනවරත වාර්ෂිකය | නිත්‍ය | නිත්‍ය වශයෙන් පැවැත්ම | සදාකාලය | සදාකාලිකභාවය | සදාතනත්වය
perplex=අවුල් කරනවා | ව්‍යාකූල කරනවා | වික්ෂිප්ත වෙනවා | සැක උපදවනවා
perplexity=අන්තෝජටා | ජරමර | වත්ත වික්ෂේපය | වික්ෂේප | වික්ෂෝභනය | විමතිය | සැකය
perplexly=පැටලැවුණු ස්වභාවයක් ඇතිව
perquisite=අතිරේක ලාභය
perquisites=අධ්‍යාර්ජනය | උරුමයෙන් බැහැර ආදායම් | උරුමයෙන් බැහැරි ආදායම | බාහිර ආදායම්
perry=බීම වර්ගයක්
persecute=හිංසා කරනවා
persecution=වධ දීම | හිංසා කිරීම
persecutor=වධකයා
perseity=තද්භූ | දේභාවය
perseverance=උට්ඨාන වීර්යය | උත්සාහය | උද්‍යෝගය | දෘඩ උත්සාහය | ප්‍රබල උත්සාහය
perseveration=අභිනිවේශය
persevere=දැඩි වීර්ය කරනවා | නොනැවත කරගෙන යනවා | නොපසුබටව කර ගෙන යනවා | නොපසුබටව කරනවා
persevering=උත්සාහවත් | උත්සාහවන්ත
persiflage=උපහාසය
persist=අප්‍රතිහතව කරගෙන යනවා | නොනැසී පවතිනවා | මුරණ්ඩුකම් දක්වනවා
persistance=පැවැත්ම
persistence=අප්‍රතිහත ධෛර්යය | එලබ සිටීම,ප්‍රස්ථීතිය | ප්‍රාවර්තනය | පැවැත්ම | රිස්සුම
persistency=අප්‍රතිහත ධෛර්යය | එලබ සිටීම | සමාවෘතිය
persistent=අනවරත | අප්‍රපතන | නිබැදි | නිබැඳි | නොනැවත කරනු ලබන | නොනැවතී පවත්නා | නොනැසී පවත්නා | මුරණ්ඩු
persisting=නිබඳු
person=අය | ඇඟපත | කෙනෙක් | තැත | තැනැත්තා | නම | පළ | ප්‍රාණකාරයා | පුඟුලා | පුද්ගලය | පුද්ගලයා | පොළ | මනුස්සයා | ශරීරය
persona=කථක | පුද්ගලතාව | ව්‍යක්තිය
personable=පුද්ගල ස්ථීත්‍යයක් ඇති | මනා රූ ඇති | ලක්ෂණ
personage=උත්තමයා | උත්තමයෙක් | උසස් කෙනෙක්
personal=ආධ්‍යාත්මික | පුද්ගල | නින්දා සහගත | පුද්ගල | පුද්ගලික | පුද්ගලීය | පෞද්ගලික | ශරීරය පිළිබඳ | ස්වකීය
personalidealism=පුද්ගලාධිෂ්ඨානය
personalism=පුද්ගල ප්‍රමාණවාදය | පුද්ගලප්‍රමාණවාදය
personalistics=පුද්ගලවිභාගය
personalities=කෙනෙකු පිළිබඳ දොස් දක්වා කරන කථා
personality=අනුභාසම්පන්න බව | ආත්මභාවය | චංචල දේපල | පුද්ගල විශේෂතාව | පුද්ගලත්වය | පූද්ගලතාව | පෞද්ගලිකත්වය | පෞරුෂත්වය | පෞරුෂය | විශේෂ ලක්ෂණ | ස්වභාවය | ස්වියත්වය | ස්වීයත්වය
personalization=පුද්ගලායනය
personalize=පෞද්ගලිකව අයිති කරගන්නවා
personally=තමාම | පෞද්ගලිකව
personate=අනෙකෙකු සේ පෙනී සිටිනවා | සංරුද්ධ
personation=අනෙකෙකු සේ පෙනීසිටීම | පුද්ගලාරූඩය | විඩම්බනය
personator=විඩම්බකයා
personification=පුද්ගලත්වය ආරෝපණය කිරීම | පුද්ගලවත් කිරීම | පුද්ගලායනය | පුද්ගලාරෝපණය | පුද්ගලීකරණය
personified=පුද්ගලායිත
personify=පුද්ගලයනය | පුද්ගලායනය | පුද්ගලායනය කරනවා | මූර්තිමත් වෙනවා
personnel=කාරක මණ්ඩලය | කාර්ය මණ්ඩලය | පිරිස | පිරිස් | සේවක | සේවක පිරිස | සේවක මණ්ඩලය | සේවා මණ්ඩලය | සේවීජනයා
personology=ස්වීයත්ව අධ්‍යයනය
persons=අය | දෙනා
persopation=ප්‍රාවශෝෂණය
persorption=අතිශෝෂණය
perspective=ඇසට පෙනෙන දර්ශනය | දෘෂ්ටිකෝණය | පර්යාදර්ශී | පර්යාලෝක | පර්යාලෝකය | යථාදර්ශනය
perspectivism=පර්යාලෝකවාදය
perspectivity=පර්යාලෝකතාව
perspex=පාරදෘශ්‍ය ප්ලාස්ටික් විශේෂයක්
perspicacious=තීක්ෂ්ණ බුද්ධිය ඇති | සූක්ෂ්ම දෘෂ්ටි ඇති
perspicacity=තීක්ෂ්ණතාව | දෘෂ්ටිය පිළිබඳ තීක්ෂ්ණභාවය | බුද්ධිය පිළිබඳ තීක්ෂ්ණභාවය
perspicuity=නිරවුල් බව | පැහැදිලිබව | විශදතාව | විශදභාවය
perspicuous=නිරවුල් | පැහැදිලි | ස්පෂ්ට
perspiration=ඩාදිය | ඩාදිය දැමීම | දහඩිය ගැලීම | ස්වේදනය
perspire=දාඩිය දමනවා | හැල්බඩ ලනවා
persuade=අනුනයනය කරනවා | අනුනයනය කිරීම | ඒත්තු ගන්වනවා | නම්මා ගන්නවා
persuasion=ඒත්තු ගැන්වීම | කැමැති කරවාගැනීම | දෘෂ්ටිය | නිකාය | ප්‍රරෝචනය | පෙළඹවීම | සභාව | සම්ප්‍රදාය
persuasive=අනුනයී | නම්මන
persue=එළවා යනවා | ලුහුබඳිනවා
persuit=එළවා යෑම | ලුහුබැඳීම
pert=බුහුටි
pertain=අදාළව පවතිනවා | අයිතිව පවතිනවා
pertinacious=ආධානගාහී | මුරණ්ඩු
pertinacity=අභිනිවේශය | ස්ථිරව සිටීම
pertinent=අදාළ | උචිත | කාරණයට සම්බන්ධ වූ
pertubation=වික්ෂෝභය
perturb=වික්ෂිප්තභාවයට පමුණුවනවා
perturbation=කැලඹීම | වික්ෂෝභය
pertussis=උත්කාසය
peruke=බොරු කොණ්ඩය
perusal=පරීක්ෂාකාරීව කියවීම
peruse=පරීක්ෂාවෙන් කියවා බලනවා
pervade=ව්‍යාප්ත වෙනවා | විනිවිද යනවා | හාත්පස පැතිරෙනවා
pervasion=පැතිරීම | විසිරී පැවතීම
pervasive=පැතිරී පවතින
perverse=අදම්‍ය | දුෂ්ට | මුරණ්ඩු | හිතුවක්කාර
perverseness=අගතිය | හිතුවක්කාරකම
perversion=අයුතු ලෙස යෙදෙනවා | අවවර්තනය | දුරාචාරය | මුළා කිරීම | විපර්යාසය | විපරිවර්තනය
perversity=අගතිය | හිතුවක්කාරකම
pervert=අවවර්තිකයා | කාමවිකෘතයා | නොනිසි ලෙස යොදනවා | මිථ්‍යාදෘෂ්ටි වැළඳගත් තැනැත්තා | මිථ්‍යාදෘෂ්ටියට හරවාගන්නවා | මුළා කරනවා | වරදෙහි පොළඹවනවා | විපර්යාස කරනවා
pervibration=ප්‍රකම්පනය
pervious=ඇතුළට යා හැකි | ප්‍රවේශ්‍ය | සම්පූර්ණයෙන් වැසී නැති
peseta=ස්පාඤ්ඤයේ කාසියක්
pesky=කරච්චල් කරන
peso=ලතින් ඇමෙරිකානු රටවල භාවිත කරන මුදල්
pessary=පෙසරිය | යෝනිස්තම්භනිය
pessimism=අශුභවාදය | සර්වශුභවාදය | සර්වාශුභවාදය
pessimist=සර්වාශුභවාදියා
pessimistic=සර්වාශුභවාදි
pest=උපද්‍රවය | පලිබොධය | මහත් හිරිහැරය | මාරිය | වසංගතය
pester=කරදර කරනවා | ගැහැට කරනවා | හිරිහැර කරනවා
pesticide=කෘමිනාශක ද්‍රව්‍යය
pestiferous=බොහෝ පීඩා ගෙනදෙන | වසංගත ඇති කරන
pestilence=වසංගතය | සෘතුකය
pestilent=මහත් උපද්‍රව සහිත | මාරක
pestilential=අතිදුෂ්ට | මාරාත්මක | වසංගත ඇතිකරන
pestle=මූසුල | මොහොල | මෝල් | මෝල්ගස | මෝල්ගහ | වණ
pestology=කෘමි විද්‍යාව
pet=ආදරය දක්වනවා | කේන්තිය | සුරතල් | සුරතල් කරනවා | සුරතල් දරුවා | සුරතල් සතා | සුරතලා | සුළු තරහ
petal=දල | දලය | පතාක දලය | මල් පෙත්ත | ශේඛරපත්‍රය
petaliform=දලාකාර
petaline=දලාකාර
petalode=දලාභය
petalody=දලාභතාව
petaloid=දලාභ
petalous=සදල
petaly=සදලතාව
petard=පුපුරන වෙඩි වර්ගයක්
petechial=පෙටිකීය
petella=කටාහකය | දණිස් කටුව
peter=ක්ෂය වී යනවා | ක්‍රමයෙන් නැතිවී යනවා
petersham=ඝන දඟ වැටුණු සේද පටි
pethidine=පෙතින්
petiolar=වෘන්ත | වෘන්තීය
petiolate=සවෘන්ත
petiole=කොළ නටුව | පත්‍ර වෘන්තය
petiolular=වෘන්තික
petiolule=වෘන්තිකාව
petit=චුට්ටි | පුංචි
petite=චුට්ටි | පුංචි
petition=අයදිනවා | අයදුම | ඉල්ලුම් කරනවා | ඉල්ලුම් පත්‍රය | ඔප්පුකර සිටිනවා | පෙත්සම | පෙත්සමක් ඉදිරිපත් කරනවා | යමක් ඉල්ලනවා | ලිඛිත ආයාචනාවක් කරනවා
petitioner=අයදුම්කරු | අයදුම්කාරයා | පෙත්සම්කරු
petitmal=පෙටිට්මාල්
petra=ගල | බර
petraology=පාෂාණ විද්‍යාව
petrel=කුඩා මුහුදු පක්ෂියෙක්
petrifact=පාෂාණීභුතය
petrifaction=කැටි ගැසීම | ගල් ගැසීම | ගල්වීම | පාෂාණීභවනය
petrification=ගල්වීම | පාෂාණි භවනය | පාෂාණිභවනය | ශිලාභවනය
petrify=ගල් කරනවා | ගල් ගැහෙනවා | ගල් වෙනවා | ගල්වෙනවා | පාෂාණි වෙනවා | පාෂාණීවෙනවා
petrloleum=පැට්‍රෝලියම්
petrochemical=බොරතෙල් හෝ භූමි වායුවෙන් ලබා ගන්නා ද්‍රව්‍යයක්
petrodollar=තෙල් විකුණා ලැබෙන ඩොලර්
petrogeny=පාෂාණජනනය
petrography=පාෂාණ විස්තර විද්‍යාව | පාෂාණසංයුති විද්‍යාව
petrol=ඛනිජ තෙල් | පැට්‍රල් | පැට්‍රෝල් | පෙට්‍රල්
petroleum=ඛනිජ තෙල් | ඛනිජතෙල් | පැට්‍රෝලියම් | පෙට්‍රෝලියම් | මිහිතෙල්
petrolium=පැට්‍රෝලියම්
petrology=පරම්පරා විද්‍යාව | පාෂාණ විද්‍යාව | පාෂාණ විස්තර විද්‍යාව
petrophilus=පාෂාණකාමී
petrophyta=පාෂාණශාක
petrophytes=පාෂාණශාක
pettah=පිටකොටුව
petticoat=නීවිය | යටගවුම | ස්ත්‍රීන්ගේ යටසාය
pettifog=සුළු දේ ගැන නඩු කියනවා
pettifoger=සුළු දේ ගැන නඩුහබ ගැන ක්‍රියා කරන නීතිඥයා
pettifogging=කෙස් පලන
petting=ලාලනය
pettish=කේන්ති යන | කේන්තියෙන් සිටින
petty=නීච | නොවැදගත් | සුළු
petulance=වහා ඇවිස්සෙන බව
petulant=නොරිස්සුම් ගති ඇති
petunia=මල් ඇති ශාකයක්
pew=ආසන පෙළක් ඇති බංකුව
pewter=පිට්ටර් ලෝහය | පිව්ටර්
peyote=මෙක්සිකානු පතොක් විශේෂයක්
peyotism=පෙයෝජිතිස්මය
pfennig=ජර්මනියේ ඉතා සුළු වටිනාකමක් ඇති කාසියක්
pgeon=පරෙවියා
phacolite=පාකොලයිට්
phacolith=පාකොලිත්
phaeophycean=පේයොපිසේය
phaeophyll=පේයොපිල්
phaeophyta=පේයොපීටා
phaeophyte=පේයොපීටා ශාකය
phaeosporae=පේයොස්පොරේ
phaeton=අශ්වයන් දෙදෙනකු ඇති රථය
phagocyte=පේගෝසයිටය | භක්ෂ සෛටය | ලේවල රෝගබීජනාශක කොටසක්
phagocytosis=භක්ෂසෛටොසියාව
phalanges=ඇඟිලි ඇට | සෙබළ මුල්
phalanx=ඇඟිලි ඇටය | ජනතා සමූහය | පර්වනය | පාලිකය | සෙබළ මුළ | සේනාබ්‍යහය
phallic=ලිංගය වැනි
phalline=පැලයින්
phalloid=පලුස් වැනි
phallus=පලුස් | ලිංගරූපය | ශෛශ්නය
phanerogam=දෘශ්‍යයෝගිය
phanerogamic=දෘශ්‍යයෝගි
phanerogamous=දෘශ්‍යයෝගි
phanerophyte=දෘශ්‍යශාකය
phantasm=අභූතරූපය | අවතාරය | කල්පනාමාත්‍රය | මනොකල්පනාව | මනෝ දෘෂ්ටිය | මනෝදෘෂ්ටිය | මායාව
phantasmagoria=අභූතරූපදර්ශනය | ඉන්ද්‍රජාලය
phantasmal=මායා | මායාරූපී
phantasy=අපූර්ව සිහිනය | මනස්සෘෂ්ටිය | මනහ්කල්පිත | මනහ්සෘෂ්ටිය | විජ්ජාව | විවත්‍ර කල්පනාව
phantom=අභූතරූපය | අවතාරය | භූතයා | මායාව
phanton=අවතාරය
pharaoh=පාරාවෝ
pharisaic=ව්‍යාජ භක්තික
pharisaical=ව්‍යාජ භක්තික
pharisaism=පරිසිවාදය
pharisee=ව්‍යාජ භක්තිකයා | හොර උපාසකයා
pharmaceutical=ඖෂධ
pharmacist=බෙහෙත් වෙළෙන්දා | භිෂග්වේදියා | හෛෂකයා
pharmacodynamics=භෛෂජ්‍ය ශක්තතාව
pharmacology=ඖෂධ විද්‍යාව | ඖෂධ ශාස්ත්‍රය | භිෂක්වේදය | භිෂග්වේදය
pharmacopoeia=ඖෂධ නිඝණ්ඩුව | ඖෂධසංග්‍රහය
pharmacotherapy=භිෂග්වකිත්සාව
pharmacy=ඖෂධාගාරය | ඖෂධාලය | බෙහෙත් ශාලාව | බෙහෙත් සෑදීමේ විද්‍යාව | භෛෂජ්‍ය සංග්‍රහය
pharmocology=භිෂග්වේදය
pharos=පහන්කණුව
pharyngitis=උගුරේ දැවිල්ල | කණ්ඨවිවරදාහය | ග්‍රසනිකා පදාහය | ග්‍රසනිකාදාහය
pharyngotomy=ග්‍රසනිකාද්වාරණය
pharynx=උගුරේ කෙළවර කොටස | ග්‍රසනිකාව
phase=අංශය | අවධිය | අවස්ථාව | කලාපය | කලාව | ප්‍රාවස්ථාව | පාර්ශ්වය | පැත්ත | පියවර
phasea=ප්‍රාවස්ථාව
phaseolin=පසෙයොලින්
phaseolunatin=පසෙයොලුනටින්
phasing=කලාස්ථ කිරීම
phasor=අවධිකය
pheasant=වලිකුකුළාට සමාන පක්ෂිවර්ගයක්
phellem=වල්කය
phelloderm=වල්ක චර්මය
phellogen=වල්ක ජනකය
phenacetin=පෙනසිටින්
phenazone=පෙනසෝන්
phenix=මිථ්‍යා පක්ෂියෙක්
phenobarbitone=පෙනොබාර්බිටොන්
phenol=ඇරෝමැටික හයිඩොකාබනයක ව්‍යත්පන්නය | පීනොල් | පීනෝල්
phenology=ජීවර්තු විද්‍යාව | වර්තු විද්‍යාව | සෘතු ඵල විද්‍යාව
phenomena=ප්‍රපංච | සංසිද්ධි | සිද්ධි
phenomenal=අති විශාල | ආශ්චර්යවත් | ප්‍රපංච | සංසිද්ධි
phenomenalism=ප්‍රපංචවාදය | ප්‍රපඤ්චවාදය | සංසිද්ධි වාදය
phenomenology=ජීවර්තු විද්‍යාව | ප්‍රපංචවේදය | සංසිද්ධි විද්‍යාව
phenomenon=අද්භූත සිද්ධිය | ආශ්චර්යය | දෘශ්විෂයය | ප්‍රපංචය | විද්‍යාමාන දේ | සංසිද්ධිය | ස්වාභාවික සිද්ධිය
phenotype=රූපානුදර්ශය
phenotypic=රූපානුදර්ශී | රූපානුදර්ශීය | රූපායුදර්ශිය
phenylalanine=පෙනිල් ඇලනයින්
phew=වහ්
phi=ග්‍රීක හෝඩියේ විසි එක්වන අකුර
phi-coefficient=ඵයි සංගුණකය | මි සංගුණකය
phi-phenomenon=පෛ සංසිද්ධිය
philadelphus=වනයේ පඳුරු විශේෂයක්
philander=සල්ලාලනය කරනවා | ස්ත්‍රීන් සමග සෙල්ලම් කරනවා
philanderer=සල්ලාලයා
philanthrophy=ජනහිතකාමය | පරාර්ථ චර්යාව | පරාර්ථචර්යාව | මානවහිත කාමය
philanthropic=පරාර්ථකාමියා
philanthropist=පරාර්ථකාමියා | මහජන හිතෛෂියා
philanthropy=ජනහිතකාමය | පරාර්ථකාමීභාවය
philatelist=මුද්දර එකතු කරන්නා
philately=මුද්දර එකතු කිරීම
philippic=බැණ වැදීම | භය | විරුද්ධ
philistine=අශිෂ්ටයා | කලාවන් ප්‍රිය නොකරන්නා | කලාවිහීන | කලාවිහීනයා | පිලිස්තීනුවා
philistinism=පිලිස්තීනු දෘස්ටිය | සභ්‍යත්වය නොරුස්නා බව
philological=වාග්විද්‍යාත්මක
philologist=වාග්විද්‍යාඥයා
philology=භාෂාශාස්ත්‍රය | වාග්විද්‍යාව | ශබ්ද විද්‍යාව | ශබ්දවිද්‍යාව
philosopheme=දාර්ශනික නිගමනය | දාර්ශනික ප්‍රදර්ශකත්වය
philosopher=ආපදාවන්හි කම්පා නොවන්නා | තත්ත්වඥයා | දර්ශන වාදියා | දාර්ශනිකයා | ප්‍රාඥයා | න්තකයා
philosophic=කම්පා නොවන | දර්ශනය පිළිබඳ වූ | දාර්ශනික | ප්‍රාඥ
philosophical=කම්පා නොවන | දර්ශනය පිළිබඳ වූ | ප්‍රාඥ
philosophize=ඥානවන්ත ලෙස කියනවා | ඥානවන්ත ලෙස සිතනවා | දාර්ශනික විමර්ශනය
philosophy=ආන්වික්ෂිකී ශාස්ත්‍රය | තත්ත්වවිචාරය | දර්ශන විද්‍යාව | දර්ශනය | දර්ශනවාදය | දසුන | චින්තනය | හේතුධර්මශාස්ත්‍රය
philter=ඉනා බේත | වශීකරණ ඖෂධය
philtre=ඉණාව | ඉනා බේත | වශීකරණ ඖෂධය
phimosis=රෞධ්‍යය
phitre=ඉණා බෙහෙත්
phiz=මූණ
phlebitis=ධමනීපාකය | ලේ නහරවල රුදාව | හිංස්‍රාදාහය
phlebotomus=ප්ලීබොටමස්
phlegm=අලසකම | කළු | ශ්ලේෂ්ම | ශ්ලේෂ්මල | සෙම | සෙම්
phlegmatic=අලස | උනන්දුවක් නැති | සෙම් අධික | සෙම්බර
phlobaphene=ප්ලෝබපීන්
phloem=ප්ලෝයම
phlogiston=ප්ලොස්ටන් | මුල් අවධියේදී දහනය ඇතිකළා යයි කියන දෑ
phloroglucin=ප්ලෝරොග්ලුසින්
phlox=ශාකයක්
phoaphorometer=ස්ඵුරමානය
phobia=භීතිකාව
phoenix=අද්විතීයයා | පිනික්ෂියා
phon=පොනය
phonation=ස්වනය
phonautograph=ධ්වනිරේඛය
phone=අමතනවා | බණුව
phoneidoscope=ධ්වනි තත්වේක්ෂය
phoneloscope=ධ්වනිමානේක්ෂය
phoneme=ශබ්දාණුව
phonetic=වාග්විෂයක | ශබ්දයන් පිළිබඳ
phonetician=භාෂා විද්‍යාඥයා | ශබ්දවිද්‍යාඥයා
phonetics=ශබ්ද විද්‍යාව | ශබ්ද ශික්ෂාව | ස්වර ශික්ෂාව | ස්වරශාස්ත්‍රය
phonic=ධ්වනි | ශබ්ද විද්‍යාවට සම්බන්ධ
phonodeik=පොනොඩයිකය | පොනෝඩයිකය
phonogram=පොනෝග්‍රෑමය | ශබ්ද රූපය | ශබ්දවාහිනී තැටිය | හඬ තැටිය
phonograph=තැටි වාදන යන්ත්‍රය | ශබ්ද ලේඛය | ශබ්දවාහිනිය
phonography=ලඝුලේඛන ක්‍රමයක්
phonology=ශබ්ද විද්‍යාව | ස්වර විද්‍යාව | ස්වරයන්ගේ යෙදීම | ස්වරශාස්ත්‍රය
phonometer=ධ්වනිමානය
phonon=පෝනෝනය
phonopathy=ධ්වනි ව්‍යථය
phonophobia=ධ්වනි භීතිකාව
phonorecord=ශබ්ද රෙකෝඩය
phonoscope=ධ්වනීක්ෂය
phony=බොරු | ව්‍යාජ
phoronomy=ප්‍රේරණ නියාමය
phosphatase=පොස්පටේස්
phosphate=පොස්පේට් | ෆොස්පේට්
phosphoglucomutase=පොස්පොග්ලුකොමියුටේස්
phosphoglyceraldehyde=පොස්පොග්ලිසරැල්ඩිහයිඩ්
phosphohexokinase=පොස්පොහෙක්සොකයිනේස්
phospholipid=පොස්පොලිපිඩ්
phospholipin=පොස්පොලිපින්
phosphor=ප්‍රකාශද
phosphor-bronze=පොස්පර් ලෝකඩ
phosphoresce=ස්ථූරදීපනය වෙනවා
phosphorescence=අග්නිරහිත දීප්තිය | ස්ථුරදීපනය | ස්ථූරදීපනය | ස්ඵුරදීපනය
phosphorescent=ස්ඵුරදීප්ත | ස්ඵූරදීප්ත
phosphorolysis=පොස්පොරොලිසිය
phosphoroscope=ස්ථුරදීපේක්ෂය
phosphorus=ප්‍රකාශද | පොස්පරස් | පොස්පොරස්
phosphorylase=පොස්පොරිලේස්
phosphorylation=පොස්පොරයිලීකරණය
phot=පෝටය
photerythrous=ප්‍රභාරක්තය
photism=ප්‍රභා මෝහය
photo=ඡායා | සේයාව
photo-dissociation=ප්‍රකාශ විඝටනය
photo-elasticity=ප්‍රකාශ ප්‍රත්‍යාස්ථතාව
photo-electricity=ප්‍රකාශ විද්‍යුතය
photo-electrons=ප්‍රකාශ ඉලෙක්ට්‍රෝන
photo-engraving=සේයා නිරේඛණය
photo-finish=ඡායා නිර්ණය | ඡායාරූපයක ආධාරයෙන් නියම කරන තුරඟ දිවුම
photo-lithography=ඡායා ලිතෝ මුද්‍රණ ක්‍රමය
photo-offset=පොටෝ සප්සෙට් ම්‍රද්‍රණය
photo-oxidation=ප්‍රකාශඔක්සිකරණය
photo-phobia=ප්‍රභාභීතිකාව
photo-synthesis=ප්‍රභා සංස්ලේශණය
photobacteria=ප්‍රකාශ බැක්ටීරියා
photobiotic=ප්‍රකාශවී
photobmagnetism=ප්‍රකාශ චුම්බකත්වය
photocatalysis=ප්‍රකාශ උත්ප්‍රේරණය
photocathode=ප්‍රකාශ කැතෝඩය
photocell=පකාශ කෝෂය | ප්‍රකාශ කෝෂය
photocharger=සේයා පොත් නිකුතු යන්ත්‍රය
photocharging=සේයා පොත් නිකුතුව
photochemical=ප්‍රකාශ රසායන
photochemistry=ප්‍රකාශ රසායනය
photocomposition=සේයා වර්ණයෝජනය
photoconductivity=ප්‍රකාශ සන්නායකතාව
photocopier=ඡායා පිටපත් යන්ත්‍රය
photocopy=ඡායා පිටපත
photocopying=ඡායා පිටපත් ගැනීම
photocurrent=ප්‍රකාශ ධාරාව
photodiode=ප්‍රකාශ ඩයෝඩය | ප්‍රකාශ දියෝඩය
photodisintegration=ප්‍රකාශ පෘථක්කරණය
photodissociation=ප්‍රකාශ විඝටනය
photodynamic=ප්‍රකාශගති
photoelasticity=ප්‍රකාශ ප්‍රත්‍යාස්ථතාව
photoelectric=ප්‍රකාශ විද්‍යුතයට අයත් | ප්‍රකාශ විද්‍යුත්
photoelectricity=ප්‍රකාශ විද්‍යුතය | ප්‍රකාශවිද්‍යුතය
photoelectrometer=ප්‍රකාශවිද්‍යුත්මානය
photoelectron=ප්‍රකාශ ඉලෙක්ට්‍රෝනය
photoemissive=ප්‍රකාශ විමෝචන
photoengraving=ඡායා උත්කීරණය
photoetching=ඡායා නිරේඛනය
photogalvanomerter=ප්‍රකාශ ගැල්වනොමීටරය
photogenic=ඡායාකාන්ත | ප්‍රකාශජනක | පින්තූර ගත් විට හොඳට පෙනෙන
photogrammetry=ඡායාරේඛනමිතිය | ඡායාලේඛනමිතිය
photograph=ඡායාරූප | ඡායාරූප ගන්නවා | ඡායාරූපය | ඡායාරූපයක් වශයෙන් වැටෙනවා
photographer=ඡායාරූප ගන්නා | ඡායාරූප ශිල්පියා
photographic=ඡායාරූප | ඡායාරූප පිළිබඳ | ඡායාරූපයක් වැනි | ඡායාරූපී
photography=ඡායාරූප කලාව | ඡායාරූප ශිල්පය
photogravure=ඡායා උත්කීරණය | ඡායාරූප පටලයකින් ලෝහමය රාමුවකට රූපගත කිරීම
photohalide=ප්‍රකාශ හේලයිඩය
photohyalography=ප්‍රකාශ කාචරේඛනය
photoisomeric=ප්‍රකාශ සමාවයවික
photokinesis=ප්‍රකාශචලනය | ප්‍රභා චලනය
photokinetic=ප්‍රකාශචාලක
photolithography=ගල්වල කැටයම් කර මුද්‍රණය කිරීම
photoluminescence=ප්‍රකාශ සන්දීප්තිය
photolysis=ප්‍රකාශ විච්ඡේදනය | ප්‍රභාවිච්ඡේදනය
photolyte=ප්‍රකාශ විච්ඡේද්‍යුය | ප්‍රභාවිච්ඡේද්‍යය
photolytic=ප්‍රකාශ විච්ඡේද්‍යු | ප්‍රභාවිඡේද්‍ය
photoma=ප්‍රභා මායාව
photomagnetism=ප්‍රකාශ චුම්බකත්වය
photomanometer=ප්‍රභා පීඩනමානය
photometer=දීප්තිමානය | දීප්තිමාපකය | ප්‍රකාශමානය | ප්‍රභාමානය | පොටෝමීටරය
photometric=දීප්තිමාපක | ප්‍රකාශමිතික
photometry=දීප්තිමිතිය | ප්‍රකාශමිතිය
photomicrograph=අණ්වීක්ෂ ඡායාරූපය | ඡායා සූක්ෂ්මරේඛය
photomorphosis=ප්‍රකාශරූපනය
photomultiplier=ප්‍රකාශ ගුණකය
photon=පෝටෝනය
photonastic=ප්‍රභාසන්නමන
photonasty=ප්‍රභසන්නමනය
photoperiodism=ප්‍රකාශ අවධි ප්‍රචාරය | ප්‍රකාශ අවධිප්‍රතිචාරය | ප්‍රකාශාවර්තිතාව
photopharmacology=ප්‍රකාශ භීෂග් වේදය
photophilic=ප්‍රකාශකාමී
photophilous=ප්‍රකාශකාමී
photophobia=ආලෝක භීතිකාව | ප්‍රභා භීතිකාව | ප්‍රභාභීතිකාව
photophone=ප්‍රකාශද්වනිකය
photopolymerization=ප්‍රකාශ බහුඅවයවීකරණය | ප්‍රකාශ බහුඅවයවීභවනය
photoproduct=ප්‍රකාශ ඵලය
photoreaction=ප්‍රකාශ ප්‍රතික්‍රියාව
photoreceptive=ප්‍රභාග්‍රාහක ක්‍රියාවලිය
photoreceptor=ප්‍රභාග්‍රාහක ක්‍රියාවලිය | ප්‍රභාග්‍රාහකය
photoreduction=ප්‍රකාශඔක්සිහරණය
photosensitive=ආලෝක ප්‍රතිචාරි | ආලෝක සංවේදී | ප්‍රකාශ සංවේදී
photosensitivity=ප්‍රකාශ සංවේදිතාව
photosensitizer=ප්‍රකාශ සංවේදකාරකය
photosetting=සේයා වර්ණ යෝජනය
photosphere=ප්‍රකාශ ගෝලය | ප්‍රභාගෝලය
photostable=ප්‍රකාශ ස්ථායී
photostat=ඡායා පිටපත | ඡායාස්ථීති | පෝටෝස්ටැට්
photostatic=ඡායාස්ථිතික
photosynthesis=ප්‍රභා සංශ්ලේෂණය | ප්‍රභාසංශ්ලේෂණය
photosynthetic=ප්‍රභාසංශ්ලේෂ | සංශ්ලේෂක
phototelegraphy=ප්‍රකාශ දුරරේඛය
phototheodolite=ඡායාතියඩොලයිට්ටුව
phototonic=ප්‍රකාශතානික
phototonus=ප්‍රකාශතානය | ප්‍රකාශසංවේදිතාව
phototopography=ඡායාභූලක්ෂණය
phototransistor=ප්‍රකාශ ට්‍රාන්සිස්ටරය
phototrophy=ප්‍රකාශපෝෂය
phototropic=ප්‍රභාවර්තී
phototropism=ප්‍රකාශාවර්තනය | ප්‍රභාවර්තනය
phototube=ප්‍රකාශ කපාටය
phragmoplast=ප්‍රුග්මොප්ලාස්ටය
phragmosome=ප්‍රුග්මසෝම
phrase=කැඩිය | පාදය | වචනයෙන් ප්‍රකාශ කරනවා | වාක්සම්ප්‍රදාය | වාක්‍ය ඛණ්ඩය | වාක්‍යාංශය | වැකිකඩ
phraseology=පදරචනාව | වාක්ශෛලිය | වාග් ශෛලිය
phratry=පාර්ශ්වය
phrenicotomy=ප්‍රේණික විච්ඡේදනය
phrenologist=හිස් කටුවෙහි ආකාරය බලා ගතිගුණ කියන්නා
phrenology=කපාලලක්ෂණ ශාස්ත්‍රය | ප්‍රේණවේදය | මස්තක නෛමිත්තය
phronesis=අර්ථසිද්ධි ඥානය | ප්‍රායෝගික ඥානය
phrynoderma=ශාලුරචර්මය
phthalylsulphathiazole=තෙලිල්සල්පතයසෝල්
phthisis=ක්ෂයරෝගය | පුප්ඵුසක්ෂය
phut=නාස්ති වී
phycochrome=පයිකොක්‍රෝම්
phycochrysin=පයිකොක්‍රිසින්
phycocyanin=පයිකොසයනින්
phycoerythrin=පයිකොඑරිත්‍රින්
phycohaematin=පයිකොහීමටින්
phycologist=ඇල්ගී විද්‍යාඥයා
phycology=ඇල්ගී විද්‍යාව
phycomycetes=පීකොමිසෙටේස්
phycophaeine=පයිකොපේයින්
phycoporphyrin=පයිකොපෝපයිරින්
phycopyrrhine=පයිකොපයිරීන්
phycoxanthine=පයිකොසැන්තින්
phykocyanin=පයිකොසයනින්
phykoerythrin=පයිකොඑරිත්‍රින්
phylactery=හීබ්‍රූ පොත්පත් අඩංගු කුඩා සම්පසුම්බිය
phyletic=වංශික | වාංශික
phyllidium=පිලීඩියම
phyllite=පිලයිට්
phyllocaline=පිලෝකැලයින්
phylloclade=පත්‍රීස්කන්ධය
phyllode=පත්‍රාහය
phyllody=පත්‍රාභනය | පත්‍රාහනය
phylloid=පත්‍රාකාරය | පිලොයිඩය
phyllome=පිලෝමය
phyllomorphic=පත්‍රරූපී
phyllomorphy=පත්‍රාහනය
phyllotactic=පත්‍රවින්‍යාසක
phyllotaxis=පත්‍රවින්‍යාසය
phyllotaxy=පත්‍රවින්‍යාසය
phylloxanthin=සැන්තොපිල්
phylloxera=මිදිකොළ රෝගය
phylogenesis=වංශ ජනනය
phylogenetic=වංශප්‍රවේණික
phylogeny=වංශ ප්‍රවේණිය | වංශප්‍රවේණිය
phylum=වංශය
physic=ඖෂධය | චිකිත්සා ශාස්ත්‍රය | සුදුකරය
physical=ඉන්ද්‍රියගෝචර | කායික | ද්‍රව්‍යමය | ද්‍රව්‍යාත්මක | බාහිර | භෞතික | භෞතීය | මහා භූතයන් පිළිබඳ | ශාරීරික
physicalism=භෞතියවාදය
physically=කයින් | භෞතික වශයෙන් | ශරීරශක්තියෙන්
physician=තිකිච්ඡක | භෞතවෛද්‍යු | චිකිත්සකයා | වෙද | වෛද්‍යාචාර්ය | වෛද්‍ය | වෛද්‍යයා | වෛද්‍යවරයා
physicist=භෞතික විද්‍යාඥයා | භෞතිකඥයා
physico-chemical=හෞතරසායනික
physicochemical=භෞතරසායනික
physicosocial=භෞතික සාමාක
physics=ද්‍රව්‍ය ධර්ම ශාස්ත්‍රය | භෞතික විද්‍යාව | භෞතිකය | භෞතිකවිද්‍යාව
physiochemical=භෞතික රසායනික
physiocrats=පිසියෝක්‍රැට් නිකායිකයෝ
physiognomist=දේහ ලක්ෂණ බලා ශාස්ත්‍ර කියන්නා
physiognomy=දේහ ලක්ෂණ විද්‍යාව | පෙනුම | මුඛලක්ෂණ විද්‍යාව | මුහුණුවර | මුහුණෙහි ලක්ෂණ
physiographic=භූ රූපණ
physiography=පෘථිවි විස්තරය | භූ රූප විද්‍යාව | භූ රූපණ විද්‍යාව | භූ රූපණය
physiological=කායකර්ම | කායික | කායික විද්‍යාමය | භෞතවේදීය
physiologist=කායික විද්‍යාඥයා
physiology=කායකර්මය | කායික විද්‍යාව | භෞතවේදය
physiotherapy=කායික වකිත්සාව | භෞතචික්තිසාව
physique=දේහය | දේහලක්ෂණය | රූපකාය | ශරීර ශක්තිය | ශරීරය
physopsis=පිසොප්සිස්
physostigmine=පිසොස්ටිග්මින්
phytin=පයිටින්
phyto-geography=ශාක භූගෝල විද්‍යාව
phytobenthon=නිතලශාක
phytobiology=ශාක විද්‍යාව
phytochemistry=ශාක රසායන විද්‍යාව
phytocoenose=ශාකසීනෝසය
phytoedaphon=පාංශු ක්ෂුද්‍රශාක
phytoflagellates=කශිකාධර ශාක
phytogeography=ශාකභූගෝල විද්‍යාව
phytography=ශකලේඛනය
phytohaematin=පයිටොහීමටින්
phytohormone=ශාකහෝර්මෝනය
phytol=පයිටෝල්
phytologist=ශාක විද්‍යාඥයා
phytology=ශාක විද්‍යාව | ශාකවිද්‍යාව
phytometer=ශාකමානය
phytomorphosis=ශාකරූපනය
phytopalaeontologist=පුරෝද්භිදවිද්‍යාඥයා
phytopathology=ශාක ව්‍යාධි විද්‍යාව
phytophagous=ශාකභක්ෂ
phytophenology=ශාකර්තු විද්‍යාව
phytoplankton=ශාක ප්ලවාංග
phytosterol=පයිටොස්ටෙරොල්
phytoteratology=ශාකවිරූප විද්‍යාව
phytotron=පයිටොට්‍රෝනය
pi=ග්‍රීක හෝඩියේ දහසයවෙනි අකුර | පයි
pi-meson=පයෝනය | පීමෙසෝනය
pianissimo=ඉතා හීන් හන් | මෘදුස්වන ඛණ්ඩය
pianist=පියානා වාදකයා
piano=පියානාව | හීන් හන්
pianoforte=පියානාව
pianola=පියානා වර්ගයක්
piazza=ඉදිරියෙහි දිග ඉස්තෝප්පු ඇති සාප්පු පෙළ | ගොඩනැඟිලිවලින් වට වූ චතුරශ්‍ර වීථිය
pibroch=යුධහමුදා තූර්යසංගීතය
picador=අශ්වයකු පිට නැඟී කුළු ගොනකු සමඟ සටන් කරන්නා
picaresque=චෞරාඛ්‍යානය | ධර්තයන් හා හොරුන් පිළිබඳ
picayune=කුඩා කාසියක්
piccalilli=අච්චාරුවක්
piccaninny=කුඩා නීග්‍රෝ දරුවා
piccolo=කුඩා නළාව
pick=අවුළනවා | ඇහිඳගත් දේ | ඇහිඳගන්නවා | ඇහිඳිනවා | ඇහිඳීම | ඉතා වැදගත් කොටස | ගල්කටුව | තෝරාගන්නවා | නෙලනවා | නෙළනවා | වැරදි හොයනවා | හාරනවා | හොරෙන් ගන්නවා
pick-a-back=කරපින්නාගෙන
pick-axe=ගල් කටුව
pick-lock=අගුළු හොරා
pick-me-up=රසායන බෙහෙත
pick-pocket=ගැටකපන්නා
pick-pocketeer=ගැටකපන්නා
pick-up=අහුළුව | ඇහිළුම
pickard=ගල්කටුව
pickaxe=කුන්තානිය | ගල්කටුව
picker=ඇහුළුම් කූර | කෙක්ක | බුහු කැටය | බුහුකැටය
picker-out=ඇහුළුම් කූර
picket=උල | කූඤ්ඤය | කොටු කරනවා | දිගේලි කරනවා | මුර කණ්ඩායම | මුරපොළ | මුරහිටවනවා
picketing=අවහිර කිරිම | අවහිර කිරීම | දොර වාඩි ලෑම | ප්‍රතිබාභය | පිකට් කිරීම | පිකටිං කිරීම
picking=මල සේදීම | ලෝහ දෝවනය
picking-out=ඇහිලීම
pickings=ඇහිඳගත් දේ | සුළු සුළු ලාබ
pickle=අච්චාරු | අච්චාරු දමනවා | අමාරුව | අවුල | තක්කඩියා | ලුණුවතුර | විනාකිරි
pickles=අච්චාරු
pickling=ඇඹිලීම | රස ශෝධනය | රසශෝධනය
pickpocket=ගැට කපන්නා
picks=හරස් නූල්
picky=කරදරකාර
picnic=සෙල්ලම් ගමනක යෙදෙනවා
picnidium=පික්නීඩිය
pico=පිකෝ
pico-farad=පිකෝපැරඩය
picot=රේන්දවල අගට යොදන විවරයක් ඇති ගැටය
picroerythrin=පික්‍රොඑරීත්‍රින්
picrotoxin=පික්‍රොටොක්සින්
pict=උතුරු බ්‍රිතාන්‍යයේ ආදි මිනිසා
pictogram=චිත්‍රාක්ෂරය | සිතිලිය
pictograph=චිත්‍ර ආශ්‍රිත ලිඛිතය | චිත්‍ර ප්‍රස්තාරය
pictography=රූප රේඛණය
pictorial=පින්තූර පිළිබඳ වූ | පින්තූර මඟින් දක්වන | චිත්‍රවලින් සැරසූ පත්‍රය | චිත්‍රවලින් සැරසූ සඟරාව | චිත්‍රාත්මක | සච්ත්‍රකය
picture=ආදර්ශය | ඉතා ලක්ෂණ තැනැත්තා | ඉතා ලක්ෂණ තැනැත්තී | ඡායාරූපය | පින්තූර | පින්තූරය | මනැසට ඉදිරිපත් කරනවා | මූර්තිය | රූපය | චිත්‍රපටිය | චිත්‍රය | විස්තර කරනවා | විස්තරය | සිතියම | සිතියම් කොට දක්වනවා | සිතෙහි ඇඳගන්නවා
picture-gallery=චිත්‍ර මණ්ඩපය
picture-hat=ස්ත්‍රීන්ගේ ලොකු ගැටියක් ඇති තොප්පිය
picture-house=සිනමා ශාලාව
picture-postcard=එක පැත්තක පින්තූරයක් ඇති තැපැල් පත
picture-writing=අකුරු වෙනුවට රූප යොදා ලිවීම
pictured=චිත්‍රිත
picturesque=ඉතා ශෝභන | දර්ශනීය | දැකුම්කලු | චිත්‍රසදෘශ්‍ය | චිත්‍රාකාර | වර්ණවිභූෂිත | විසිතුරු
picturization=චත්‍රීකරණය
piddle=යමක් සුළුකොට තකනවා
piddling=නොවැදගත්
pidgin=පින්
pie=පක්ෂිවර්ගයක්
piebald=ගෝමර ඇති | පාඩ | පුල්ලි ඇති
piece=ආලෝපය | කජු | කඩ | කණ්ඩය | කාලතුවක්කුව | කාසිය | කැබැල්ල | කැබෙල්ල | කෑල්ල | කොටස | ඛණ්ඩ | තැනැත්තී | පිඩ | පියලි | බඩුව | රොද
piece-goods=නියමිත ප්‍රමාණවලට තනනු ලබන රෙදිපිළී | ප්‍රමාණවලට තනනු ලබන රෙදිපිළී ආදිය
piece-meal=ටික ටික
piece-work=කැබලි වැඩ
piecework=කෑලි ගණනේ වැඩ
pied=පුල්ලි වැටුණු
pied-a-terre=අවශ්‍ය වේලාවට ගැනීමට සූදානම් කර ඇති තාවකාලික ස්ථානය
piedmont=ගිරිපාද
pien=හනකදාර අපෝහනය
pier=කණුව | ජැටිය | පිය | මඟී පාලම | මුහුදු ප්‍රාකාරය | රේගුව
pierce=කාවදිනවා | කුත්තු කරනවා | පසාරු කරනවා | පීඩා කරනවා | බිඳගෙන යනවා | විදිනවා | විනිවිද යනවා | සිදුරු කරනවා | හිල් කරනවා
piercer=සිදුරුකරය
piercing=ඇනුම්පද සහිත | තීක්ෂ්ණ | මහ හන් යුත් | විදමන | විදුම | විනිවිද යන
pierrot=කෝනංගියා | පියරෝව | පියරෝවා
pieta=මරියතුමියගේ පින්තූරය | වලප්නාව
pietism=ධර්මශීලවාදය | සුශීලවාදය | සුහද බව
piety=ධර්ම ශිලතාව | ධර්මිෂ්ඨභාවය | භක්තිය | ශ්‍රද්ධා | ශ්‍රද්ධාව | ශ්‍රද්ධාව | සද්ධා | සුසිල්වත් බව | සුසීලතාව
piezochemistry=පීඩ රසායන විද්‍යාව
piezocrystallization=පීඩ ස්ඵටිකීකරණය
piezoelectricity=පිඩවිද්‍යුතය | පීඩ විද්‍යුතය
piezoelectron=පීඩ ඉලෙක්ට්‍රෝනය
piezometer=පීඩනාමානය | පීඩමානය | පීඩ්‍යතාමානය
piezomicrophone=පීඩමයික්‍රොපෝනය
piffle=ඉතා සුළු | නොවැදගත් | පච
pig=අධමයා | ඊරි | ඌරා | කෑදරයා | පිණ්ඩය | වරාහ | ශූකරයා | සූකරයා | හූරා | හූරු | හොටබරියා
pigeon=කලරැව් | පරවියා | පරෙයියා | පරෙවියා
pigeon-breasted=පරෙවියාගේ මෙන් උස් ළය ඇති
pigeon-hearted=බියසුලු
pigeonhole=කල් දමනවා | කුඩා කූඩුව
piggery=ඌරුමඩුව
piggish=ඉතා අපිරිසුදු | ඌරකු වැනි
piggy=කුඩා ඌරුපැටියා
piggy-back=කර උඩ තබාගෙන
piglet=කුඩා ඌරුපැටියා
pigment=පාට ද්‍රව්‍යය | රංගය | වර්ණකය | සායම
pigmentation=වර්ණකය | වර්ණීකරණය | වර්ණීභවනය | සිවියෙහි පාට
pigmy=අඟුටුමිට්ටා | ඉතා කුඩා | ඉතා සුළු | කුරු මිනිහා | පිග්මි | මිට්ටා | වාමනයා
pignus=පිග්නුසය | බඩු උකස
pigon=කපෝත
pigskin=ඌරාගේ හම
pigswill=ඌරන්ට දෙන මද්‍යසාර කොටස්
pigtail=හූරුවලග
pike=උල් කුළ | කට්ට | කුන්තය | ගඟේ මාලු වර්ගයක් | පාරේ රේන්දපොළේ කඩුල්ල | හෙල්ලය
piked=උල්වූ
pikestaff=උල්මිට
pilaff=මස් එළවළු මාළු සහිත බත්
pilaster=නෙරි කුළුණ | සතරැස් කුලුන
pilau=භෝජනයක්
pilaw=භෝජනයක්
pilchard=කුඩා මුහුදු මාලුවෙක්
pile=අට්ටිය | අමු යකඩ මිටිය | අසුරනවා | කුලුන | ගොඩ | ජම්බාරය | ටැඹ | ධන රාශිය | පුංජය | රාශිය | විශාල ගොඩනැඟිල්ල | සිහින් ලෝම
pile-driver=ජම්බාරය
pileate=සඡත්‍ර
pileiform=ඡත්‍රාකාර
pileola=ඡත්‍රිකාව
piles=අර්ශස් | මූලග්ගාය | මූලගාය | මූලරෝගය
pileus=ඡත්‍රය
pilfer=සුළු හොරකම් කරනවා
pilferage=සුළු හොරකම් කිරීම
pilgrim=වන්දනාකරු | වන්දනාකාරයා
pilgrimage=වන්දනා ගමන | වන්දනාව
piliform=රෝමාකාර
piling=මිටි බැඳීම
pill=ගුලිය | ගුළිකා | ගුළිය | පෙත්ත | බෙහෙත් ගුළිය | වර්තිකාව
pillage=කොල්ලකනවා | කොල්ලය | කොල්ලා කනවා | බලෙන් පැහැරගන්නවා | මංකොල්ලය
pillar=ආධාර කාරයා | උපකාරකයා | කණුව | කප | කම්බ | කුඹය | කුලුන | කුළුණ | ටඹ | ටැඹ | ථම්භ | යූපය | ස්තම්භ | ස්ථම්භය
pillion=මෝටර්සයිකලයේ පසුපස ආසනය
pillory=දඬු කඳ | දඬු කඳේ ගසනවා | දඬු රාමුවේ දමනවා | දඬුකඳ
pillow=කන්වයින | කොට්ටය | කොට්ටය වැනි දේ | බරු දරණුව,හාන්සි වෙනවා
pillow-case=කොට්ට උරය
pillow-fight=කොට්ට පොරය
pillow-slip=කොට්ට උරය
pilocarpine=පයිලොකාපින්
pilose=රෝමවත්
pilot=අහස්‍යාත්‍රාව පදවන්නා | ගුවන් නැවියා | ගුවන් නියමුවා | ජයබිම කරා ගෙනයනවා | නියමු | නියමුව | නියමුවා | නියාමකයා | පදවනවා | මඟ පෙන්වනවා | මාර්ගදර්ශකයා | මෙහෙයවනවා
pilotage=නියමුවා
pilous=රෝමවත්
pilule=කුඩා ගුළිය
pimento=කොච්චි වැනි මිරිස් කරලක්
pimp=අලුකුත්තේරුවා | කුට්ටානිය | ගණිකා තැරැව්කාරයා | පිම්පියා | වේශ්‍යා ස්ත්‍රීන් සපයනවා | වේශ්‍යා ස්ත්‍රීන් සපයන්නා
pimpernel=සදාහරිත ශාකයක්
pimple=කුරුලෑ | කුරුලෑව | බිබිල
pimply=කුරුලෑ සහිත
pin=අල්පෙනෙත්ත | අල්පෙනෙත්ති ගහනවා | අල්පෙනෙත්තිය | ඇණය | කුර | කූර | ගසා අමුණනවා | පයින්ටුව | හිර ඇණය
pin-hole=සූව සිදුර
pin-valve=කුඩු කපාටය
pin-vice=අත් දඩුඅඩුව
pinafore=උඩ වැස්ම
pince-nez=නාසික උපැස
pincers=අජුව | ඩැහි අඬුව
pinch=අසුර | කෙනිත්තීම | කොනහනවා | කොනිත්තනවා | ටික | ඩිංග | මසුරුකම් කරනවා | මිරිකීම | රිදවනවා | රිදෙනවා | ලවය | හිඟය | හිරබාරයට ගන්නවා | හොරෙන් ගන්නවා
pinchaetium=පරිවේෂ්ඨකය
pinchbeck=තඹක්ක | රැවටිලි සහිත | හොර
pine=අන්නාසි | ක්ෂය වෙනවා | දුකින් පසු වෙනවා | සරල වෘක්ෂය
pine-apple=අන්නාසි
pineal=කේතු
pineapple=අන්නාසි | අන්නාසි ගෙඩිය
pinecone=පයින් ගසේ ගෙඩි
pineery=අන්නාසි කොටුව
ping=රිදී හඬ
ping-pong=මේස පන්දු ක්‍රීඩාව
pingo=කද
pingo-bearer=කත්කාරයා
pinion=අවරෝදය | කුඩා දැති රෝදය | දැව රෝදය | දවරෝදය | පියාපත් බඳිනවා | හිරප්පාඩු කරනවා
pink=ඉතා උසස් තත්ත්වය | පළොල් | පළොල් පැහැය | පාටල වර්ණය | මඳක් රතු වූ | මෝටර් යන්ත්‍රය ගැස්සි ගැස්සී ක්‍රියා කරනවා | රෝස
pinkie=සුළැඟිල්ල
pinking=සිලි සිලි හඬ
pinna=කන්පෙත්ත | ගරුතය | පක්ෂකය
pinnace=කුඩා බෝට්ටුව
pinnacle=කොත | මුදුන | ශිඛාව
pinnate=දෙපැත්තෙහි පිහාටු ඇති | පක්ෂවත්
pinnatifid=මිතපක්ෂ
pinnatilobate=පක්ෂවත් ව බෙදුණු
pinnatipartite=අර්ධපක්ෂ
pinnatisect=පක්ෂච්ඡේද
pinned=කූරු ලූ
pinning=ඇමිණීම | කිරීම | කුඩු පිරීම
pinnule=අනුපක්ෂකයා
pinny=ආරක්ෂාවට අඳින ළය වැස්ම | කුඩු පිරි
pinpoint=ඉතා සියුම් ඉලක්කය
pinprick=සුළු හිරිහැරය
pint=පනිට්ටුව | පයින්ටය | බෙලෙක් බාල්දිය | මනාව
pintail=හබන්කුකුළා
pintle=පින්ටලය | යම් යම් කොටස් කරකැවෙන තුඩ | යම් යම් කොටස් කරකැවෙන බදැණය
pinx=නිර්මාතෘ | නිර්මාපක
pinxit=නිර්මාතෘ | නිර්මාපක
pion=පයෝනය
pioneer=ආදි කර්තෘ | පුරෝගාමි | පුරෝගාමියා | මාර්ගදර්ශකයා
pioneering=පුරෝගාමී
pioner=මූලිකයා
pious=ගුණවත් | ධාර්මික | බැතිමත් | භක්තිමත් | ශ්‍රද්ධාවත් | ශ්‍රද්ධාවන්ත | සද්ධාවන්ත | සැදැහැති | සුසිල්වත් | සොඳ
pip=තරහව | තිත | දොම්නස | නූලෙන් පරදවනවා | පිප් | පුල්ලිය
pip-pip-pip-signal=පිප් හඬ
pip-squeak=අවශේෂ පුද්ගලයා
pipe=ගෙල | දුම්කෝව | නල | නලාව | නළය | නළා පිඹිනවා | නළාව | නාලය | නාළය | පයිප්පය | බට | බටය | හීන් හඬ නඟනවා
pipe-clay=කිරි මැටි | පයිප්ප මැටි | මකුළු
pipe-cutter=නළ කපනය
pipe-line=නළ මඟ
pipe-threader=නළ පොට කපනය
pipeclay=පයිප්ප මැට්ට | පයිප්ප මැටි
pipeline=නල මඟ | නළමාර්ගය
pipelines=නළ මාර්ග
piper=නළාකාරයා
pipette=කුඩා නළය | පිපෙට්ටුව
piping=ඉතා උණුසුම් | වළ ගැසීම
piping-hot=ඉතා උණුසුම්
pipit=කුඩා කුරුලු වර්ගයක්
pippin=ඇපල් වර්ගයක්
pips=පිප්
piquancy=තියුණු බව | මනෝහරභාවය | සැරකම
piquant=කට හාරවන | කටුක | සැර | සිත්ගන්නා
pique=කේන්ති කරනවා | කේන්තිය | තරහ අවුස්සනවා | දළ රෙදි වර්ගයක් | පොළඹනවා | මඳ තරහ
piracy=ගංගා විලෝපය | ප්‍රකාශන හොරකම් | මුහුද කොල්ලය | මුහුදු කොල්ලය | මුහුදු කොල්ලාකෑම | ලුංටනය
pirana=පීරානා නම් මත්ස්‍යයා
pirate=ග්‍රන්ථචෞරයා | මුහුදු කොල්ලකාරයා | මුහුදු කොල්ලාකරු
pirit=පරිත්‍රාණ
pirivena=පරිවේණ
pirn=හැඩකූර
pirouette=චක්‍රනෘත්‍යය | පයේ ඇඟිලිවලින් කරකැවෙනවා | බමර වළල්ල | භ්‍රමණ නර්තනය
piscary=අන්‍යයකුගේ ජලයක මාළු ඇල්ලීමේ අයිතිය | මසුන් මරන අයිතිය
piscatorial=මසුන් මැරීම පිළිබඳ
pisces=මීන | මීන රාශිය
pisciculture=කෘත්‍රිම ලෙස මාලු බෝකිරීම
pisciform=මීනාකාර
piscina=දේවස්ථානයේ අල්තාරය අසල තබා ඇති ගල් බේසම
pisgah=අනාගතය දැක්කහැකි අවස්ථාව
piss=මූත්‍ර
pistachio=ගෙඩි විශේෂයක්
piste=ක්‍රීඩාව සඳහා සෑදු හිමබිම
pistia=පිස්ටියා
pistil=ජායාංගය
pistillary=ජායාංගී
pistillate=ජායාංගී
pistillode=ජායාංගාහය
pistillody=ජායාංගාභතාව
pistol=කොට අත්තුවක්කුව | පිස්තෝලය
pistology=භක්තිවේදය
piston=පිස්ටනය
pit=ආවාටය | කූපය | කූව | ද්‍රව්‍ය වෙළෙඳ පොළ | නරාවළ | පතලය | පතහ | ප්‍රේක්ෂාවාටය | රංගාංගනය | වල | වළ | වළක දමනවා | වළක් සාදනවා | වළක් සෑදෙනවා | වාත්තු වළ | හිල | හිලක් සාදනවා | හිලක් සෑදෙනවා
pit-(a)-pat=ගැහි ගැහී | මහත් වේගයෙන්
pit-fall=බොරුවළ
pita=ග්‍රීසියේ හා මැදපෙරදිග සාදනු ලබන පාන් විශේෂයක්
pitch=අන්තරාලය | අන්තරාලයය | ආදෝලනය | ඉස්කුරුප්පුවේ | උස් පහත් ප්‍රමාණය | කඳවුරු බඳිනවා | ගල් තාර | ගල්තාර | තාරතාව | වීසි කරනවා | වීසි කිරීම | සංගීතයේ | ස්වරමානය
pitch-black=ඉතා කළු
pitch-darkness=කට්ට කළුවර
pitched=කීල් ගානලද
pitched-battle=සූදානම් වූ සටන
pitcher=ඇතුරුම් ගල | කලය | කළගෙඩිය | කළය | කුණ්ඩිකාව | කෙණ්ඩිය | කොතළය
pitcher-plant=බාඳුරාවැල
pitchfork=මිට දිග මුල්ලුව
pitching=අතුළුව | පාදම සිටුවීම
pitchometer=අන්තරාලයමානය
piteous=අනුකම්පා උපදවන | කනගාටුදායක | දුහ්ඛිත
pitfall=උගුල | උපද්‍රවය | ගිනිගෙඩිය | බොරු වළ
pith=ඉරිමදය | ඉරුමදය | බඩය | බලය | මජ්ජාව | මණ්ඩය | මදුල | වීර්යය | සාරය | සාරාංශය | හරය
pithead=පතලයට ඇතුල්වන තැන | පතල් මිදුල
pithecanthropus=පිතෙකැන්ත්‍රොපුස්
pithecoid=වානරාභ
pithiatism=ප්‍රරෝචන ප්‍රතිකාරය
pithily=සාරවත්ව
pithox=පිතොස් බුජම
pithy=බලගතු | සංක්ෂිප්ත | සාරවත්
pitiable=අනුකම්පා උපදවන | කනගාටුදායක | දුහ්ඛිත
pitiful=අනුකම්පා සහිත | කාලකණ්ණි | දුක්ඛදායක | බැගෑපත්
pitifully=අතිශයින් | ඉතා නරක ලෙස
pitiless=අකාරුණ්‍ය | අනුකම්පාරහිත | ක්‍රෑර
pitocin=පිටෝසින්
piton=කූඤ්ඤය
pitressin=පිට්‍රෙසින්
pittance=ඉතා සුළු ආදායම | ඉතා සුළු වැටුප
pitted=වළ ගැසූ | සාවාට
pitting=වළ ගැසීම
pituitary=පිටියුටරි ග්‍රන්ථිය
pituitin=පිටියුටින්
pituitrin=පිටියුට්‍රින්
pity=අනුකම්පා කරනවා | අනුකම්පාව | අනේ | කනගාටුවට කාරණය | කරුණාව | කාරුණ්‍යය | චහ් | දයාව
pivot=අවලම්බය | කේන්ද්‍රය | ගුළු ඇණය | ගුළු ඇණය වටා කැරකෙනවා | භ්‍රමණකේන්ද්‍රය | විවටුව | විවර්තනිය
pivotal=අවශ්‍ය | ප්‍රධාන
pivoted=විවර්තනී කළ | විවැටූ
pivoting=විවර්තන කිරීම
pixy=භූතයා
pizza=ඉතාලියානු ආහාර විශේෂයක්
pizzicato=වයලීනයේ තත් අතිත් පිරිමැදීමෙන්
placaat=පලක්කාට්ටුව
placable=සමා කරවාගත හැකි
placard=දැන්වීම් පත්‍ර අලවනවා | දැන්වීම් පුවරුව | පලක්කට්ටුව | පළපත
placate=කෝපය සමනය කරනවා | විරෝධය මඟහරවා ගන්නවා | සතුටුකරවා ගන්නවා | සමාම් කිරීම
place=අටවනවා | ඉඩම | ගාධ | තත්ත්වය | තනතුර | තබනවා | තැත | තැන | තියනවා | තෙන | දක්වනවා | දමනවා | දේශය | නියම කරනවා | නිලය | පදිංචිය | පළ | පිහිටුවනවා | පෙදෙස | පොළ | බහනවා | රක්ෂාව | ලනවා | සංස්ථානය | ස්ථාන | ස්ථානය | සිටුවනවා | හොවනවා
placebo=ඖෂධයක් ලෙස ප්‍රබල නොවූ ප්‍රතිකාරය
placeman=ආණ්ඩුවේ තනතුරු ලැබූ තැනැත්තා
placement=පත්කිරීම | පත්වීම | රක්ෂාව | ස්ථාපනය
placenta=අපරාව | කලබන්ධය | ඩිම්බබන්ධය | බන්ධය | බීජබන්ධනය | වැදැමහ
placentation=ඩිම්බන්‍යාසය
placer=අගම් නිධිය | ලෝවැලි | වැලිනිධිය
placid=ඉක්මනින් කලබල නොවෙන | නිශ්චල | ශාන්ත | සන්සුන් | සෞම්‍ය
placidity=තැන්පත්කම | සන්සුන්කම
placidness=ශාන්තබව
placing=ආරෝපණය | තැබීම | දැමීම | ස්ථාපනය
placket=කාන්තා සායෙහි ඇති විවරය
platform=මැස්ස | වේදිකාව
plagiarism=රචනා චෞරත්වය | රචනා චෞර්යයා | රචනා සොරකම
plagiarist=කුකවියා | රචනස්තේනයා | රචනා චෞරයා | රචනා සොරා
plagiarize=රචනා සොරකම් කරනවා
plagiogeotropism=තිරෝගුරුත්වාවර්තනය
plagiotropic=තිරෝවර්තී
plagiotropism=තිරෝවර්තනය
plague=නිතර නිතර හිරිහැර වෙනවා | මහත් හිරිහැරය | මහමාරිය | මහාමාරිය | ලෙල්ලම | වසංගතය
plaguy=කලබල සහිත | හිරිහැර සහිත
plaice=පැතලි මාලුවෙක්
plaid=දිග සළුව
plain=අලංකාරයක් නැති | අවංක | අවලක්ෂණ | අවහිරයක් නැති | අවිශිෂ්ට | චාම් | තලව්ව | තලාව | තැන්න | තැනි | තැනිතලා | තැනිතලාව | නොවළහා | පතන | ප්‍රස්තරය | පැතලි | පැහැදිලි | පැහැදිලි ලෙස | මුහුදු තැන්න | සමතල | සමතලා | සරල | සාමාන්‍ය
plain-spoken=අව්‍යාජව කථා කරන
plainsong=සරල රිද්මයක් ඇති ගීතිකාව
plaint=පැමිණිල්ල | පැමිණිලිපත | ලතෝනිය
plaintiff=පැමිණිලිකරු | පැමිණිලිකාරයා
plaintive=දුක්මුසු | විලාප සහිත
plait=ගෙතුම | ගොතනවා | වෙණියක් මෙන් සාදනවා
plaited=පට වැටුණු
plan=අදහස | අදහස් කරනවා | උපක්‍රමය | උපාය | උපාය යොදනවා | කලින් සකස් කරනවා | ක්‍රමය | පඩිමාකඩ | පඩිමාව | ප්ලෑන | පිඹුර | පිඹුර සැලැස්ම | පිඹුරු පත | පිඹුරුපත | බලාපොරොත්තු වන ක්‍රියාමාර්ගය | බිම් සටහන | මෝස්තරය | සැලසුම | සැලැස්ම | සැළැස්ම | සිතියම
planation=තලනය | පැතැලි කිරීම
planchette=ප්ලැංචෙට්ටුව
plane=ග්‍රහයා | තල | තලය | තලාව | ධරාතලය | යත | යත්ත | යතු කැටය | යතු ගානවා | යතුකැටය | යතුගානවා | සමක්ෂේත්‍රය | සමතලය | සමතලා
planer=ගාන යත්කරු | මං මටකුරුව | මට්ටම් ලෑල්ල | යත්ත
planes=තල
planet=ග්‍රහතාරකාව | ග්‍රහයා | ගිරහ
planetarium=ග්‍රහ ලෝකාගාරය | ග්‍රහමණ්ඩල ආදර්ශය | ග්‍රහලෝකාගාරය
planetary=ග්‍රහ | ග්‍රහතාරකා පිළිබඳ
planetoid=ග්‍රහකයා | ග්‍රහාභය
plangent=දුක්බර | බැගෑපත්
plani-sphere=තලගෝලය
planimeter=තල මානය | තලමානය
planimetry=තලමිතිය
planing=ගෑම | මට්ටම් ගෑම | යතු ගෑම | යතුගෑම
planish=මට්ටම් තලනවා | මට්ටම් තළනවා
planishing=මට්ටම් තැලීම | මට්ටම්තැලීම
planisphere=තලගෝලය
plank=පුවරුව | පෝරුව | ඵලකය | ලෑල්ල | ලෑලි ගහනවා
planking=ඝන ලෑලි දැමීම
plankton=ජලයෙහි පාවෙන ශාක විත | ජලයෙහි පාවෙන සත්ව විත | ප්ලවාංග | ප්ලාවංග | ප්ලැන්ක්ටන්
planned=ප්‍රකල්පිත
planner=සැළසුම්කරු
planning=ක්‍රම සම්පාදනය | ක්‍රමසම්පාදනය | යතු ගෑම | සංවිධානය | සැලසුම් කිරීම | සැලසුම්කරණය | සැලැසුම් කරණය
plano-convex=තල උත්තල
planocaine=ප්ලැනොකෙයින්
planogamete=චලජන්මාණුව
planometer=මට්ටම් තැටිය
planorbis=ප්ලැනෝර්බිස්
planospore=චලබීජාණුව
plant=ඉන්දනවා | පදිංචි කරවනවා | පැල | පැලය | පැළ කරනවා | පැළය | පැළෑටිය | පිරියත | පිහිටුවනවා | යන්ත්‍රෝපකරණ | රෝපණය කරනවා | වගා කරනවා | වවනවා | ශාක | ශාකය | සිටුවනවා | හිටවනවා | හිටුවනවා
plantain=කෙසෙල් | කෙහෙල් | රම්බා | රම්හා | රඹ
plantatio=වගා අයිති
plantation=උපනිවේශය | වගාව | වත්ත | වැවිල්ල | වැවිලි
planter=රෝපක | වතුකාරයා | වැවිලි කාරයා | වැවිලිකරු | වැවුණු
planteris=පාදුකය
planting=රෝපණ | රෝපණය
plaque=අලංකෘත ඵලකය | ඵලකය
plaquette=ඵලිකාව
plash=ඉහිරුණු වතුර | දිය ඉහිනවා | මඩ වතුර
plashing=මාවර ඇල්ලීම | මාවරය
plasm=ප්ලාස්මය
plasma=ප්ලාස්මය | ප්ලාස්මාව | ප්ලැස්මය | රුධිර ප්ලාස්මාව | රුධිර රසය | ලේවල ද්‍රව කොටස
plasmagene=ප්ලාස්මජානය
plasmalemma=ප්ලාස්ම පටලය
plasmamembrane=ප්ලාස්ම පටලය
plasmodesma=ප්ලාස්මබන්ධය
plasmodesmic=ප්ලාස්මබන්ධ
plasmodial=ප්ලාස්මෝය
plasmodium=ප්ලාස්මෝඩිය
plasmogamic=ප්ලාස්මයෝගී
plasmogamy=ප්ලාස්මයෝගය
plasmolysed=විශුන
plasmolysis=ප්ලාස්මච්ඡේදනය | විශුනතාව | විශූන්‍යතාව
plaster=ආලේප කරනවා | කපරාරු කරනවා | කපරාරුව | ඝනලෙස ගානවා | පැලැස්තරය | බදාම | හුණු බදාම
plaster-of-paris=පැරිස් බදාම
plastering=කපරාදුව | කපරාරුව
plastic=කල්ප්‍ය | නිර්මාණය පිළිබඳ වූ | පහසුවෙන් නැමිය හැකි | ප්ලාස්ටික් | මූර්තිධර | මෙළෙක් | වාත්තු කළ හැකි | සුවකාර්ය | සුවිකාර්ය | සූවිකාර්ය
plasticine=ඇඹීමට ගන්නා මැටි
plasticise=මෙළෙක් කරනවා
plasticiser=සුවිකාර්යතාව වැඩි කරන ද්‍රව්‍යය
plasticity=කර්මණ්‍යභාවය | මූර්තිධරරූපිත්වය | සුවකාර්යතාව |  සුවිකාර්යතාව | සූවකාර්යතාව
plasticizer=සුවකාර්යකාරකය | සුවිකාරකය
plastics=ප්ලාස්ටික් | ප්ලාස්ටික් ද්‍රව්‍ය
plastid=ලවය
plastin=ප්ලාස්ටින්
plastochrone=ප්ලාස්ටක්‍රෝනය
plastogamic=ප්ලාස්මයෝගී
plastogamy=ප්ලාස්මයෝගය
plastoid=ප්ලාස්ටොයිඩය
plastometer=ප්ලාස්ටොමීටරය
plastotype=රූපාදර්ශය
plat=හිමිකම් පිඹුර
plate=ආලේප කරනවා | තටුව | තලය | තලිය | තහඩු | තහඩුව | තැටිය | පට්ටකය | පිඟන් | පිඟාන | ඵලකය | මලාව | රන් රිදි ආලේප කරනවා | සරාව
plate-glass=තහඩු වීදුරුව
plateau=උස් සමභූමිය | සානුව
plateglass=ඉතා ඝන වීදුරු
platelayer=මිරිය පීලි යොදන්නා
platelet=පට්ටිකාව | රුධිර පට්ටිකාව
platen=ප්ලැටන | ප්ලැටන් | මුද්‍රණ ශිල්පයේ අකුරු අච්චු ගැස්වෙන තැටිය
plater=තහඩු කැමියා
platform=කථිකාසනය | කරළිය | පිල් | මැස්ස | වේදිකාව
plating=ආලේප කිරීම | ආලේපය | තහඩු කම | ලෝහ ගෑම | ලෝහාලේපනය
platiniferous=ප්ලැටිනීධර
platinize=ප්ලැටිනී කරනවා
platinoid=ප්ලැටිනොයිඩ්
platinum=ප්ලැටිනම් | ප්ලැටිනම් ලෝහය
platitude=නිස්සාර කියමන | වාන්තය | වැදගැම්මකට නැති ප්‍රකාශය
platitudinous=අවිශිෂ්ට | නීරස | වාන්ත
platonic=ක්‍රියාවෙන් කාමුක නොවූ | ප්ලේටෝනික
platonism=ප්ලතෝනිකවාදය | ප්ලේටෝගේ දර්ශනය
platoon=පාබළ හමුදා ඛණ්ඩය
platter=පලංගානම | ලොකු තැටිය
platycarpic=පැතැලිඵල
platycarpous=පැතැලිඵල
platyhelminthes=ප්ලැටිහෙල්මින්ති
platykurtic=වක්‍රිමය | වපිටවක්‍රිම
platykurtosis=වපිටවක්‍රිමය
platypus=ප්ලැටිපස්
plaudit=අත්පොළසන් දීම | ප්‍රනාදය | ප්‍රශංසාව
plausibility=සමර්ථකම
plausible=ව්‍යාජ | සත්‍යරූපී
play=ක්‍රිඩව | ක්‍රියා කරනවා | ක්‍රීඩනය | ක්‍රීඩාව | කෙළනවා | කෙළි | කෙළිය | ගසනවා | දෘශ්‍යකාව්‍යය | නළුව | නාටකය | නාට්‍යය | නිදහස | නූර්තිය | නෘත්‍යය | බුරුල | මතුපිට වැටෙනවා | යන්තමින් පෙනෙනවා | රඟදක්වනවා | රඟදැක්වීම | වයනවා | වැටෙන්ට සලස්වනවා | වැනීම | සූදු කෙළිනවා | සූදුව | සෙලවීම | සෙල්ලම | සෙල්ලම් කරනවා
play-debt=සුදු ණය
play-ground=කෙළිබිම
play-mate=ක්‍රීඩා සහයකයා
play-within-a-play=ගර්භ නාටකය
playa=ප්ලයාව
playa-lake=ප්ලයා විල
playboy=සෙල්ලක්කාරයා
player=ක්‍රීඩකයා | නළුවා | නාට්‍යකරුවා | නිළිය | වාදකයා
playful=සෙල්ලක්කාර
playfulness=හාවභාව
playgoer=නිතර නාට්‍ය බැලීමට යන්නා
playground=ක්‍රීඩා භූමිය | ක්‍රීඩාභූමිය | පොරපිටිය | සෙල්ලම්පිටිය
playhouse=නෘත්‍යශාලාව
playing=වාද්‍යු | වැයීම | වැයුම
playlet=නාටිකාව
plaything=කෙළිබඩුව
playwright=නාටක රචක
plea=අභියාචනය | ආයාචනය | කන්නලව්ව | පැරැත්ත | බේරීමට කියන දේ
pleach=බඩවැටිය වවනවා
plead=අදියදිනවා | අධියාචනය කරනවා | අයදිනවා | ආයාචනය කරනවා | උදක් ඉල්ලනවා | කන්නලව් කරනවා | කරුණු පෙන්වනවා | වගඋත්තර කියනවා
pleader=අදියැදියා | අධියාචකයා | නීතීඥයා
pleading=අදියැදුම | අධියාචනය | ආයාචනය | උත්තරපත | පින්සෙණ්ඩුව
pleasance=ආරාමය | ක්‍රීඩෝද්‍යානය
pleasant=කදිම | කාන්ත | කෝමල | දර්ශනීය | දැකුම්කලු | නන්ද | නන්දන | නන්දනීය | නඳ | ප්‍රසන්න | ප්‍රිය | ප්‍රියංකර | ප්‍රියශීලී | භද්‍ර | මනරඟ | මනෝඥ | රම්‍ය | සිත්කලු | සුන්දර | සොමි
pleasantness=මනෝඥතාව | සොමිගුණය
pleasantry=විහිළු තහළු | හාස්‍යයෙන් පිරි කථාව
please=අනේ | අරියනවා | කරුණාකොට | කැමැති වෙනවා | පැහැදෙනවා | පිනනවා | සතුට ගෙනදෙනවා | සතුටු කරනවා | සතුටු වෙනවා
pleased=තිළී | සන්තෘප්ත
pleasing=කල් | කලු | නඳන | පිය | මනකල් | මනනඳ | මනෝඥ | මෝදක | රංජක | රංජුනය | රුසිනා | විසිත්ත | සුමන
pleasurable=ආනන්දජනක | සතුටුදායක
pleasure=අභිමතය | කැමැත්ත | තිළි | තිළී | පරිතෝෂය | පහටුව | ප්‍රණය | ප්‍රමද | ප්‍රීතිය | මොද | රතිය | සතුට | සතොස | සන්තුෂ්ටිය | සන්තෝෂය | සම්භෝග | සාත | සැපය | සුඛ වේදනාව | සුඛය | සොම්නස | හර්ෂය
pleasure-garden=ආරාමය | ක්‍රීඩෝද්‍යානය
pleat=රැලි | රැලි දමනවා
pleats=පොලොවි
plebeian=පොදු ජනයා
plebian=ග්‍රාම්‍ය | පොදු ජනයාට අයිති | සාමාන්‍ය
plebiscite=ජනමත විචාරණය | ජනමත විමසුම | ජනමත විමැසුම | ජනමතවිචාරය
plectenchyma=ව්‍යාජමෘදුස්තරය
pledge=ඇපය | උකස් තියනවා | ඔඩපන කරනවා | ඔඩපනය | ප්‍රතිඥාව | පොරොන්දු කරවාගන්නවා | පොරොන්දුව | මඩපනය | ඹඩපනය | සහතිකය
pledgee=ඔඩපනලාභියා | ඹඩපනලාභියා
pledgor=ඔඩපනදායකයා | ඹඩපනදායකයා
plegia=ඝාතය
pleiades=හත්දින්න | හත්දින්නන් තරු
pleiads=සප්තර්ෂී
pleiochasial=බහුශාඛ
pleiochasium=බහුශාඛය
pleiomorphous=බහුආකාර
pleiomorphy=බහුආකාරය
plenary=නිශ්ශෙෂ | පූර්ණ | සම්පූර්ණ | සීමාරහිත
plender=ආයාචක
plenepotentiary=පූර්ණාධිකාරී | පූර්ණාධිකාරී රාජ්‍යදූතයා
plenipotentiary=පූර්ණ බල සහිත තානාපතියා
plenish=සපයා දෙනවා
plenitude=උත්කර්ෂය | සම්පූර්ණත්වය
plenteous=බහුල | විපුල
plentiful=බහුල | විපුල | සුභික්ෂ | සුල මුල | සුලබ
plentifully=කට ගොන්නක්
plenty=බහුලබව | බාහුල්‍යය | ඕනෑතරම් | සමෘද්ධිය | හුඟ
plenum=පූරිත | පූරිතය
plenus=පිරුණුව
pleomorphic=බහුරූපී
pleomorphism=බහුරූපතාව
pleonasm=පුනරුක්තදෝෂය | වාග්බාහුල්‍යය
pleophagism=පහුභක්ෂතාව
pleophagous=බහුභක්ෂ
pleophyletic=බහුවංශික
pleroma=පූර්ණත්වය | පූර්ණතාව
plerome=මාධ්‍යජනකය
plesiotype=අනුදර්ශය
plethora=අධිකභාවය | රක්තපිත්ත | රත්පිත | රාශිය
plethysmograph=වීතරේඛය
pleura=ප්ලුරාව | මේඛලාව | වංක්‍රිය
pleurisy=ප්ලුරසිය | පෙනහැල්ලේ ඉදිමුම
pleurocarpous=පාර්ශ්වඵලීන
pleurodynia=චංක්‍රිතෝදය
pleuston=ප්ලවාංග
plexus=ප්‍රතානය
pliability=සුනම්‍යතාව
pliable=කීකරු | පහසුවෙන් නැමෙන
pliancy=සුනම්‍යතාව
pliant=කීකරු | පහසුවෙන් නැමෙන
plica=වලිතය
plicate=පට වැටුණු | වලිත
plicatulate=සූවලිත
pliers=අඬුව | අත් අඬුව | කුඩා අඬුව
plight=අවස්ථාව | තත්ත්වය | බහ දෙනවා
plimsolls=රබර් අඩි යෙදූ කැන්වස් සපත්තු
plinth=කයිරුව | කුලුනෙහි සතරැස් අඩිය | පදනම | ප්‍රතිමාවෙහි සතරැස් අඩිය | පාකඩ | පේකඩ
pliocene=ප්ලයෝසීන
plod=බොහෝ මහන්සියෙන් ඇවිදිනවා | බොහෝ මහන්සියෙන් ඉගෙනගන්නවා
plodder=හෙමිනා
plonk=ලාභ වයින් | විශාල ශබ්දය
plop=යමක් වතුරට වැටෙනවා | යමක් සෙමින් වතුරට වැටෙන හඬ | හදිසියෙන්
plosive=සෂ්ඨජාක්ෂරය
plot=අඳිනවා | උපක්‍රමය | උපා යොදනවා | උපාය මන්ත්‍රණය | කථා වස්තුව | කැබැල්ල | කැබෙල්ල | කුමන්ත්‍රණ කරනවා | කුමන්ත්‍රණය | කොටස් කරනවා | කොටුව | පාත්තිය | පිහිටුවනවා | බිම් කැබැල්ල | බිම් කැබෙල්ල | යටිය | යටිසූත්තරය | ලකුණු කරනවා | ලකුණු කරන්න | වස්තුව
plotinism=ප්ලොටිනියානුවාදය
plotter=කුමන්ත්‍රණ කාරයා | ලකුණු කරනය | ලකුණුකරනය
plotting=පිහිටුවීම | යටිකූට්ටු | ලකුණු කිරීම
plough=නංගල | නගුල | නඟුල | පුලුක් යත්ත | බිම නඟනවා | විභාගයකින් අසමර්ථ කරනවා | සාදනවා | සීර | සීසානවා | හානවා
plough-blade=සීවැල්
plough-handle=නිමුන් මිට
ploughing=සෑම | සී | හෑම
ploughman=හාන තැනැත්තා
ploughshare=නඟුල් දත
plover=න වටුවා
ploy=කූටෝපාය
pluck=උදුරනවා | උපුටනවා | කඩනවා | කඩා ගන්නවා | කඩාලනවා | චීරභාවය | ධෛර්යය | නෙලනවා | පැහැරගන්නවා | විභාගයෙන් අසමර්ථ කරනවා
plucking=කඩතොලු කිරීම
plucky=ධෛර්ය්‍යසම්පන්න | වීර
plug=අඩය | ඇබ ගහනවා | ඇබය | කීලය | තළා ඝනකළ දුම්කොළ | පේනු වද්දනවා | පේනුව | බොහෝ සේ වෙහෙසෙනවා | වෙඩි තබනවා
plum=පලම් | ප්ලම් | පිහාටු පළඳිනවා | වියලි මිදි | විශේෂයෙන් උසස් පදවිය | විශේෂයෙන් වැදගත් දේ
plum-pudding=රසවත් පුඩිම
plumage=පිල්කලබ
plumb=ඊයම් වැඩ කරනවා | එක පාරට | කෙළින් පහතට | ගැඹුර බලනවා | ලඹ කැටය | ලඹය | ලඹයට හරි වූ | සම්පූර්ණයෙන්ම | සෘජු | සෘජුව | හරි කෙළින්
plumb-line=ඔලොඹු | ලඹ නූල
plumbago=මිනිරන් | මිහිරන් | මීරන්
plumbate=ප්ලම්බේට්
plumber=ඊයම් වැඩ කරන්නා | ජල නළ කාර්මිකයා | ජලනල වැඩ කරුවා | නළ කැමියා
plumbing=ඊයම් ගෑම | ජලනල වැඩ | නළ කම | නළකම | ලඹ ඇල්ලීම
plumbless=අගාධ | මැනිය නොහැකි
plumbline=ලම්බරේඛාව | ලඹ ලනුව
plumed=පෙඳි
plummet=බිලියම | ලඹය | වේගයෙන් පහතට වැටනවා
plummy=ප්‍රිය උපදවන | හොඳ
plumose=පෙඳැති
plump=කෙළින් කියන ලද | කෙළින්ම | තර | තර වෙනවා | බරට | මහත | මහත් වෙනවා | සෘජු | හදිසියෙන්
plumpness=ස්ථූලභාවය
plumula=බීජාංකුරය
plumule=බීජාංකුරය
plumy=පිහාටු වැනි
plunder=උදුරනවා | කොල්ලකනවා | කොල්ලකාගත් දේ | කොල්ලකාරයා | කොල්ලකෑම | කොල්ලා කෑම | පහරනවා | පැහැර ගන්නවා | බලෙන් පැහැරගන්නවා
plunderer=කොල්ලකාරයා | මංකොල්ලකාරයා
plundering=විලුම්පනය
plunge=අනතුරට පැනීම | අනිනවා | ඇතුළට වද්දවනවා | ඉදිරියට පනිනවා | ඉදිරියට පැනීම | කිඳනවා | ගිල්වීම | ගිලීම | ණයගැති වෙනවා | නිමග්න කරනවා | නිමග්න වෙනවා | වේගයෙන් ගිල්වනවා | වේගයෙන් ගිලෙනවා | සූදු කෙළිනවා | හදිසියෙන් ගිල්වනවා | හදිසියෙන් ගිලෙනවා
plunger=නිමජ්ජකය
plural=බහු | බහුවචන | බුහු | බොහෝ
pluralism=බහුත්ව වාදය | බහුත්වවාදය | බහුවිධතාව
plurality=අනේකත්වය | බහුත්වය | බහුවිධතාව
pluralize=බහුවාචක කරනවා
pluriccllular=බහුසෛලීය
plurifoliate=බහුපත්‍රී
plurilateral=බහු පාර්ශ්වය
plurilocular=බහුකෝෂ්ඨීක
pluripartite=බහුහින්න
pluripetalous=බහුදල
pluriseptate=බහුආවාර
plurivalent=බහුසංයුජ
plurivalved=බහුකපාට
plurivalvis=බහුකපාට
plurivorous=බහුභක්ෂක
plus=එකතු කළයුතු | එකතු වූ | ධන | වැඩිපුර | සමඟ | සහ
plus-fours=ගොල් ක්‍රීඩා කරන විට අඳින කලිසම
plush=සේද රෙදි වර්ගයක්
plushy=මනහර | සුඛෝපභෝගී
plutocracy=කුවේර තන්ත්‍රය | ධනපතීන්ගේ ආණ්ඩුව
plutocrat=ධනපතියා | ධනයෙන් බලවත් පුද්ගලයා | ධනවතුන්ගේ ආණ්ඩුවේ සාමාකයා
plutocratic=ධනයෙන් ආඩ්‍යවූ
plutonic=අග්නිජ
plutonium=ප්ලූටෝනියම්
pluvial=වර්ෂාව පිළිබඳ වූ | වර්ෂාවෙන් ඇති වූ | වාරුණ
ply=ආස්තරණය | තට්ටු | පට | පටය | වැඩෙහි යෙදෙනවා
plywood=තඩු ලෑලි | තුනී ලෑලි | තුනීලෑල්ල
pneuma=ප්‍රාණය | වායුව
pneumatic=වාතරෝධක | වායව | හුළං පුරවනලද
pneumatics=ප්‍රාණ විද්‍යාව | වායව විද්‍යාව | වායු විද්‍යාව
pneumatogen=නියුමැටොජන්
pneumatology=ප්‍රාණභූත විද්‍යාව | ප්‍රාණවේදය | වායුවේදය
pneumatolysis=වායවච්ඡේදය
pneumatophore=වායුධරය
pneumodynamograph=නියුමොඩයිනමෝග්‍රාපය
pneumograph=වායු රේඛය
pneumokoniosis=නියුමෝකොනියෝසියාව
pneumonectomy=පුප්ඵුස විච්ඡේදනය
pneumonia=නියුමෝනියාව
pneumoperitoneum=සමීරපරිතානය
pneumophonia=වායු ස්වනය
pneumothorax=සමීරඋරස
pneumoventriculography=සමීර තුන්දීරේඛණය
poach=මඳ ගින්නේ තම්බනවා | හොරෙන් දඩයම් කරනවා
poacher=මිගතෙනුවා | හොර දඩයක්කාරයා | හොරෙන් දඩයම් කරන්නා
poaching=මිගතෙනුම | හොර දඩයම
pochade=සටහන් මාත්‍රය
pock=බිබිල
pocket=ගොටුව | පසුම්බිය | පොකැට්ටුව | මඩිස්සලය | සාක්කුව | සාක්කුවට දමනවා | සාක්කුවේ දමාගන්නවා | හොරකම් කරනවා
pocket-battleship=කුඩා යුද්ධනැව
pocket-book=අත්පොත | කුඩා පසුම්බිය
pocket-borough=තරඟයක් නැතිව ඉදිරිපත් විය හැකි ඡන්ද කොට්ඨාසය | නොකඩවා එකම මන්ත්‍රීවරයා තෝරාපත් කරන ඡන්ද කොට්
pocket-expenses=අතින් වියදම් වූ මුදල
pocket-handkerchief=සාක්කු ලේන්සුව
pocket-knife=පොඩි පිහිය
pocket-money=අතේ ඇති සුළු මුදල
pockets=ගැබ්
pod=කරල | කරලෙන් ඇට ගලවනවා
podetiform=පොඩේටියාකාර
podetium=පොඩේටිය
podger=ටොමිය | තැනිලි යතුර | පොජරය
podgy=තරබාරු
podium=කුඩා වේදිකාව | පාදය
podsol=පොඩ්සෝල
podus=පාදය
podzol=පොඩ්සෝල්
poem=කව | කවිය | කාව්‍යය
poening=කපල්ල
poesy=කාව්‍ය ශාස්ත්‍රය
poet=කවිකාරයා | කවියා | කාව්‍ය කාරයා | කිවි | කිවිඳිය | කිවිවරයා
poetaster=කුකවියා
poetess=කිවිඳිය
poetic=කාව්‍යමය | පද්‍යුමය | රසවත් | සාහිත්‍යාත්මක
poetical=කාව්‍යමය | කාව්‍යාත්මක | පද්‍යුමය | රසවත් | සාහිත්‍යාත්මක
poetics=කව්‍යශාස්ත්‍රය | කාව්‍ය ශාස්ත්‍රය
poetry=කවිත්වය | කවිතාව | කාව්‍ය ශාස්ත්‍රය | කාව්‍ය සංග්‍රහය | කාව්‍යය | පද්‍යුය
pogo=කෙළිබඩුවක්
pogrom=වැසියන්ගෙන් පක්ෂයකට වධ බන්ධන පැමිණවීම
poietic=උත්පාදක
poignancy=බලවත් කනගාටුව
poignant=ඛේදජනක | තියුණු | විනිවිද යන | සැර | සිත් කාවදින | හෘදයංගම | හෘදයග්‍රාහී | ළගන්නා
poignard=කුඩා කිරිච්වය
poikilothermic=චලතාප
poinsettia=ගෙවතු ශාකයක්
point=අංකය | අග | අග්‍රය | අභිප්‍රාය | උල | උල් කරනවා | කුළින්න | කොටස | කොන | තැන | තිත | තුඩ | තුඩක් කරනවා | තුඩාව | තුඩුව | දක්වනවා | නියම ස්ථානය | නියමිත මොහොත | ප්‍රධාන කාරණය | පොයින්ට් ප්‍රමාණය | බදාම දමා පුරවනවා | බින්දුව | මං මාරුව | ලක්ෂ්‍ය | ලක්ෂ්‍යය | ලකුණ | විශේෂ බලාපොරොත්තුව | ස්ථානය | සාමර්ථය
point-event=ක්ෂණය
point-scale=ලකුණු පරිමාණය
point-to-point=ලක්ෂ්‍යයෙන් ලක්ෂ්‍යයට | හරි කෙළින්
pointed=උල් | උල් වූ | කෙළින් එල්ල කළ | තියුණු
pointer=දක්වනය | දර්ශකය | දර්ශකයා | නිමිත්ත | සුචකය | සූචකය
pointers=දර්ශක තාරකා
pointillism=පාට තිත්වලින් සායම් කිරීමේ ශාස්ත්‍රය
pointillisme=ලක්ෂ්‍යවාදය
pointing=කුස්තුර වැසීම
pointless=නිෂ්ඵල
points=කරුණු | ගතිගුණ | තැන් | ලකුණු
pointsman=දුම්‍රියේ පීලි මාරුකිරීම බාර තැනැත්තා
poise=අහසෙහි නිශ්චලව සිටිනවා | තැන්පත්කම | පොයිසය | සමවෘත්තිය
poison=ආශීර්විෂ | වස | වස දෙනවා | වසවිස | විෂ | විෂ පොවනවා | විස | විස වද්දනවා | විස වෙනවා | හලාහල
poisoneless=නිර්විෂ
poisoning=වසවීම
poisonous=අනතුරුදායක | ආශීර්විෂ | විෂ ධූමය | විෂ සහිත | විෂකුරු | විෂඝෝර | විසකුරු
poisons=වස
poke=අතින් ඔබනවා | අනිනවා | ඇඟිල්ලෙන් ඔබනවා | ඇනීම | උලකින් ඔබනවා | ඔබා බලනවා | ඔබා බැලීම
poker=උදුන් කූර | කඩදාසි ක්‍රීඩාවක් | යකඩ කූර
poky=ඇහුරුණු | ඉඩකඩ නැති
polar=ධ්‍රැවක | ධ්‍රැවිත | ධ්‍රැවීය | ධෘවය පිළිබඳ වූ | ධෘවයට අයිති
polarimeter=ධ්‍රැවණමානය
polarimetry=ධ්‍රැවණමිතිය
polaris=ධ්‍රැව තරුව | පෝලාරිස්
polarisability=ධ්‍රැවණශීලතාව
polarisable=ධ්‍රැවණශීල
polarisation=ධ්‍රැවණය
polariscope=ධ්‍රැවණේක්ෂය | ධ්‍රැවනේක්ෂය
polariscopy=ධ්‍රැවණමිතිය
polarise=ධ්‍රැවණය කරනවා | ධ්‍රැවණය වෙනවා | ධ්‍රැවීකරණය කරනවා
polariser=ධ්‍රැවකය | ධ්‍රැවණකාරකය
polarising=ධ්‍රැවණ
polarity=ධ්‍රැවත්වය | ධ්‍රැවතාව | ධ්‍රැවීයතාව | පරස්පරතාව
polarizability=ධ්‍රවණශීලතාව
polarizalion=ධ්‍රැවායනය
polarization=දෙකඩ බෙදීම | ධ්‍රැවණය | ධ්‍රැවායනය | ධ්‍රැවීකරණය
polarize=ධ්‍රැවී කරනවා
polarized=ධ්‍රැවායිත | ධ්‍රැවිත
polarizer=ධ්‍රවණකාරකය | ධ්‍රැවකය
polarizing=ධ්‍රැවණ
polarogram=ධ්‍රැවණලේඛය
polaroid=ධ්‍රැවණාහ | පෝලරොයිඩ් | සුළු කාලයක් තුළදී පින්තූර පිටපත් ගතහැකි කැමරාව
polder=පහත් බිම් ප්‍රදේශය | පෝල්ඩරය | පෝල්ඩරය
pole=අහස | ඒ‍රියාකඳ | කණුව | කම්බු | කුඹය | කෝටුව | ගෝලයක දෙකොනින් එකක් | චුම්භක අග්‍රයක් | ධ්‍රැවය | පෝල | පෝලන්තයෙහි වැසියා | පෝලය | බැටරියෙහි දෙකෙළවරින් එකක් | රිට | රිටි | රීට | ලීය | විදුලිය
pole-axe=දඬු පොරොව
pole-end=යටග
pole-jump=රිටකින් තල්ලු කරනවා | රිටි පැනීම
polecat=උගුඩුවා
polemic=ව්‍යක්ත කථාව | වාදය | විවාදය
polemical=ව්‍යක්ත | වාදශීලී | විවාදාත්මක
polemics=විවාදය
poles=ධ්‍රැව
polhode=ධ්‍රැවපථය
police=පොලිස් | පොලිස් භටපිරිස | පොලිසිය | පොලීසිය | මුර යොදනවා
policeman=පොලිස් භටයා | පොලිස්කාරයා | රාජපුරුෂයා
policy=ආණ්ඩුක්‍රමය | උපාය | ඔප්පුව | ක්‍රියාමාර්ගය | ප්‍රතිපත්තිය | ප්‍රතිපදාව | පිළිවෙත
poling=මත් ගෑම | රිටි ලෑම
poliomyelitis=ධූසරමජ්ජාදාහය | පෝලියෝමයිලයිටිස්
polish=ආටෝපය | ඔප දමනවා | ඔප මිශ්‍රණය | ඔපකරනවා | ඔපකරය | ඔපදමනවා | ඔපය | ඔපලනවා | ඔප්නගනවා | ඔප්නැංවුම | පලිප්පු | පාහිනවා | මදිනවා | ලක්ෂණ | ලක්ෂණ කරනවා | ශිෂ්ටාචාරය | සංස්කරණය කරනවා | සභ්‍යත්වය
polishing=ඔප දැමීම | ඔපකරය දැමීම | ඔපදැමීම
polite=ආචාරශීලී | ආචාරසම්පන්න | ශිෂ්ට | සුවිනීත
politelearning=සාහිත්‍යඥානය
politeness=ආචාරසම්පන්නකම
politic=ඥානවන්ත | දූරදර්ශී | ප්‍රඥාගෝචර | ශූර
political=ආණ්ඩුවට අයත් | දේශපාලන | දේශපාලනික
politician=දේශපාලකයා | දේශපාලන කටයුතුවල යෙදෙන්නා | දේශපාලනඥයා
politicise=දේශපාලනයේ නියැලෙනවා
politicization=දේශපාලනීකරණය
politico=දේශපාලකයා | දේශපාලන කටයුතුවල යෙදෙන්නා
politics=දේශපාලන උපාය | දේශපාලන තරඟ | දේශපාලන විද්‍යාව | දේශපාලනය | රාජනීතිය
polity=ආණ්ඩුක්‍රමය | රාජ්‍ය සංස්ථාව
polka=නැටුම් විශේෂයක්
poll=අග්ගිස් කපනවා | ඉහටිය | කෙස් කොටකර කපනවා | ඡන්ද ගැනීම | ඡන්ද දීම | ඡන්ද විමසීම | ඡන්දය දුන් ගණන | ඡන්දය දෙනවා | ඡන්දය පවත්වන තැන | ඡන්දය ලබනවා | ඡන්දය විමසීම
poll-tax=ඇඟ බද්ද | ඇඟබද්ද
pollack=මෝර වර්ගයේ මාලුවෙක්
pollard=අං කොට සතා | කප්පාදු කළ ගහ | පරලු | මුදුන් ගැසු ගහ
pollarding=අතුබෑම | මුදුන් ගැසීම
pollards=පරළු
pollen=පරාග | රේණු | රොන්
pollex=මාපටැඟිල්ල
pollicitation=පොරොන්දු යෝජනාව
pollinate=පරාග පෝෂණය කරනවා | පරාග සංයෝග කරනවා | පරාගනය කරනවා
pollinated=පරාගිත
pollination=පරාග පෝෂණය | පරාගණය | පරාගනය
polling-booth=ඡන්ද මධ්‍යස්ථානය
pollinium=පරාග පිණ්ඩය
pollinodium=පුංධානිය
pollomate=පරාගණය කරනවා
pollster=ජනමත විමසන්නා
pollute=අපවිත්‍ර කරනවා | කෙලෙසනවා | දූෂ්‍ය කරනවා
polluted=දුෂිත | සංක්ලේශ
pollution=අපවිත්‍ර වීම | අපවිත්‍රකරණය | අපවිත්‍රවීම | කිල්ල | කිලුට | දුෂණය | දූෂණය
polo=අශ්වාරෝහකයන්ගේ පන්දු ක්‍රීඩාවක්
polonaise=නැටුම් විශේෂයක්
polonium=පොලෝනියම් | විකිරණශීලී මූල ද්‍රව්‍යයක්
polonnaruva=පුලත්ථිපුර | පුලස්තිපුර
polony=ලිංගුස් විශේෂයක්
poltergeist=අවතාරය | ගෙවලයා | ඝෝෂා සහිත භූතයා
poltroon=නීචයා | බයගුල්ලා
poly=බහු
poly-acidie=බහුආම්ලික
polyadelphia=පොලිඇඩෙල්පියා
polyadelphous=බහුකලාපික
polyadic=බහුසංයුජ
polyandria=පොලියන්ඩ්‍රියා
polyandrous=බහුපුරුෂ | බහුරේණුක
polyandry=එක ගෙයි කෑම | එකගෙයි කෑම | බහපුරුෂ සේවනය | බහු පුරුෂ සේවනය | බහු පුරුෂත්වය | බහුපතික්‍රමය | බහුපුරුෂ සේවනය | බහුපුරුෂත්වය | බහුරේණුකතාව
polyanthous=බහුපුෂ්පී
polyanthus=බද්ධ කරනලද ශාකවලින් ලබාගන්නා මල්
polyarch=බහුකොන්
polyatomie=බහුපරමාණුක
polybasic=බහුභාස්මික
polycarpellary=බහුඅණ්ඩප | බහුකාපලීය
polycarpic=බහුඅණ්ඩප | බහුඵලීන | බහුවාරඵලීන
polycarpicous=බහුඅණ්ඩප | බහුඵලීන | බහුවාරඵලීන
polycarpous=බහුඅණ්ඩප | බහුඵලීන | බහුවාරඵලීන
polycephalous=බහුශීර්ෂක
polychotomy=බහුබෙදුම
polychromatic=බහුවර්ණ
polychrome=විවිධ වර්ණයෙන් යුත්
polychronic=බහුකාලීන
polycilliate=බහුපක්ෂ්මීය
polycladous=බහුශාඛ
polyclady=බහුශාඛතාව
polycotyledonous=බහුකොටිල | බහුබීජපත්‍රී
polycotyledony=බහුකොටිලතාව | බහුබීජපත්‍රතාව
polycross=බහුමුහුම
polycrystalline=බහුස්ඵටිකරූපි
polyculture=බහුවගාව
polycycle=බහු චක්‍රය
polycyclic=බහුචක්‍රීය
polycycly=බහුචක්‍රතාව
polydactylism=බහු ආංගුලිකතාව
polydemic=බහුප්‍රදේශික | බහුප්‍රාදේශිකය
polyembryonate=බහුකලල
polyembryonic=බහුකලල
polyembryony=බහුකලලතාව
polygamia=පොලිගැමියා
polygamist=බහු භාර්යා සේවනය කරන්නා | බහු විවාහිකයා
polygamous=බහු විවාහික | බහුභාර්යා සේවන | බහුයෝගී | බහුවිවාහක
polygamy=බහු භාර්යා සේවනය | බහු විවාහය | බහුභාර්යත්වය | බහුභාර්යා සේවනය | බහුයෝගිතාව
polygenesis=බහුජනනය | බහුවංශිකතාව
polygeny=බහුවංශිකතාව
polyglot=බහු භාෂී | බහුභාෂා | බහුභාෂා වේදියා
polygon=බහු අස්‍රය | බහුඅශ්‍රය | බහුඅස්‍රය
polygonal=බහුකෝණ සහිත
polygonous=බහුකෝණ සහිත
polygraph=නාඩි වැටීම වැනි දෑ කියවිය හැකි යන්ත්‍රය | බහු රේඛය
polygraphy=බහු කර්තෘක කෘතිය
polygynia=පොලිගයිනියා
polygynous=බහුජායාංගී
polygyny=බහු භාර්යත්වය | බහුභාර්යා සේවනය | භහුභාර්ය්‍යා සේවනය
polyhedral=බහුතල
polyhedron=බහුතල අශ්‍රය | බහුතලය
polyheism=නොයෙක් ශිල්පයන් ප්‍රගුණ කරන
polyhierarchic=බහු ධූරානුක්‍රම
polykaric=බහුන්‍යෂ්ටික
polylogia=නන්දෙඩවිල්ල
polymath=බහුශාස්ත්‍රඥයා | මහාප්‍රාඥයා
polymer=බහු අවයවකය | බහුඅවයවකය
polymeric=බහුඅවයවික
polymeride=බහුඅවයවය
polymerisation=බහුඅවයවිභවනය | බහුඅවයවීකරණය
polymerise=බහු අවයවීකරණය වෙනවා
polymerism=බහුඅවයවකතාව
polymerization=බහුඅවයවීකරණය
polymorph=බහුරූපය
polymorphic=බහුරූපී
polymorphism=බහුරූපතාව
polymorphonuclear=බහුරූප න්‍යෂ්ටික
polymorphous=බහුරූපී | විවිධ වෙනස්කම්වලට තුඩුදෙන
polymorphy=බහුරූපතාව
polymorphysm=බහුරූපිතාව
polymysin=පොලිමයිසින්
polynesia=පොලිනීසියාව
polynesian=පොලිනේසියානු
polynia=පොලිනියාව
polynomial=බහුපද | බහුපද ප්‍රකාශනය | බහුපදය
polynominal=බහු කර්තෘ | බහු පද
polynucleate=බහුන්‍යෂ්ටික
polyoetalous=බහුදල
polyoicous=බහුගෘහී
polyonym=බහුවර්ථපදය
polyonymous=බහු නාමක
polyoxide=පොලීඔක්සයිඩ්
polyp=බහුපාදියා
polypeptide=පොලිපෙප්ටයිඩ්
polypeptides=පොලිපෙප්ටයිඩ
polypetalous=බහුදල | බහුදල්‍ර
polyphagous=බහුභක්ෂ
polyphase=බහු කලා | බහුකලා
polyphony=බහුතාල නාදය | බහුස්වනය
polyphylesis=බහුවංශිකතාව
polyphyletic=බහුවංශික
polyphyllous=බහුපත්‍රී | බහුපරිපුෂ්පී
polypide=බුහුපැදියා
polyploid=බහුගුණ | බහුගුණකය
polypodiaceous=පොලිපෝඩියුම් වැනි
polyporoid=පොලිපෝරුස් වැනි
polyporous=පොලිපෝරුස් වැනි
polyptych=අල්තාර මණ්ඩලය
polypus=පොළිපස
polypyknotic=බහුඝනත්වය
polyrhizal=බහුමුල
polyrhizous=බහුමුල
polysaccharide=පොලිසැකරයිඩ් | පොළිසැකරයිඩ්
polysaccharides=පොලි සැකරයිඩ
polysepalous=බහුමණිපත්‍රී
polysiphonous=බහුනාල
polysomy=බහ්වර්ථ
polystelic=බහුස්ථුණ
polystely=බහුස්ථුණතාව
polystichous=බහුපංක්තික
polystyrene=තද ප්ලාස්ටික් විශේෂයක් | පොලිස්ටයිරින්
polysyllabic=බහුමාත්‍රික
polysyllable=බහු අක්ෂර පදය
polysyllogism=බහුසංවාක්‍යය
polytechnic=බහු තාක්ෂණික | බහු තාක්ෂණික ආයතනය | බහු තාක්ෂණික විද්‍යාලය | බහු ශිල්පීය ආයතනය | බහුතාක්ෂණික
polyterm=බහුපද
polytheism=බහුදේව වාදය | බහුදේවවාදය
polytheist=බහුදේවවාදය | බහුදේවවාදියා
polythene=පොලිතීන්
polytopic=බහුස්ථානික
polytypic=බහුදර්ශ
polyurethane=කෘත්‍රිම රෙසිනයක්
polyuria=අධිමූත්‍රතාව | බහු මූත්‍රතාව
polyzygosis=බහුයුග්මතාව
pomace=මද්‍යසාරය සෑදීමට ගන්නා මිරිකන ලද ඇපල්
pomaceous=ආඵලීන
pomade=කේෂාලේපය | ශීර්ෂාලේපය
pomander=සුවඳ විලවුන් බහාලන රවුම් බඳුන
pome=ආඵලය
pomegranate=දෙළුම්
pomelo=පැඟිරි විශේෂයක්
pomeranian=සුනඛ විශේෂයක්
pomfret-cake=රවුම් රසකැවිලි ජාතියක්
pommel=කඩු මිටේ ගෝලාකාර කොටස | පහර දෙනවා
pomology=ඵල විද්‍යාව
pomp=අලංකාරය | ගර්වය | විභූතිය
pompier=ආග්නිකයා
pompom=තුවක්කු වර්ගයක්
pomposity=ආටෝපය | උඩඟුකම | සාඩම්බරත්වය
pompous=ආඩම්බර | උජාරු | උදාර | උදාරම් ලෙස හැසිරෙන | ගර්විත | පම්පෝරි | ප්‍රතාපවත් | මහත් අලංකාරයෙන් යුත් | සගර්ව | සාටෝප | සාඩම්බර
ponce=ගණිකාවකගෙන් යැපෙන්නා | ගණිකාවන්ගේ ආදායමින් වත්වන්නා
poncho=කබා විශේෂයක් | පොන්වෝව
pond=තටාකය | තඹරවනය | තඹුරුවනය | තළා | තළාකය | පතහ | පියුමාකර | පුෂ්කරණිය | පොකුණ | සර | සරසී | සරා | සරෝ | හ්‍රදය
ponder=සංවන්තනය | ඕනෑකමින් සිතා බලනවා
ponderable=ලඝු නොවූ | සැලකියයුතු
ponderous=තඩි | ප්‍රාණයක් නැති | බර | බරපතළ
poniard=කුඩා කිරිච්වය
ponore=පෝනෝර්
pons=පොන්ස් | සේතුව
pontiff=නායක පූජකයා | පාප්තුමා | බිෂොප්
pontifical=දැඩි මත දරණ | පාප්තුමා පිළිබඳ වූ
pontificalia=පූජක පළඳනා
pontificals=පූජක පළඳනා
pontificate=පාප් පදවි කාලය
pontification=අනුශාසනය
pontoon=කාඩ්වලින් කෙරෙන ක්‍රීඩාවක් | පාරුව
pontoon-bridge=පාරු පාලම
ponunciation=සසය
pony=කුඩා වර්ගයේ අශ්වයා | පෝනියා
poodle=කුඩා බල්ලන් වර්ගයක්
poof=සමලිංගික සේවනයේ යෙදෙන්නා
pooh=වහ්
pooh-bah=එකවිට නිල කීපයක් දරන්නා
poohpooh=නින්දා කරනවා | හෙළා දකිනවා
pool=කිටුව | ගඟෙහි ගැඹුරු තැන | දිය කඩිත්ත | පොකුණ | රැස් කරනවා | සංසදය
pooling=කිටු කිරීම
poonac=පුණ්ණක්කු | පුනක්කු | මුරුවට
poop=අවරය | නැවේ පසුභාගය
poor=අඩු | අපොහොසත් | අපෝසත් | අර්ථහීන | අසරණ | අසාර | කපණ | කෙට්ටු | තුච්ඡ | දරිද්‍ර | දිළිඳු | දීන | දුක්පත් | දුගී | දුප්පත් | දුර්වල | නිදන | බැරි | සුළු
poor-spirited=දීන | බියසුලු
poorly=අසනීප ගති ඇති | නොසතුටුදායක ලෙස
poorness=නිස්සාරභාවය | හීනභාවය
pop=උකස | නව විලාසිතා | සිහින් පිපිරුම් හඬ | හඬ ඇතිව | හදිසියෙන්
popcorn=පොරි | විලඳ
pope=පාප් වහන්සේ
popery=කතෝලිකආගමට උපහාස වශයෙන් යොදන පදයක්
popinjay=උද්ධච්ඡ තැනැත්තා | ගිරවා | පුරාජේරු කාරයා
popish=කතෝලික ආගම සම්බන්ධ
popit=සල ඉහකඩ
poplar=ගස් විශේෂයක්
poplin=කපු රෙදි වර්ගයක් | පොප්ලින්
popliteal=මාන්දිරා
popper=ලොකු බොත්තම
poppet=බොනික්කා | රූකඩය | සල ඉහකඩ | සුරතලා | සුරතලී
popping=කේතුක ඡිද්‍රණය | පොපියනවා
popping-crease=ක්‍රිකට් ක්‍රීඩාවේ පිතිකරු සීමාව
poppit=සල ඉහකඩ
poppy=පොපි පැළෑටිය
poppycock=තේරුමක් නැති කතා | විකාර
poptizator=පෙප්ටයිස් කාරකය
populace=පොදු වැසියෝ | මහජනයා
popular=ඔවුන්ට සුදුසු | ජනතවාදී | ජනප්‍රිය | ජනරංජන | ජනසම්මත | ප්‍රචලිත | ප්‍රතීත | පොදු | මහජනයා පිළිබඳ වූ | සාමාන්‍ය
popularity=ජනප්‍රසාදය | ජනප්‍රියභාවය | ජනසම්මතභාවය
popularize=ජනතාව අතර ප්‍රකට කරනවා
populate=ජනගහනය ඇති කරනවා | සෙනඟ පදිංචි කරනවා
population=ගහනය | ජන සංඛ්‍යාව | ජනගහණය | ජනගහනය | ජනයා | ශාක ගහනය | සංගහනය
populism=ජනතාවාදය
populist=ජනතාවාදී | ජනහිතවාදියා
populous=ජනයාගෙන් ගැවසි | ජනාකීර්ණ
porasity=සිදුරු හසිත බව
porbability=විය හැකි බව | සම්භාවිතාව
porcelain=පිඟන් මැටි | පෝසිලේන්
porch=ද්වාරමණ්ඩපය | පියස්සක් සහිත දොර
porcine=ඌරන් වැනි | ඌරන්ගේ
porcupine=ඉත්තෑවා
pore=කූපය | ඡිද්‍රය | විවරය | සිදුර
pore-wall=ඡිද්‍ර බිත්තිය | සිදුරු බිත්තිය
porect=බිහිකුරු
porism=බුහුතුරුව
pork=ඌරුමස් | හූරුමස්
porker=මස් ඌරා
porky=මසින් පිරුණු
pornographic=අශ්ලීල
pornography=අශ්ලීල කෘති | අශ්ලීල රචනා | අශ්ලීලරවනය | අසභ්‍ය පොතපත | කාමෝද්දීපන රචනය | ගාණික්‍යය
porogamic=ඡිද්‍රාවිශ්ම
porogamous=ඡිද්‍රාවිශ්ම
porogamy=ඡිද්‍රවේශනය
porometer=ඡිද්‍රාමානය
porosimeter=සවිවරතාමානය
porosity=සඡිද්‍රතාව | සවිවරතාව
porous=දිය උරාගන්නා | දිය කන | සඡිද්‍ර | සඡීද්‍ර | සව්වර | සවිවර
porphyrine=පෝපයිරින්
porphyry=ගරුජපාෂාණ වර්ගයක් | පෝපිරි
porpoise=මූදු ඌරා
porridge=තලප
porringer=තලප තැටිය
port=කවුළුව | ගමන්ලීලාව | තිත්ථ | තීර්ථය | තොට | තොටමුණ | තොටු | තොටුපළ | දොරටුව | නැව්තොට | නැවේ වම් පැත්ත | පටුන | බිල | මුද්‍රිකපාන වර්ගයක් | වරාය | වරායක් ඇති නගරය | සුක්කානම වම් පැත්තට හරවනවා
portability=සුවහබව | සුවහය
portable=අතේ ගෙන යාහැකි | සුවහ
portage=ඔසවා ගෙන යෑම
portal=ද්වාරය | මහාද්වාරය | වාසල් රාමුව
portcrayon=ක්‍රෙයෝන්මිට
porte-crayon=ක්‍රෙයෝන්මිට
portend=පෙර නිමිති දක්වනවා
portent=ආශ්චර්යය | පෙරනිමිත්ත
portentous=අතිවිශාල | අභූත | ආශ්චර්ය | පෙරනිමිතිරූපී | භයානක
porter=දොරටුපාලයා
porterage=එසවුම් කුලිය | බර ඉසිලීමේ කුලිය | වැහුම් කුලිය
portfolio=අමාත්‍ය ධූරය | ආයෝජන කළඹ | පත්‍රධාරය | ලිපි ගොනු කවරය
portico=ද්වාර මණ්ඩපය | පෝටිකෝව | වහලක් සහිත සක්මන
portion=අංශය | ඉරණම | ඒකදදේශය | කඩ | කුට්ටිය | කොටස | කොටස් වශයෙන් දෙනවා | කොටස් වශයෙන් බෙදනවා | ඛණ්ඩය | දායාදය | දෑවැද්ද දෙනවා | පංගුව | බික | බියල්ල | බියලී | බෙදා දෙනවා | භාගය
portionless=දෑවැදි නොමැති | මුදලක් හෝ දේපලක් නැති
portly=ගර්විත ලෙස පෙනෙන | ගරු කළයුතු | තරබාරු | ස්ථූල
portmanteau=ගමන්මල්ල
portrait=ආලෙඛය | ආලේඛය | කෙනෙකුගේ දේහලක්ෂණ | ගතරුව | ඡායාරූපය | ප්‍රතිමූර්තිය | පිළිරුව | චිත්‍රය
portraiture=ආලේඛ්‍ය චිත්‍ර | චිත්‍ර කලාව
portray=ආලේඛනය කරනවා | නිරූපණය කරනවා
portrayal=ආලේඛනය | නිරූපණය | වචනයෙන් විස්තර කිරීම
portry=චිත්‍රයකින් ඇඳ දක්වනවා
portugal=පුර්තුගාලය | පෘතුගාලය
portuguese=පරංගි | ප්‍රතිකාල් | පුර්තුගීසි | පෘතුගාලයට අයිති | පෘතුගීසි
pose=නිෂ්ඨාව | පෙන්වන ආකාරය | පෙනී සිටිනවා | බොරු ගතිගුණ දැක්වීම | මතු කරනවා | ලීලාව | වෘත්තිය | සෙයියාව | හැඩ ගැසී පෙනීම
poser=ගැටළුව | ප්‍රශ්නය | ව්‍යාජ ගතිගුණ දක්වන්නා | විසඳීමට දුෂ්කර ප්‍රශ්නය
poseur=නැති ගුණ දක්වන්නා | බොරුකාරයා
posh=අලංකාර | ලක්ෂණ | ෂෝක් | සැපපහසු
posit=ඉදිරිපත් කරනවා | උපග්‍රහණ කරනවා | ප්‍රකාශ කරනවා | ප්‍රතිජානනය කරනවා | සත්‍ය වශයෙන් සිතාගන්නවා
position=ආකල්පය | ආස්තානය | ආස්ථානය | ඉරියව්ව | ඨානාන්තරය | තත්ත්වය | තත්වය | තනතුර | තරම | තරමතිරම | තරාතිරම | තානාන්තරය | තැන | ධුර | නිලය | පදවිය | පිහිටීම | පිහිටුව | පිහිටුවනවා | පිළිගැනීම | මතය | රක්ෂාව | ස්තානය | ස්ථාන | ස්ථානය | ස්ථානාන්තරය | ස්ථාපිතය | ස්වරූපය
positional=ආස්ථානීය | ස්ථානීය
positionality=ආස්ථානීයතාව | ස්ථානීයතාව
positive=අවශ්‍ය | ඒකාන්ත | ඡායාරූපය | තත්ථ්‍ය | තාත්වික | ධණ | ධන | ධනාත්මක | නියත | නිශ්වත | ප්‍රත්‍යක්ෂ | ප්‍රතිඡායා | ප්‍රතිජානක | ප්‍රතිජානන | ප්‍රමාප්‍ය | ප්‍රයෝජනවත් | පැහැදිලි | ඵලදායක | යථානුරූප | සහතික | සාධානීය | සාධාරණාර්ථ | සාමාන්‍ය ගුණවාචකය
positivism=ඉන්ද්‍රියානුභූතවාදය | ඉන්ද්‍රියානුභූතිවාදය | ධනීයවාදය | ප්‍රත්‍යක්ෂවාදය | යථානුභූතවාදය
positivist=ධනීයයා | ප්‍රත්‍යක්ෂවාදියා
positron=පොසිට්‍රෝනය
posscript=පසුලිපිය
posse=කණ්ඩායම | බල මණ්ඩලය
possess=අරක්ගන්නවා | බුක්ති විඳිනවා | බුත්ති විඳිනවා | යටත් කරගෙන සිටිනවා | හිමිව සිටිනවා
possessed=ආවිෂ්ට | ආවේස වූ | භූතාවේශ වූ | වියරු වැටුණු | සන්තක
possessio=බුත්තිය
possession=අතමිට | අයිතිය | ආරූඩවීම | ආවේශය | දේපළ | නතුව | බුක්තිය | බුත්තිය | බුත්තීය | භුක්තිය | වැහීම | සන්තකය | ස්වාමිත්වය | ස්වාමීත්වය | හිමිකම | ළඟ තබාගැනීම
possession,undisturbed=නිරවුල් බුත්තිය
possessions=අයත් රටවල් ආදිය | දේපල | වස්තුව
possessive=ස්වාමිත්වය දක්වන
possessor=අයිතිකාරයා | බුත්තිකරු | භුක්ති විඳින්නා | ස්වාමියා | හිමියා
possessory=අයිතිකරු පිළිබඳ වූ | බුත්තීය | භුක්තීය
posset=ආහාරමය උණු කිරි
possibilism=ශක්‍යවාදය
possibility=කළහැකි දේ | පුළුවන්කම | භව්‍යත්වය | භාව්‍යතාව | වියහැකි දේ | වියහැකියාව | ශක්නුතාව | ශක්‍යතාව | හැකිකම | හැකියාව
possible=ආශ්‍රය කළහැකි | කළහැකි | පිළිවන් | පුළුවන් | භව්‍ය | භාව්‍ය | වියහැකි | සම්භාව්‍ය | හැකි
possibly=කොහෙත්ම | කොහොමවත් | බාග වේලාවට
post=කණුව | කප | කම්බ | කුඹය | ඛීලය | ඨානාන්තරය | තනතුර | තානාන්තරය | තැත | තැපැල් කරනවා | තැපෑල | ධුර | නියමිත ස්ථානය | නිල | නිලකාරයා නිලතල | පදවිය | පශ්චාත් | පශ්චාද් | පසු | පසුව | ප්‍රදර්ශනය කරනවා | පිහිටුවනවා | මුරපළ | රක්ෂාව | ස්ථම්භය | ස්ථානාන්තරය
post-cambrian=පශ්චාත් කේම්බ්‍රිය
post-census=පශ්චාත් සංගණනය
post-chaise=අශ්ව කෝච්චිය | අශ්වයන් යෙදූ ගමන්රථය
post-dated=පසු දාතම දරණ | පසුදාතම් කළ
post-free=තැපැල් ගාස්තුවක් නැතිව
post-glacial=පශ්චාත් ග්ලැසියර
post-haste=ඉතා ඉක්මනින්
post-horses=අශ්වකෝච්වයේ යෙදූ අශ්වයෝ
post-impressionism=පශ්චාත් උපස්ථීතිවාදය
post-mortem=පශ්චාත් මරණ පරීක්ෂණය
post-natal=පශ්චාත් ප්‍රසව | පශ්චාත් ප්‍රසූති
post-nuptial=විවාහයෙන් පසු පවත්වන
post-office=තැපැල් කන්තෝරුව
post-paid=තැපෑලට ගෙවූ
post-prandial=කෑමෙන් පසු
post-war=යුද්ධයෙන් පසු
postage=තැපැල් ගාස්තු | තැපැල් ගාස්තුව | තැපෑල
postal=තැපැල් | තැපෑල පිළිබඳ වූ
postal-order=තැපැල් ඇණැවුම
postassium=පොටෑසියම්
postcensal=පශ්චාත් සංගණන
postclimax=පශ්චෝත්කර්ෂය
poster=දැන්වීම් කොළය | පෝස්ටරය | බෙලියත
posteranium=පශ්චකපාලය
posterior=අපර | තට්ටම | පසු භාගයෙහි පිහිටි | පසුව සිදු වූ | පිටිපස
posterity=අනාගත පරම්පරාව | දරුමුණුබුරෝ | මතු පරම්පරාව | මතුපරම්පරාව | සංහතිය
postern=කරුබිලිය | රහස් දොර
postfertilization=පශ්චාත් සංසේචන
posthumous=මරණාපර | මරණින් පසු වූ | මල පසු | මළ පසු
postical=උදරීය
postiche=ව්‍යාජ
postillion=රථ අශ්වාරෝහකයා
posting=තැපැල් කිරීම | පදස්ථාපනය | පිටපත් කිරීම
postman=තැපැල්කරු | තැපැල්කාරයා
postmortem=ශවපරීක්ෂණය
postpone=අතපසු කරනවා | කල් තබනවා | කල් දමනවා
postponed=කල් ගිය
postponement=කල් දැමීම | කල්දැමීම | කල්‍යාම | කල්‍යෑම | ප්‍රමාද කිරීම
postposition=නාම පදයකට පසුව යොදන නිපාතය
postscript=අනුලේඛය | අපරලේඛය | පසු වදන | පසු සටහන
postulant=ඉල්ලුම්කරුවා
postulate=ආකල්පනය කළ දෙය | උපකල්පනය කරනවා | උපග්‍රහණය | ප්‍රගිගෘහිතය | ප්‍රතිගෘහිතය | ප්‍රතිගෘහීතය | පූර්වග්‍රහණය කරනවා
postulation=උපග්‍රහණය කිරීම
postural=ඉරියව්
posture=අංගවින්‍යාසය | ආකල්පය | ඉරියව්ව | ඉරියව්වක පිහිටුවනවා | ඉරියවුව | පිහිටා තිබෙන ආකාරය | පිහිටා සිටින ආකාරය | යම්කිසි ආකාරයක් පානවා | යම්කිසි ඉරියව්වක පිහිටනවා | ස්ථාපනය
posy=පුංචි මල් කළඹ
pot=කුඩම | කුම්භය | කෝව | ඝටය | තලිය | පැළ කරනවා | පෝච්වය | පෝච්වවල දමා හිටවනවා | භාජනවල දමනවා | මලාව | මුට්ටිය | වළං | වළන් | වළඳ | විශාල ප්‍රමාණය | වෙඩි තබනවා | සැලිය | සැළ | හට්ටිය | හැළි | හැළිය
pot-arrack=හැළි අරක්කු
pot-bellied=තුන්දිල
pot-belly=බණ්ඩිය | විශාල බඩ
pot-boiler=උදරපෝෂකය | බඩ රැකුම | මුදලට ම ලියූ දෙය
pot-herb=පලා වර්ග
pot-like=ඝටාකාර
pot-pourri=විවිධ රචනා සංග්‍රහය | විවිධාහාර මිශ්‍රණය
pot-shot=කුරුමාණම
potable=බීමට යෝග්‍ය
potash=පොටෑෂ් | යවකාර ලුණු
potassium=පොටෑසියම් | යවකාර ලුණු
potation=බීම
potato=අර්තාපල්
poteen=හොරෙන් පෙරන විස්කි
potence=ශක්තිය
potency=කාම ශක්තිය | ප්‍රාබල්‍යය | විභවය | ශක්තිය
potent=ප්‍රබල | බලසම්පන්න | සමර්ථ
potentate=ඒකාධිපති පාලකයා | නරේන්ද්‍රයා | බලසම්පන්නයා | රාජයා
potential=ගුප්ත | දියුණු කළහැකි | භව්‍ය | විභව | විභවය | විභව්‍ය | වියහැකි | ශක්තිසම්පන්න | සම්භාව්‍ය
potentiality=විභවතාව
potentiatity=වියහැකිබව | ශක්‍යතාව
potentiometer=විභවමානය
poterage=එසවුම් කුලිය | වැහුම් කුලිය
potestas=පොටෙස්ටාස් අධිබලය
pother=කලබලය
potion=විෂ මත්පැන්
potlatch=පොට්ලැවය
potometer=පානමානය
potsherd=කැබිලිත්ත | වළං කැබැල්ල
pottage=තලපය
potted-meat=පිස අහුරන ලද මස
potter=අතපත ගගා සිටිනවා | කුම්භකාරයා | කුඹල්කරු | කුඹල්කරුවා | කුඹලා | බඩහැලයා | මැටි භාජන සාදන්නා | වළන්කරුවා
potter-wasp=කුඹල්මැස්සා
potters-wheel=කුඹල් සක
pottery=කුඹල් කර්මාන්තය | කුඹල් පට්ටලය | මෘද්භාණ්ඩ | වළං සෑදීම | වළන් | වළන් බඩු
potty=නොවැදගත් | බඳුන | මෝඩ | විකාර | හිස්පෝච්චිය | ළමා මුත්‍ර භාජනය
pouch=කුඩා මල්ල | කූරපයිය | කොසුව | කෝෂයක් යොදනවා | පසුම්බියක් යොදනවා | පැස | පුටකය | සාක්කුව
pouffe=ඝන මෙට්ටය | සිනිඳු මෙට්ටය | සුවපහසු මිටි අසුන
pouit=කුරුල්ලෙක්
poulterer=කුකුළු වෙළෙන්ඳා
poultice=ආලේපය | පාප්පය | පෝල්ටිසය
poultry=කුකුළු ගණය
pounce=කඩා පනිනවා | කුරුල්ලාගේ දිග නිය | හදිසියෙන් පැන අල්ලාගන්නවා | හිල් කරනවා
pouncing=සංක්‍රාමණය
pound=කොටනවා | කොටුවේ වසා තබනවා | පවුම | පිටිකොටනවා | රන් පවුම | රාත්තල | වැරෙන් පහර දෙනවා
pound-weight=රාත්තල් බර | රාත්තල් බර
poundage=කොටු ගාස්තුව | පවුන්ඩේජ් ගාස්තුව | පවුමට හෝ රාත්තලට ගාස්තුව
poundal=පවුන්ඩලය
pounder=තුවක්කු වර්ගයක් | මෝල | රාත්තලක් බර දෙය
pour=ගලනවා | ගලා එනවා | ගලා යනවා | වක්කරනවා | වත්කරනවා | වැක්කෙරෙනවා | වැගිරෙනවා | වැල නොකැ යනවා | සනවා
pourboire=පාරිතෝෂකය | සුළු තෑග්ග
poured=වගුළ
pouring=වත් කිරීම
pouring-rain=නාකපන වැස්ස
pourparler=ප්‍රාරම්භ සාකච්ඡාව
poussinisme=පූසින්වාදය
pout=කට උල්කිරීම | හොට බලියනවා
pouter=පුඹු පරවියා | පුඹු පරෙවියා
poverty=කලිමල | දරිද්‍රතාව | දිළිඳු බව | දිළිඳුකම | දුගීබව | දුප්පත්කම | නැතිකම | නැතිබැරිකම | නිස්සාරභාවය | බැරිකම | හිඟය
poverty-stricken=දිළිඳු | දීන
pow-wow=රතු ඉන්දියන්කාරයන්ගේ රැස්වීම | සාකච්ඡා සභාව
powder=කුඩ | කුඩු | කුඩු ඉසිනවා | කුඩු කරනවා | චූර්ණය | පියර | පුයර | පුයර දමනවා | වෙඩිබේත් | සුන් | සුනු
powder-puff=පුයර මල
powdery=කුඩු වැනි | කුඩු වෙන | කුඩු සහිත
power=ඉසිරු | ඉසුර | ඉසුරමදය | ඉසුරු | එඩිය | ඓශ්චර්ය | ක්ෂමතාව | ගැම්ම | ජවය | ප්‍රබලත්වය | පාලනය | පුළුවන්කම | බලතල | බලය | බලවතා | බලශක්තිය | මහ හුඟක් | රාජ්‍යය | විභවය | ශක්තිය | සවිය | සහය | හයිය
power-set=බලවේග කට්ටලය
power-station=විදුලි බල ස්ථානය
powerful=උත්තර | ගාඩ | ජවසම්පන්න | ජවාධික | තරසර | තෙදැති | පබල | ප්‍රතිබල | ප්‍රබල | ප්‍රභූ | බලගතු | බලවත් | බලසම්පන්න | වික්‍රාමාවිත | විශාල | වීර | වේගවත් | ශක්තිමත් | ශූර | සවිබල | සැඬ | සැඩ
powering=බලයකට නැංවීම
powerless=දුබල | නොහැකි | බෙලහීන | විබල
powers=බලතල
pox=වසංගතය
poya=උපෝසථ
pozzolana=පොත්සොලානා | පොසොලානා
practicable=ක්‍රියායෝග්‍ය | ක්‍රියාවෙහි යෙදිය හැකි | ප්‍රායෝගික | ව්‍යවහාරික | සාධන
practical=ක්‍රියාත්මක | ක්‍රියාශීලී | ප්‍රායෝගික | ප්‍රායෝගික පරීක්ෂණය | ප්‍රායෝගිය | පුරුද්දෙන් ලබාගත් | ව්‍යවහාරික
practically=ප්‍රායෝගිකව
practice=අභ්‍යාසය | ක්‍රියාමාර්ගය | ක්‍රියාව | පරිචය | පරිචයනය කරනවා | පරිචාරය | පරිශීලනය | ප්‍රගුණනය | ප්‍රතිපත්තිය | ප්‍රයෝගය | පුරුද්ද | පුහුණුවීම | භාවිතය | යෝග | යෝගය | රීති | රීතිය | වහර | ව්‍යවහාරය | සිරිත | හුරුකම
practile=අදාල ප්‍රතිශතය
practise=අනුගමනය කරනවා | ක්‍රියාවෙහි යොදනවා | පරිචයනය කරනවා | ප්‍රගුණ කරනවා | පුරුදු කරනවා | පුරුදු වෙනවා | රක්ෂාව වශයෙන් කරනවා | හුරු වෙනවා
practitioner=නියුක්තයා | පරිචායකයා | රක්ෂාවක් කරන්නා | වෘත්තිකයා | වෘත්තියෙහි නියුක්ත නීතිඥයා
praecox=අකාලපරිණත
praefforation=පරිවින්‍යාසය
praefoliton=නාරටිවින්‍යාසය
praemunire=රාජද්‍රෝහය
praenomen=පුද්ගල නාමය | පුරාණ රෝමයේ පුද්ගලයකුගේ නම
praesodymium=ලෝහමය මූලද්‍රව්‍යයක්
praetor=ප්‍රීටර | පුරාණ රෝමයේ මහේස්ත්‍රාත්
prafunda=ගම්භීර
pragmatic=උපයෝගික | ප්‍රයෝජ්‍ය | ප්‍රායෝගිකව සලකා බලන
pragmatism=උපයෝගිතාවාදය | කෘත්‍යසාධකයා වාදය | තත්කාර්ය වාදය | ප්‍රයෝජ්‍යතාවාදය | ප්‍රායෝගිතා වාදය
pragnanz=ප්‍රෙග්නන්සය
prairie=ප්‍රෙයාරී | මහා තැනිතලාව
prairies=ප්‍රෙයාරි
praise=අභිනන්දනය | ආ වඩනවා | තියූ | තුතිය | තෙවුම | පසසනවා | ප්‍රශංසා කරනවා | ප්‍රශංසාකරනවා | ප්‍රශංසාව | පැසසුම | පූච්චම | වණනවා | වර්ණනා කරනවා | වර්ණනාව | ස්තුති කරනවා | ස්තුතිය | හුවනවා
praiseworthy=ප්‍රශංසනීය
prakara=ප්‍රාකාරය
prakrit=ප්‍රාකෘත
praline=සීනි වලින් සාදන ද්‍රව්‍යයක්
pram=අත දරුවන් තබා තල්ලුකරන රථය
prance=උඩඟු ලෙසින් යනවා
prandial=රාත්‍රි භෝජනය සම්බන්ධ
prang=අනතුරින් හානි වෙනවා | ඝට්ටනයෙන් අලාභ වෙනවා | තුඩු කුලුන | සුනු විසුණු කරනවා | හැප්පෙනවා
prank=ඳඟය | විහිළුව | විහිළුවට රැවටීම | සමච්චලය | සරසනවා
prankster=ඇස් රතු වන විහිළු කරන්නා
praseodymium=ප්‍රෙසියොඩිමියම්
prat=මෝඩයා
prate=නන්දොඩනවා
pratique=ප්‍රටීකය | බෝවෙන රෝගීන් සිටි නැව වරායට ඇතුළු වීමට දෙන අ
prattle=ජල්පනය | දොඩවනවා | ප්‍රලාප | බොළඳ කථා කරනවා | බොළඳ බස් | බොළඳ බස් කියනවා | සුරතල් බස් දෙඩවිල්ල
prawn=ඉස්සා
pray=කරුණාකර අනේ | දඩයම | ප්‍රාර්ථනා කරනවා | පින්සෙණ්ඩුව | බැගෑපත් ලෙස ඉල්ලනවා | යඡනවා | යදිනවා | යාච්ඤා කරනවා | යාච්ඤාව
prayer=අයැදුම | ආයාචනය | ආයාචනාව | ප්‍රාර්ථනාව | බැගෑපත් ඉල්ලීම | යාච්ඤාව | යාච්ඥාව | යාඥාව | යාතිකාව | යාදින්න | යාදිනී
prayerful=යාච්ඤාවෙහි ලැදි
pre=කලින් | ප්‍ර | ප්‍රාක් | ප්‍රාග් | පුරෝ | පූර්ව | පූර්ව | පෙර
pre-amplifier=පූර්ව වර්ධකය
pre-arrange=කලින් සූදානම් කරනවා
pre-audience=මුලින් කන්දීම
pre-axial=පුරෝක්ෂ
pre-cataloguing=ප්‍රකාශන පූර්ව සූවකරණය
pre-christian=ක්‍රිස්තුස්වන්සේගේ පහළවීමට පළමු
pre-conception=පූර්වසංකල්පනය
pre-condition=පූර්ව කොන්දේසිය | පූර්ව ප්‍රත්‍යය | පූර්වප්‍රත්‍යය | පූර්වාවස්ථාව
pre-date=සැබෑ දිනය වෙනුවට ඊට ප්‍රථම දිනයක් දමනවා
pre-destination=පූර්ව නියමය
pre-determinatioa=පූර්ව නියතිය
pre-eminent=ප්‍රකට | පාමොක් | විශිෂ්ට
pre-empt=පළමුව බුක්තිය ගන්නවා
pre-emption=පූර්වක්‍රය | පෙරවිකිණීම
pre-emptive=පූර්වක්‍රය
pre-exist=කලින් වත්ව සිටිනවා | පවතිනවා
pre-existence=කලින් වත්ව තිබීම | කලින් වත්වීම | ප්‍රාග්භාවය | පූර්ව විතය | පූර්වජන්මය | පෙර සිට පැවතීම
pre-historic=ප්‍රාගෛතිහාසික
pre-history=ප්‍රාග් ඉතිහාසය
pre-ignition=කලින් ජ්වලනය | කලින් ජ්වලනය වීම | පෙර දැල්වුම
pre-meditation=පූර්ව විමර්ශනය
pre-paid=කලින් ගෙවූ | පෙර ගෙවූ | පෙරගෙවූ
pre-print=පූර්ව මුද්‍රණය
pre-requisite=පූර්වාවශ්‍ය
pre-revolutionary=ප්‍රාග්විප්ලව
pre-selector=ප්‍රාග්වරකය | පෙරතෝරනය
pre-stressed=කම්බි යොදා දැඩිකළ
pre-supposition=පූර්ව අභ්‍යපගමනය | පූර්ව අභ්‍යපගමය
pre-tensioning=පෙර ආතතීකරණය
pre-testing=කලින් පරීක්ෂා කිරීම | කලින් පරීක්ෂාකිරීම | පෙර පරීක්ෂා කිරීම | පෙර පරීක්ෂාව
preach=අවවාද කරනවා | උගන්වනවා | දේශනා කරනවා
preacher=උපදේශකයා | දේශකයා | දේශනාකාරයා | ධර්මදේශකයා | භාණක
preaching=දම් සබය | බණ
preadmission=පේර පිවිසුම
preamble=ප්‍රස්තාවනාව | ප්‍රාරම්භය | පූර්විකාව
preamplifier=ප්‍රාක්වර්ධකය
preangiospermous=පුරාවෘතබීජක
prebendary=විශේෂ දේවගැතිවරයෙකුට ගෙවීමට නියමිත දීමනාව ලබන
preboring=පෙර හෑරීම
prebound=පෙරබැඳි
precambrian=ප්‍රාග් කෙම්බ්‍රියානු
precarious=අඩමාණ | අඩමාන | අස්ථිර | සැක සහිත
precatory=ප්‍රාර්ථනාත්මක
precatuionary-motive=පූර්වාරක්ෂණ චේතනාව
precaution=කලින් පරිස්සම් වීම | පූර්වාරක්ෂාව | පූර්වෝපාය | පූර්වෝපායය | පෙරපරෙස්සම
precautionary=ආරක්ෂක
precautionary-motive=පූර්වාරක්ෂණ චේතනාව
precede=කලින් වත් වෙනවා | කලින් සිදු වෙනවා | පූර්වගමනය | පෙරටුව ගමන් කරනවා
precedence=ඉස්සර වීම | ප්‍රධානත්වය | ප්‍රමුඛතාව | පූර්වගාමීත්වය | පූර්වාදර්ශය | වඩා වැදගත්කම
precedent=ආදර්ශය | කලින් ඇති වියයුතු | කලින් තීරණය | පුර්වාදර්ශය | පූර්වගමනය | පූර්වගාමී | පූර්වාදර්ශය | පෙරගියාව
preceding=ඉදිරියෙහි වූ | ඉහත | කලින් | පුරෝගාමී | පූර්ව | පූර්වංගම | පූර්වගාමී | පෙරටුව
precentor=ප්‍රධාන ගීතිකාකාරයා
precept=අණපත | උපදේශය | නියොගපත්‍රය | නියෝගය | ප්‍රඥප්තිය | ශික්ෂාපද | ශික්ෂාව | සික | සිකපදය | සිල්
preceptor=ආචාර්යයා | ආචාර්යවරයා | උපාධ්‍යායයා | ගුරුවරයා | ශික්ෂකයා
preceptress=උපදේශිකාව
precession=අයනාංශය | පූර්වායනය | සාපේක්ෂක අක්ෂභ්‍රමණය
precinct=අවට පිහිටි ප්‍රදේශය | ගොඩනැගිල්ලකට අයිති භූමිභාගය | සීමාව
precincts=වට සීමාව | සීමාව
precious=අගනා | අගමැති | අනර්ඝ | කදිම | බොහෝ වටිනා | මාහැඟි | විශේෂ | හුඟක්
precipice=පර්වත ප්‍රාන්තය | පල්ලම | ප්‍රපාතය | බෙයද | වලුක්කම | සෙල් | හෙල
precipitable=අවක්ෂේප්‍ය
precipitance=හදිසිය
precipitancy=හදිසිය
precipitant=අවක්ෂේපකය
precipitate=අපරීක්ෂාකාරී | අවක්ෂේප කරනවා | අවක්ෂේපය | ඉක්මණින් කිරීමට සලසනවා | ඉක්මන් | ඉක්මන් කරවනවා | ඉක්මනින් සිදුවීමට සලසනවා | ඉතා වේගවත්
precipitated=අවක්ෂිප්ත
precipitation=අධික ඉක්මන | අවක්ෂේපණය | අවක්ෂේපය | යටට බේරීම | වර්ෂණය
precipitator=අවක්ෂේපකරය
precipitous=අපරීක්ෂාකාරී | බොහෝ පල්ලම් සහිත | මහත් ඉක්මනින් කරනලද
precis=පිණ්ඩාර්ථය | සංක්ෂේපය | සාරය | සාරාංශය
precise=ඉතා නිවැරදි | නියත | නියමිත | නිර්දෝෂ | නිශ්චිත | නිසියුම් | නොවරදනා | යථාතථ්‍ය | යථාර්ථ | සම්පූර්ණයෙන් | සියුම්
precisely=නිවැරදිව | හරියටම
precision=තථ්‍යතාව | නියතාර්ථය | යතාතථ්‍යය | යථාතථ්‍ය | යථාතථ්‍යතාව | යථාතථ්‍යය | සම්පූර්ණයෙන්ම නිවැරදි බව | සුනම්‍යතාව | හරි බව
preclimax=පුරෝත්කර්ෂය
preclude=අවහිර කරනවා | කලින් වළක්වනවා | නිවාරණය කරනවා | පවතිනවා | ප්‍රාරම්භ වශයෙන් යොදනවා | ප්‍රාරම්භය | පූර්වලක්ෂණය | බාධා කරනවා
precocious=කලින් පැසුණු | ප්‍රපාක | පැහිච්ච | පූර්වපාක
precocity=අකලට පැසීම | ග්‍රගල්භතාව | ප්‍රපාකතාව | ප්‍රපාකය | පැහිච්චකම
precognition=කලින් දැන සිටීම | පූර්වඥානනය | පූර්වඥානය
preconceive=කලින් සිතා ගන්නවා
preconception=පූර්ව කල්පනාව | පූර්ව සංකල්පනය
precondition=අවශ්‍ය දේ | පූර්ව කොන්දේසිය | පූර්වාරෝපණය
preconscious=පූර්ව විඥානය
precursor=ප්‍රාක්චරයා | පුර්වගය | පුර්වගයා | පුරෝගාමියා | පුරෝධාවකය | පූර්වගය | පූර්වගයා | පූර්වනිමිත්ත
precursory=ප්‍රාරම්භ
predacious=ගොදුරු අල්ලා කන
predator=කොල්ලකාර කෘමියා | ගොදුරු අල්ලන සතා | විලෝපියා
predatory=කොල්ලකාර
predecease=කලින් මැරෙනවා
predecessor=කලින් සිටි නිලධාරියා | පුරෝගාමියා | පූර්වකය | පූර්වගාමියා
predestinate=කලින් නියම කරනවා
predestination=දෛවය | නියමය
predestine=කලින් නියම කරනවා
predetermine=කලින් නියම කරනවා | කලින් බේරාගන්නවා | පූර්ව නිර්ණයනය කරනවා | පූර්ව නිශ්චය කිරීම
predetermined=පූර්ව නිශ්වත
predicable=කලින් කීමට හැකි
predicament=අකරතැබ්බය | අමාරුව | අසීරු තත්ත්වය | තත්ත්වාකාරය | දුර්දසාව
predicant=ආගම ප්‍රචාරය කරන
predicate=ආඛ්‍යාතය | කියනලද්ද | කියාපානවා | පදාභිධේයය | ප්‍රකාශ කරනවා | විශේෂකය | සාධනය කරනවා
predication=අභිධානය
predicative=ක්‍රියාපදය පිළිබඳ වූ
predict=දිවස් කියනවා | පේන කියනවා
predictable=අනාවැකි කියහැකි | කලින් කීමට හැකි
prediction=අනාගත වාක්‍යය | අනාගතවාක්‍යය | අනාවැකි කියන්නා | අනාවැකිය | පුරෝකථනය | පුරෝකථිතය | පෙරැයීම
predictive=පුරෝකථ්‍ය | පුරෝකථ්‍යය
predictor=අනාවැකි කියන්නා | පුරෝකථකය | පුරෝකථකයා | පුරෝකථනය
predilection=අභිරුවය | බලවත් ළැදිකම
predispose=නමනවා | හැඩ ගසනවා | හුරු කරනවා | ළැදිකම ඇති කරනවා
predisposition=නැමීම | ප්‍රස්ථිතිය | ප්‍රාග්ප්‍රණතිය | හුරුබව | ළැදිකම
predissociation=ප්‍රාග්විඝටනය
predominance=ප්‍රබලතර බව | ප්‍රමුඛතර බව
predominant=අතිප්‍රමුඛ
predominat=ඉතා ප්‍රබල | මතුවී පෙනෙන
predominate=ප්‍රබලතම වෙනවා | ප්‍රමුඛතම වෙනවා | මතු වී පෙනෙනවා | විශේෂයෙන් බලපවත්වනවා
predominence=ප්‍රභූතතාව
predominent=ප්‍රභූත
preen=උඩඟු ලෙස හැසිරෙනවා | පිරිමදිනවා | සතුටු වෙනවා
prefabricate=කෘත්‍රිමව නිර්මාණය කරනවා
preface=ආමුඛය | ප්‍රස්තාවනාව | ප්‍රාරම්භ වශයෙන් දක්වනවා | පූර්විකාව | භූමිකාව | සංඥාපනය
prefactory=ආමුඛ
prefatory=ප්‍රාරම්භක
prefect=අධිපතියා | නායකයා | ශිෂ්‍ය නායකයා
prefecture=දිස්ත්‍රික්කය | ප්‍රාන්තය
prefer=ඉදිරිපත් කරනවා | වඩා කැමති වෙනවා
preferable=අභිරුවකර | වඩා සතුටුදායක | වඩා හොඳ
preference=අභිප්‍රේතය | අභිමතය | අභිරුවය | පක්ෂපාතභාවය | මනාපය | වරණය | වරණීය | වැඩි කැමැත්ත | වැඩි සැලකිල්ල
preferential=අනුග්‍රහපූර්වක | අභිප්‍රේත | පක්ෂපාතී | මනාප | වරණීය | වැඩි කැමැත්තක් දක්වන
preferment=උසස්වීම
prefertilization=ප්‍රාක්සංසේචනය
prefigure=උපකල්පනය කරනවා
prefix=උපසර්ගය | මුලට යොදනවා
prefloration=පරිවින්‍යාසය
prefoliation=ප්‍රාගංකුරණය
preform=කල් ඇතිව නිමවනවා
preformation=පුරානිර්මානය | පූර්ව නිර්මාණය
preformism=පුරානිර්මාණ වාදය
pregnable=පහර දියහැකි
pregnancy=ගර්භණිභාවය | ගර්භණී භාවය | ගර්භණීභාවය | ගැබ් ගැනීම | ගැබ් දැරීම | ගැබ් බව | ගැබ්දැරීම | ගැබ්බරවීම | දරුගැබ
pregnancy-longings=දොළදුක
pregnant=ගර්භණී | ගර්භනී | ගැබ්දැරි | ගැබිණි | බඩදරු | යමකින් පිරී ඇති
prehaustorium=ප්‍රාක්ශෝෂකය
preheater=පූර්ව තාපකය
prehensile=අල්ලා ගතහැකි | ග්‍රාහී | ග්‍රාහීය | පරිග්‍රාහී
prehension=ග්‍රහණය
prehistoric= ඉතා පුරාණ | ප්‍රාග් ඓතිහාසික | ප්‍රාගෛතිහාසික
preignition=පූර්ව ජ්වලනය
prejudge=අගතියට යනවා | කලින්ම නිගමනය කරනවා
prejudice=අගතිය | අවාසි පමුණුවනවා | අවිචාරක හැඟීම | පක්ෂපාතකම | ප්‍රාග් විනිශ්චය | ප්‍රාග්නිශ්චය | ප්‍රාග්විනිශ්චය | පූර්ව මතය | බාධාව | හානිය
prejudiced=අගතිගත
prejudicial=අගති ඇති කරන | අගතිකාරී | අගතිගාමී | අහිත | හානි ඇති කරන
prelacy=නායකහිමිගේ නිලය | නායකහිමිගේ පාලනය
prelate=නායක හිමි | ප්‍රධාන පූජක
preliminaries=ප්‍රාරම්භක
preliminary=පරිකර්ම | ප්‍රාථමික | ප්‍රාරම්භ | ප්‍රාරම්භක | ප්‍රාරම්භක කාර්යය | මූලික | මූලික කාර්යය
prelude=පූර්විකාව
premarital=පෙරවිවාහ | විවාහ ප්‍රාප්තතවීමට පෙර | විවාහයට පෙර
premature=අකල් | අකාල | අකාලයෙහි පැසුණු | අපරිණත | නොකල් | නොමේරූ | ප්‍රාග්පරිණත
prematurely=අමු අමුවේ
prematurity=අපරිණතබව
premedication=ශල්‍යකර්මයක් කිරීමට පෙර කෙරෙන වෛද්‍ය කටයුතු
premeditate=කලින් සැලසුම් කරනවා
premeditated=පූර්වමර්ශිත
premeditation=කලින් සැලසුම් කරන ලද දේ | පූර්වමර්ශනය | හිතාමැතීම
premenstrual=ඔසප් වීමට ආසන්නව
premier=අගමැති | අග්‍ර | අග්‍රාමාත්‍යයා | පළමුමැති | ප්‍රමුඛ | මහාමාත්‍යයා
premiere=නාට්‍යයක මංගල දර්ශනය | ප්‍රථම දර්ශනය
premine=අත්‍යත්තම
premise=අවයවය | උදාහරණය | උපනය | තර්කාංගය | ප්‍රතිඥාව | පූර්වායවයක් ඉදිරිපත් කරනවා | පූර්වාවයවය | සාධ්‍යය
premises=පරිශ්‍රය | භූමිය
premiss=පූර්වාවයවය
premium=අධිමිල | ආධික්‍යය | ත්‍යාගය | පාරිතෝෂිකය | වාරිකය
premodulation=පූර්ව මූර්ඡනය
premolar=පූරශ්චාර්වක | මුඛයෙහි ඉදිරියේ ඇති දත්
premonition=අනාදැනුම | අශුභ නිමිත්ත | පූර්වසංඥාව | පූර්වාවවාදය
premonitory=අශුභදායක
premula=සදාහරිත ශාකයක්
prenatal=ප්‍රාග්ප්‍රසව | බිහිවීමට පළමු
prenubile=ප්‍රාග් පරිපාක
preoccupation=පූර්වනියුක්තිය | සිත යොමුවී තිබීම
preoccupied=කල්පනාවෙහි ගැලුණු | වන්තාපර | වෙන දේක යෙදුණු
preoccupy=කලින් ව්‍යාපෘත කරනවා | යොදවනවා
preordain=කලින් නියම කරනවා
prep.=පාඩමට සූදානම් වීම | මූලික
preparation=පිළියෙල කළ දේ | ලකලෑස්ති | ලැහැස්තිය | ලෑස්තිය | සම්මිශ්‍රණය | සැකසීම | සූදානම | සූදානම් වීම
preparative=ප්‍රාරම්භ | මූලික | සූදානම් වශයෙන් කරන
preparatory=ප්‍රාරම්භ | මූලික | සූදානම් වශයෙන් කරන
prepare=අර අඳිනවා | පෙරුම් පුරනවා | පේකරනවා | වඩනවා | සූදානම් කරනවා | සූදානම් වෙනවා
prepared=ප්‍රකෘත
prepay=කලින් ගෙවනවා | පෙරගෙවනවා
prepayment=කලින් ගෙවීම
prepense=පූර්ව චේතනාව | හිතාමතාම කරන ලද
preperception=ප්‍රාග් සංජානනය
preponderance=අතිභාරය | අධිකත්වය
preponderant=අතිවිශාල | බොහෝ වැඩි
preponderate=ප්‍රමාණයෙන් අධිකව පවතිනවා | බලයෙන් අධිකව පවතිනවා | වැදගත්කමින් අධිකව පවතිනවා
preposition=නිපා | නිපාත | නිපාතය
prepositional=නිපාතමය
prepossess=ඇද ගන්නවා | කලින් අල්ලා ගන්නවා
prepossessing=මනෝහර | සිත් ගන්නා
prepossession=පක්ෂපාතීභාවය | පූර්වාදානය
preposterous=ඉතා අඥාන | විකාර | විපරීත | සාහසික
prepotence=අබිබෙලය | ප්‍රාග්විභවය
prepotency=අබිබෙලය | ප්‍රාග්විභවතාව
prepre=යොදනවා
prepuce=ප්‍රපූටිය
prerelease=පෙර මිදුම
prerequisite=අවශ්‍ය
prerogative=පරමාධිකාරය
presage=අශුභ නිමිති පෙනෙනවා | පූර්වලක්ෂණය
presbyopia=වෘද්ධ දෘෂ්ටිකතාව | වෘද්ධ දෘෂ්ටිය | හතලිස් ඇඳිරිය | හතළිස් ඇඳිරිය
presbyter=වෘද්ධයා
prescience=පූර්වඥානය
prescient=අනාගතඥානය ඇති
prescribe=කාලාවරෝධය කරනවා | නියම කරනවා | නිර්දේශ කරනවා | ප්‍රලේඛ
prescribed=නියමිත | නිර්දිෂ්ට
prescript=ආඥාව | නියෝගය
prescription=ඖෂධයෝගය | කාලාපගමනය | කාලාවරෝදය | කාලාවරෝධය | නියම කිරීම | නියමය | නියෝගය | ප්‍රලේඛණය | බෙහෙත් වට්ටෝරුව
prescriptive=අණ දෙන | කාලවරෝධී | නීති පනවන | විධායක
presect=ප්‍රකණ්ඩනය
preselection=පෙර තේරීම | පෙරවරණය
preselector=ප්‍රාග්වරකය | පෙර තෝරනය
presence=අබියස | අභිමුඛව | ඇති බව | ඉදිරිපස | ඉදිරියෙහි පෙනී සිටීම | ඉදිරියේ | තිබීම | පවත්නා ප්‍රමාණය | පැමිණීම | රූපාකාරය | සමුව | හමු | හැඩහුරුකම | හොඳ පෙනීම
present=අද්‍යතන | අඳුන්වා දෙනවා | අභිමුඛ | ඇති | ඉදිරිපත් කරනවා | ඉදිරියෙහි පෙනී සිටින | ඔප්පු කරනවා | ගෙනහැර දක්වනවා | තත්කාලය | ත්‍යාගය | තෑග්ග | තෑගි කරනවා | තිළිණය | තුටු පජුර | තුවක්කුවක් එල්ල කරනවා | දැකුම | දැන් | දැන් පවත්නා | දීමන | දීමනාව | නොවරදින | පජර | පජුර | පමුණුවනවා | පවත්නා | ප්‍රචර්වතන | ප්‍රත්‍යත්පන්න | ප්‍රදර්ශනය කරනවා | ප්‍රස්තුත | පානවා | පැමිණි | පිළිගන්වනවා | පුදනවා | වත්මන් | වර්තමාන | වර්තමාන කාලය | වර්තමානය | විද්‍යාමාන | වෙත පමුණුවනවා
presentable=ඉදිරිපත් කිරීමට යෝග්‍ය | ඉදිරිපත් වීමට සුදුසු | ප්‍රදානය කිරීමට සුදුසු
presentation=අර්පණය | ඉදිරිපත් කිරීම | ඔප්පු කිරීම | ගෙනහැර දැක්වීම | තෑග්ග | තෑගි ප්‍රදානය කිරීම | දර්ශනය | දීමනාව | ප්‍රතිපාදනය | ප්‍රදර්ශනය | ප්‍රදානය | පිළිගැන්වීම | රචනා විලාසය
presentation-copy=තෑගි දීමට විශේෂයෙන් පිළියෙල කරන ලද පොතේ පිට
presentationalism=ප්‍රතිපාදනවාදය
presentationism=ප්‍රතිපාදන වාදය
presenter=ඉදිරිපත් කරන්නා
presentiment=අනා හැඟුම | අශුභ නිමිත්ත | පූර්වසංඥාව
presently=තව ටික වේලාවකින් | දැනට | දැන්
presentment=ඉදිරිපත් කිරීම
presents=පාක්කුඩම් | පුද සලක්කම් | සතුටු පඬුරු | සලක්කම්
preservation=ආරක්ෂණය | ආරක්ෂාව | පරීරක්ෂණය | ප්‍රරක්ෂණය | සංරක්ෂණය
preservative=ආරක්ෂක | ආරක්ෂකය | පරිරක්ෂක | සංරක්ෂකය | සංරක්ෂණ | සංරක්ෂණ ද්‍රව්‍යය | සුරක්ෂකය
preserve=අභයභූමිය | ආරක්ෂණය කරනවා | ආරක්ෂා කරනවා | පරෙස්සම් කරනවා | පවත්වා ගන්නවා | රක්ෂිත පළතුරු | රක්ෂිත වනය | රකිනවා | සංරක්ෂණය කරනවා
preside=මුලසුන දරනවා | මූලාසනය ගන්නවා
presidency=ජනපදය | ජනාධිපතිකම | ජනාධිපතිගේ පාලන කාලය | පාලන ප්‍රදේශය
president=ජනපති | ජනාධිපති | රාෂ්ට්‍රපති | ශ්‍රෙෂ්ඨාධිපති | සභාපති
presidential=ජනාධිපති පිළිබඳ වූ | සභාපති පිළිබඳ වූ
presidium=කොමියුනිස්ට් සංවිධානයක කොමිටිය | පරිපාලන විධායක සභාව
presody=ඡන්දස් ශාස්ත්‍රය
press=ඇඳුම් මදින යන්ත්‍රය | එබීම | එබෙනවා | ඔබනවා | තද කරනවා | තද කිරීම | තද වෙනවා | තදකරනවා | තදින් වැළඳගන්නවා | තල්ලු කරනවා | තෙරපනවා | පහරුව | ප්‍රවෘත්තිකාර | පීඩකය | පුවත්පත් | පුවතාන | බල කරනවා | බලෙන් දෙනවා | මට්ටම්කරනවා | මිරිකන යන්ත්‍රය | මිරිකනවා | මුද්‍රකය | මුද්‍රණ යන්ත්‍රය | මුද්‍රණාලය | යත | රාක්කිය | රැස් කන පිරිස | වෙහෙස | ඹ්නෑකමින් කියා සිටිනවා
press-cutting=පත්‍රයෙන් කපා ගත් ලිපිය
presser=තෙරපනය
pressing=කුට්ටනය | බලගතු | හදිසි
pressure=අමාරුව | තදවීම | තෙරපීම | තෙරපුම | පීඩන | පීඩනය | බර | බරපතළකම | බලගතුකම | බලපෑම | බලය | වේගය | සම්පීඩනය
pressures=පීඩන | බලපෑම්
pressurize=පීඩනයට ලක් කරනවා
prestation=පැවරීම
presternum=ප්‍රාග් ක්‍රෝඩකය
prestidigitation=අංගුලි මායාව | ඉන්ද්‍රජාලය
prestidigitator=ඉන්ද්‍රජාලිකයා
prestige=කීර්තිය | ගරුත්වය | ගෞරවය | නම්බුව | හොඳ නම
prestigious=ගෞරවාන්විත | නම ගත්
presto=වහාම මේ බලන්න | වහාම මේ බලන්න
prestressing=පෙරැදීම
presumable=පූර්වානුමේය කළහැකි
presumably=අනුමාන වශයෙන් | සිතෙන හැටියට
presume=අනුමාන කරනවා | පූර්වානුමානය කරනවා | පූර්වානුමේය කරනවා | සිතා ගන්නවා
presumption=අනුමානය | අහංකාරය | කල්පනාව | ගර්වය | ප්‍රගල්භතාව | පූර්ව නිගමනය | පූර්වනිගමනය | පූර්වානුමිතිය | පූර්වානුමේය | විශ්වාසය | සිතිවිල්ල
presumptive=අනුමාන | පූර්වානුමේයී | විශ්වාස කළ හැකි
presumptuous=ආඩම්බර | ප්‍රගල්භ | බිය සැක නැති | ඹ්නෑවට වැඩි
presuppose=පූර්වකල්පනය | හැඟෙනවා
presupposition=ආකල්පනය
pretence=අයිතිවාසිකම් කියා පෑම | ඉච්චාව | කෞටිකරූපණය | බොරුවට ඇඟවීම | රැවටිල්ල | ව්‍යාජය | ව්‍යාදේශනය
pretend=කෞටිකරූපණය | බොරු කරනවා | බොරුවට අඟවනවා | බොරුවට පෙනී සිටිනවා | ව්‍යාජනය | ව්‍යාදේශනය කරනවා | විමූඩ වෙනවා | සෙල්ලමට අඟවනවා
pretender=බොරුකාරයා
pretension=කියාපාන දේ | බොරු සාමර්ථය | ව්‍යාජය
pretentious=අයුතු උසස්කම් දක්වන | නොමනා උඩඟුකම් ඇති | පෙනීමෙන් විශාල වූ | බොරු උසස්කම් දක්වන | ව්‍යාජක
preter=ඉක්මවා සිටින
preter-natural=අද්භූතකාලික | ස්වභාවධර්මය ඉක්මවා සිටින
preterite=භූතකාලික | යටගියාව කියන
pretext=බොරු හේතුව | රැවටිල්ල | ව්‍යාජය
pretreated=පෙරපිරියම් කැරුණු
prettily=ශෝභන ලෙස
pretty=කදිම | තරමක් | මනස්කාන්ත | යස | රම්‍ය | ලක්ෂණ | වත්තාකර්ෂණීය | සුරුබුහුටි | හුඟක්
preturned=කලින් සුසර කළ
pretzel=විස්කෝතු විශේෂයක්
prevail=දිනනවා | පැතිර පවතිනවා
prevailing=පැතිර පවත්නා
prevailling=පිළිගත් | ව්‍යාප්තව පවත්නා
prevalence=පැතිර පැවතීම | පැවැත්ම | ව්‍යාප්තිය
prevalent=පිළිගත් | බහුල | ව්‍යාප්ත | සාමාන්‍ය
prevaricate=කරුණු වසන් කරනවා
prevarication=වසන්කිරීම | සැඟැවිවාක්‍යය
prevent=ඉදිරියෙහි යනවා | නිවාරණය කරනවා | බාධා කරනවා | වළකනවා | වළක්වනවා
preventative=නිවාරක | බාධක
prevention=නිවාරණය | වැළැක්වීම
preventive=නිවාරක | නිවාරණ ඖෂධය | වළක්වන | වැළකීමට යොදන උපාය
prevernal=පුර්වවසන්ත
preview=පූර්වදර්ශනය | පෙරහුරුව
previous=ඉස්සර | කලබල | කලින් | කලින් වූ | නියමිත කාලයට මත්තෙන් | නොඉවසිලිවන්ත | පුරා | පූර්ව | පෙර | සුදුසු කාලයට මත්තෙන්
previously=ඉස්සර | ඉස්සරියෙන් | කලින් | පෙරාතුව
prevision=අනා දැක්ම
prevoke=කිපෙනවා
prey=අල්ලා කනවා | කොල්ල කනවා | කොල්ලය | ගොදුර | ගොදුරු | බලිය
price=අගය | ගණන | ගාස්තුව | තක්සේරු කරනවා | ප්‍රතිඵලය | මිල | මිල නියම කරනවා | වටිනාකම
price-ceiling=උඩත් මිල සීමාව
price-marked=මිල ලකුණු කළ
price-rclative=මිල සාපේක්ෂකය
price.net=ශුද්ධ මිල
priceless=අනගි | අමිල | ඉතා අනර්ඝ | මිල නොකළැකි
pricey=මිල අධික
pricing=මිල නියම කිරීම | මිලකරණය | මිලයනය
prick=ඇනෙනවා | කටුව | කුත්තු කරනවා | තුඩ | පීඩා කරනවා | රිදවනවා | රිදෙනවා | විදිනවා | වේදනාව | හිල
pricker=තව් කටුව | තව් කූර | විදින කටුව
prickle=කටුව | කණ්ට | කණ්ටක | කූර | තුණ්ඩය | දැත්ත | දිගකටුව
prickly=කටු සහිත | කූරු සහිත | තුණ්ඩිල | දැති සහිත
pricleless=අමූල්‍ය
pride=අබිමන් | අභිමානය | අභිමානයට හේතුව | අහංකාරය | ආඩම්බරය | උඬඟුකම | ගර්වය | දප | දර්පය | මද | මදය | මන් | මමංකාරය | මහත් සතුටට කරුණ | මානය | මාන්න | මෝස්තරය | වට්ටඩිකකම
prie-dieu=යාඥාවේදී දණගසන බංකුව
priest=ප්‍රව්‍රජීත | පැවිද්දා | පූජකයා | ශ්‍රමණයා
priest-craft=ස්වකීය බලතල තහවුරු කර ගැනීමට පූජකයන් යොදන උපා
priestess=පූජකවරිය
priesthood=පැවිද්ද | පූජක තනතුර | පූජක සංහතිය | පූජකත්වය | පූජකභාවය | පූජකවරය | මහණකම | ශ්‍රමණ සමූහයා | සංඝයා
priestly=පැවිද්දන්ට සුදුසු | පැවිදි | පූජක
priethood=පැවිදිබව
prig=සිල්වත්කම පෙන්වන්නා | හොරා
priggish=සිල්වත් බව පෙන්වන
prim=කලේලි ඇති
primacord=ප්‍රස්ඵෝටන විලායකය
primacy=ප්‍රථමතාව | ශ්‍රෙෂ්ඨත්වය
primage=ප්‍රිමේජ් ගාස්තුව
primal=ආදිකල්පික | ආදිම | ආදිමය | මූලික
primary=පළමු | ප්‍රධාන | ප්‍රමුඛ | ප්‍රාථමික | ප්‍රාථමිකය | ප්‍රාරම්භ | මුලික | මූලක | මූලික
primary-group=ප්‍රාථමික සමූහය
primate=අග්‍රරාජගුරු ප්‍රසාදිතැන
primates=අග්‍රේෂයේ | ප්‍රිමාටේෂ් | ප්‍රිමාටේස්
prime=අග්‍ර | අවශ්‍ය තොරතුරු සපයනවා | උත්තම අවස්ථාව | ප්‍රථමක | ප්‍රථමකය | ප්‍රථමය | ප්‍රධාන | ප්‍රාථමික | පුරනවා | මූල | මූලික | ශ්‍රෙෂ්ඨ
primer=පළමුවැනි පාඩම් පොත | ප්‍රථමකය | ප්‍රාථමිකය | මුල් පොත | සෝඩි පොත | හෝඩි පොත
primeval=අතිපුරාණ | ආද්‍යු | ආදි කල්පික | ආදිතම | ප්‍රාථමික | පුරාකාලායත්ත
primigravida=ප්‍රථම ගර්භිණිය
priming=ප්‍රථමාලේපය | පිරීම | වෙඩි බෙහෙත්
primipara=ඒකවිජාතාව
primitive=අතිපුරාණ | අශෝභන | ආද්‍යු | ආද්‍යුය | ආදි | ආදි තාලේ වූ | ආදිකල්පික | ආදී | චාන් | ප්‍රකෘති | ප්‍රථමතම | ප්‍රාක්තම | ප්‍රාග්තන | මූලික
primitivism=ප්‍රථමාවස්ථාවාදය | ප්‍රාග්තන වාදය
primodial=මූලාකෘතික | මූලාවස්ථිත
primodium=මූලාකෘතිය | මොලය
primogeniture=කුලුඳුල්කම | දෙටු පිළිවෙත | ප්‍රථමජන්මාධිකාරය | පූර්වජත්වය
primordia=මුලාකෘති
primordial=ආදිකල්පික | ආදිම | ප්‍රථමාරම්භ | මුලාවස්ථික | මූලාවස්ථික
primordium=මුලාකෘතිය | මෞලය | මෞලිකය
primp=ජේත්තු වෙනවා | පීරා සකස්කරනවා
primus=පළමුවෙනි | ප්‍රථම
prince=අධිපතියා | කුමාරයා | රජ | ශ්‍රෙෂ්ඨයා
princeling=කුමාරපෝතකයා | පැටියා
princely=උත්කර්ෂවත් | ධනවත් | බොහෝ ඓශ්චර්යයෙන් යුත් | රාජකීය
princess=කුමාරිකාව | කුමාරිය
principal=අධ්‍යක්ෂක | නියෝජක | ප්‍රධාන | ප්‍රධාන පරාළය | ප්‍රධාන බාල්කය | ප්‍රධානයා | ප්‍රධානියා | ප්‍රමුඛ | ප්‍රාග්ධනය | මුදල් හිමියා | මුල් මුදල | මූලධනය | විද්‍යාලයාධිපති | විදුහල්පති | වියෝජක
principality=රාජ්‍යය
principals=මූලප්පරාල
principia=ප්‍රින්සිපියාව
principle=තත්ත්වය | නියමය | ප්‍රතිපත්තිය | භාගය | මූල ධර්මය | මූලධර්මය | සිදත | සිදත්
principled=ප්‍රතිපත්ති ඇති
principles=මූලධර්ම
prink=ජේත්තු කරනවා
print=අච්චු ගසනවා | අච්චුගසනවා | පිටපත | මුද්‍රණය | මුද්‍රණය කරනවා | මුද්‍රිත අකුර | මුද්‍රිත අකුරු | මුද්‍රිත ඡායාරූපය | මුද්‍රිතය | ලකුණු කරනවා | ලාංඡනය | ලොකු අකුරෙන් ලියනවා | හර පාව
printed=මුද්‍රිත
printer=මුද්‍රකය | මුද්‍රණ යන්ත්‍රය | මුද්‍රණ ශිල්පියා | මුද්‍රණකරුවා
printing=මුද්‍රණ | මුද්‍රණය | මුද්‍රණය කිරීම
printmaker=මුද්‍රණකාර
printmaking=මුද්‍රණකරණය
printout=මුද්‍රිතය
prior=ඉස්සර | දෙවන දේවගැති | පූර්ව
prioress=කන්‍යාරාමයේ නායිකාව
priorities=ප්‍රමුඛතා
priority=ප්‍රමුඛත්වය | ප්‍රමුඛතාව | පූර්වතාව
prioriy=ප්‍රමුඛතාව
priory=තාපසාරාමය
prise=විවෘත කරනවා
prisere=ප්‍රාක්සංශ්‍රේණිය
prising=ආ ලෑම
prism=ත්‍රිපාර්ශ්වය | ප්‍රිස්මය
prism-shaped=ප්‍රිස්මාකාර
prismatic=ප්‍රිස්ම හැඩේ ඇති | ප්‍රිස්මාකාර
prismatoid=ප්‍රිස්මකාභය
prismoid=ප්‍රිස්මාභය
prison=කරගෙය | දඟ | දඟ ගේ | දඟගෙය | බන්ධනාගාරය | සිපිරිගෙය | සිර | සිරගෙදර | සිරගෙය | හිර | හිරගෙදර | හිරගෙය | හිරගේ
prisoner=සිරකරු | සිරකරුවා | සිරකාරයා | හිරකරු | හිරකාරයා | හිරකාරිය
prissy=සබකෝලය ඇති
pristine=ආදි | නොකිලිටි | පුරාතන | වෙනස් නොවූ
prithee=පින් සිද්ද වෙයි
privacy=අප්‍රසිද්ධිය | පුද්ගලික නිදහස | පෞද්ගලිකත්වය | රහසිගත වූ විවේකස්ථානය | විවේකය
private=අප්‍රසිද්ධ | පුද්ගලික | පොදු නොවූ | පෞද්ගලික | භටයා | රහස් | රහසිගත
privateer=පෞද්ගලික සටන් නැව | මුහුදුකොල්ල නැවේ කපිතාන්
privately=රහසින්
privates=රහස් අංග
privation=අගහිඟකම | ආපදාව | ඌනතාව | නැතිකම | හානිය | හිඟය
privative=අභාවය දැක්වෙන | නිෂේධාත්මක | වියෝගය
privatize=පෞද්ගලිකකරණය කරනවා
privet=පැළෑටි වර්ගයක්
privies=පෙරෙවීහු
privilege=ගෞරවය | නිදහස | බලපුළුවන්කම | වරපසාදය | වරප්‍රසාදය | විශේෂ අයිතිවාසිකම | විශේෂ අයිතිවාසිකම් තාන්න මාන්න ආදිය පවරා දෙනව
privileged=වරප්‍රසාද භුක්ති විදින
privity=පෙරෙවිතාව | පෙරෙවියාව | රහස් දැන සිටීම
privy=අතුගේ | ගුප්ත | පුද්ගලික | පෙරෙවි | පෙරෙවියා | රහස් | වැසිකිළිය
prize=අගනා | අමාරුවෙන් අරිනවා | ඉස්තරම් | උත්තම වස්තුව | උසස් | කොල්ලය | ත්‍යාගය | ත්‍යාගශීලි | තෑගි ලැබූ | දිනුම | නොම්මර එකේ | බලෙන් අරිනවා | මෝඩ | විවෘත කරනවා
pro=ප්‍ර
pro-chancellor=නියෝජ්‍ය කුලපති
pro-consul=පූර්ව කොන්සලය
pro-forma=නාම මාත්‍ර
pro-natalist=ජනන පාක්ෂික | ජනන පාක්ෂිකයා
pro-note=පොරොන්දු නෝට්ටුව
pro-rata=අනුපාතික අනුව | ආනුපාතව | ආනුපාතික | ප්‍රමාණානුකූල
pro.tem.=තාවකාලිකව | මෙම කාලයට පමණක්
proangiosperm=ප්‍රාගාවෘතබීජකය
proangiospermy=ප්‍රාගාවෘතබීජකතාව
proanthesis=අකාලපුෂ්පනය
probability=සම්භව්‍යතාව | සම්භාව්‍යතාව | සම්භාව්‍යතාවය | සම්භාවිතාව
probability-integral=සම්භාවිතා අනුකලය
probable=ඇත්ත මෙන් පෙනෙන | වියහැකි | සම්භව්‍ය | සම්භාවී | සසම්භාවී
probably=පෙනෙන හැටියට | සිතෙන හැටියට
probate=කෙනෙකුගේ ගතිගුණ | පරිවාසය | ප්‍රොබේට් | ප්‍රොබේට් බලපත්‍රය | ප්‍රොබේත්තුව
probation=ආධුනිකත්වය | ඒෂණය | කෙනෙකුගේ ගතිගුණ | පරිවාසය
probationary=ඒෂණශීලී | පරිවාස | පරීක්ෂණාත්මක
probationer=ආධුනිකයා | පරිවාසිකයා | පරීක්ෂණ පිට සිටින්නා
probative=ඒෂණීය | ඔප්පු කළ හැකි
probator=ඔප්පුකරන්නා
probe=ඒෂණය කරනවා | ඒෂණය කිරීම | ඒෂණිය | වග විභාගය | විමසනවා | සොයා විමසනවා
probing=ඒෂණය
probit=සම්භාවිකය
probity=අවංකකම | ඒෂණීයත්වය | විශ්වාස කටහැකි බව | විශ්වාසනීත්වය | ස්ථීරසාරභාවය
problem=කෘත්‍යය | ගැටඵව | ගැටලුව | දුෂ්කර කාරණය | පටලැවිල්ල | ප්‍රශ්නය | විසඳීමට ඇති ප්‍රශ්නය
problematic=ගැටලු සහගත | ගැටලු සහිත | විසඳිය යුතු | සැක සහිත
problematical=විසඳිය යුතු | සැක සහිත
proboscis=ප්‍රපෝෂකය | හොඬවැල
procambium=ප්‍රාක්කැම්බියම | ප්‍රාග්භාජකය
procarp=ප්‍රාගණ්ඩපය
procedural=පටිපාටීය | පරිපාටීය
procedure=ක්‍රියා පරිපාටිය | ක්‍රියා පිළිවෙළ | ක්‍රියා මාර්ගය | ක්‍රියාපටිපාටිය | ක්‍රියාපරිපාටිය | ක්‍රියාමාර්ගය | ක්‍රියාව | කාර්ය පටිපාටිය | පටිපාටිය | පටිපාටීය | පරිපාටිය | පරිපාටීය | පිළිවෙත | පිළිවෙළ | හැසිරීම
proceed=ආරම්භ කරනවා | ආරම්භ වෙනවා | ඉදිරියට යනවා | ඉස්සර බලනවා | කරගෙන යනවා | ක්‍රියා කරනවා | කියාගෙන යනවා | ගෙන යනවා | නිකුත් වෙනවා | පවතිනවා | ප්‍රගමනය | වඩිනවා
proceeding=ක්‍රියාව | පටිපාටිකරය | පරිපාටිකරය
proceedings=උසාවියක කටයුතු | උසාවියක වාර්තාව | කාර්යවාර්තාව | වාර්තා සටහන් | සභා රැස්වීමක කටයුතු | සභා රැස්වීමක වාර්තාව
proceeds=උත්පාදන | ලත් මුදල | ලබන මුදල | ලබන මුදල්
procerus=ප්‍රසාරකය
process=ඇණවුම්කරය | ක්‍රමය | ක්‍රියා සන්තතිය | ක්‍රියායනය | ක්‍රියාවලිය | කාර්ය ක්‍රමය | කාර්යක්‍රමය | කාර්යාවලිය | කැඳවීම් නියෝගය | ප්‍රසරය | පැසුරුම | පිළිවෙළින් සිදුවීම | විධිය | සන්තතිය
process-server=සිතාසි බාරදෙන තැනැත්තා
processing=ප්‍රක්‍රියනය | පැසිරීම | පැසුරුම | පිරිසැකසුම | පිරිසැකසුම්කරණය | සකස් කිරීම | සැකසීම | සැකසුම
procession=දිග පේළිය | පෙරහර | පෙරහැර | පේළි යෑම
processional=පෙරහැර පිළිබඳ | පෙරහැරක් වැනි
processor=සකසනය | සැකසීමේ හැකියාව ඇති යන්ත්‍රය
processor-array=අරා සකසනය
prochromatin=ප්‍රෝක්‍රොමටින්
prochronism=පූර්වත්වාරෝපණය
procidentia=විස්‍රංසය
proclaim=අස්වනවා | නිවේදනය කරනවා | ප්‍රකාශ කරනවා | ප්‍රකාශනය කරනවා | ප්‍රසිද්ධ කරනවා | හෙළි කරනවා
proclamation=කියමන | දැන්වීම | නිවේදනය | ප්‍රකාශ පත්‍රය | ප්‍රකාශනය | ප්‍රකාශය
proclivity=ඇල්ම | නැමීම
proconsul=ආණ්ඩුකාරයා | ප්‍රදේශ රාජයා
proconsular=ආණ්ඩුකාරයා හා සම්බන්ධ
procrastinate=අතපසු කරනවා
procrastination=අතපසු කිරීම | කල්දැමීම | ප්‍රමාද කරවීම
procreate=උපදවනවා | ජාතක කරනවා
procreation=ප්‍රජනනය
procrustean=ප්‍රචණ්ඩ ක්‍රියාවලින් සමානාත්මතාව ලැබීමට උත්සාහ කරන
proctor=නීතිඥයා | පෙරකදෝරු | පෙරකදෝරු තැන | විනය පාලකයා | විභාග පරීක්ෂක
procumbent=උරග | බිමදුවන | වැතුරුණු
procupine=සලල
procuration=අන්‍යකාරකත්වය | කුට්ටනය
procurator=නඩු පවරන්නා | නියෝජිතයා | බලකාරයා
procurator-fiscal=ප්‍රොකියුරේටර් පිස්කල්
procurator-general=ප්‍රොකියුරේටර ජනරාල්
procure=අත්කර ගන්නවා | උත්සාහයෙන් ලබාගන්නවා | ලබාදෙනවා | සපයනවා | සපයාගන්නවා | සපයාදෙනවා | සලසනවා
procurement=ප්‍රතිසම්පාදනය | සම්පාදනය
procurer=කුට්ටනියා | වේශ්‍යාවන් ලබාදෙන්නා | සපයන්නා
procuress=කුට්ටනී
procurist=කුට්ටානිය | පිම්පියා
prod=පොළඹනවා | හර දත
prodeedings=කටයුතු වාර්තාව
prodigal=අපතේ යවන | ඉතා නිර්ලෝභී | නාස්ති කරන | නාස්තිකාර | නාස්තිකාරයා
prodigality=අපතේ යැවීම | නාස්තිය | පමණ ඉක්මවීම
prodigious=අතිවිශාල | ආශ්චර්ය
prodigy=අද්භූත දේ | අරුම වූ දේ | අස්වාභාවික වස්තුව | ආශ්චර්ය ගුණ ඇත්තා | ආශ්චර්යය | ප්‍රවිඥයා
prodrome=පූර්වලක්ෂණ
prodromus=පුර්වකෘතිය
produce=අස්වැන්න | ඇති කරනවා | උපදවනවා | උපදින දේ | දික් කරනවා | නිපදවනවා | නිෂ්පාදන | නිෂ්පාදනය | නිෂ්පාදනය කරනවා | නිෂ්පාදිතය | පමුණුවනවා | පලදාව | පෙන්වනවා | භවබෝග | සලසනවා | සාදනවා
produced=ප්‍රභූත
producer=නිපදවන්නා | නිශ්පාදකයා | නිෂ්පාදක | නිෂ්පාදකයා | ප්‍රයෝජක | වායු ජනකය
producing=උත්පාදනය
product=උපදවන ලද දේ | ගුණිතය | නිෂ්පාදනය | නිෂ්පාදිත | නිෂ්පාදිතය | ඵලය | විපාකය | ස්වභාවිකව හටගත් දේ
production=ඉදිරිපත් කිරීම | උත්පාදනය | උපනයනය | ගෙනහැර දක්වනලද දේ | ගෙනහැර දැක්වීම | නිෂ්පත්තිය | නිෂ්පාදනය | ප්‍රදර්ශනය | ප්‍රයුංජනය
production-goods=නිෂ්පාදන භාණ්ඩ
productive=උත්පාදක | නිෂ්පාදක | පලජනක | පලදායී | ඵලදායී | ලාභ උපදවන | සශ්‍රීක | සාධක | සාරවත්
productivity=නිපදවීමේ හැකියාව | නිෂ්පාදකතාව | නිෂ්පාද්‍යුතාව | පලදායිතාව | පලදාව | ඵලදායකත්වය | ඵලදායකතාව | ඵලදායිතාව | ඵලදාව | ඵලදාවර්ධනය
products=නිපැයුම් | නිෂ්පාදිතයෝ
proem=උපන්‍යාසය | ප්‍රාරම්භ වාක්‍යය | පෙරවදන
proembryo=ප්‍රාක්කලලය
proembryonic=ප්‍රාක්කලල
proenzyme=ප්‍රොඑන්සයිම්
profanation=කෙලසීම
profane=ආගම පිළිබඳ නොවූ | ආගම් විරෝධි | කෙළෙසනවා | දුෂ්ට | දූෂණය කරනවා | දේවාපහාසකාරී | ධර්මඥානයක් නැති | ධර්මය පිළිබඳ නොවූ | මිථ්‍යාදෘෂ්ටික | ලෞකික | සාමාන්‍ය
profaneness=දේවාපහාසකාරිත්වය
profanity=කෙලෙසීම | දේවාපහාසය
profer=ඉදිරිපත් කරනවා
proferment=සයිමොජන්
profess=කියා සිටිනවා | පළ කරනවා | ප්‍රකාශ කරනවා | ප්‍රසිද්ධියේ කියනවා | රක්ෂාවක් වශයෙන් කරනවා
professed=කියා සිටි
professedly=කියන හැටියට නම්
profession=ප්‍රකාශය | වෘත්තිය | වෘත්තීය
professional=රක්ෂාව පිළිබඳ වූ | විවිධ ව්‍යාපාරයන්හි යෙදුණු | වෘත්තිකයා | වෘත්තිමය | වෘත්තියමය | වෘත්තීය | වෘත්තීයවේදී
professionalism=වෘත්තීය දක්ෂකම
professionals=වෘත්තීයවේදියෝ
professor=මහ ඇදුරු | මහාචාර්ය
professorial=මහාචාර්ය ධූරය සම්බන්ධ
professoriate=සරසවියක මහාචාර්යවරු
professorship=මහාචාර්ය ධූරය
proffer=ඉදිරිපත් කරනවා | ඉදිරිපත් කිරීම
proficiencies=ප්‍රවීණතා
proficiency=ප්‍රවීණත්වය | ප්‍රවීණතාව | ප්‍රවීනතාව
proficient=දක්ෂ | විශේෂයෙන් සමර්ථ
profile=අංශවත්‍රය | ආකෘතිය | පැති කඩ | පැති පෙනුම | පැතිකඩ | පැතිපෙනුම | මනෝරේඛය
profiling=කටු හැඩයම් ලෑම | හැඩහුරු කැපීම
profit=ප්‍රයෝජනය | ප්‍රයෝජනයක් ලබා ගන්නවා | ප්‍රයෝජනයක් ලබා දෙනවා | යහපත සලසනවා | යහපත සැලසෙනවා | ලාබය | ලාභ ලබනවා | ලාභය
profitability=වාසිදායක
profitable=අර්ථසාධක | ප්‍රයෝජනවත් | ලාභ උපදින | ලාභී
profiteer=අධික ලාභ උපයන්නා | අයුතු ලාභ ලබනවා | අයුතු ලාභ ලබන්නා | ගිනි කන වෙළෙන්දා | ජාවාරම්කරු
profiteering=අයුතු ලාභ ගැනීම | අයුතුලාභ ගැනීම | ගිනි කැම | ජාවාරම
profiterole=මැද සිදුරක් ඇති ප්‍රණීත කේක් විශේෂයක්
profits=ලාභ | ශුද්ධ ලාභ
proflavine=පොප්ලේවින්
profligacy=අශීලාචාරකම
profligate=අනාචාරයෙහි යෙදුණු | කිසි විභාගයක් නැති | දුරාචාර
profound=අධික | ගැඹුරු | දුරවබෝධ | විචක්ෂණ | හෘදයංගම
profundity=අධිකත්වය | ගාම්භීර්යය | ගැඹුර
profuse=අත්‍යධික | ගලායන | නොමසුරු | නොසෑහෙන සේ වූ | බහුල
profusion=අධිකත්වය | බාහුල්‍යය
progametangium=ප්‍රාග්ජන්මාණුධානිය
progamons=අග්‍රයෝගී
progenitor=මුතුන් මිත්තන්ගෙන් කෙනෙක්
progeny=දරු මුණුබුරු පරම්පරාව | ප්‍රජාව | පැවත එන්නෝ
progeria=ප්‍රර්ණය
progesterone=ප්‍රොජෙස්ටෙරෝන් | ලිංගික හෝමෝනයක්
progestin=ප්‍රොජෙස්ටින්
proghibited=රක්ෂිත
prognastic=පෙර නිමිත්ත
prognathic=උද්ගත හනු
prognathism=උද්ගතහනුතාව
prognathous=නෙරිහණු
prognosis=ප්‍රාඥෙයය | භාවීඵල | භාවීඵල ප්‍රකාශනය | රෝග විග්‍රහය | විග්‍රහය
prognosticate=කලින් කියනවා | පෙරනිමිති දක්වනවා | පේන කියනවා
progradation=ප්‍රක්‍රමණය
program=ක්‍රමලේඛය | වැඩ සටහන
programme=ක්‍රියා පිළිවෙළ | කාර්ය ක්‍රමය | ප්‍රක්‍රමය | ප්‍රතිපත්තිය | වැඩ ලේඛනය | වැඩ සටහන | වැඩසටහන
programmer=ක්‍රමලේඛක | කාර්ය ක්‍රම සම්පාදක | ප්‍රක්‍රම සම්පාදක
programming=ක්‍රම ලේඛනය | ක්‍රමලේඛනය | ප්‍රක්‍රමණය | වැඩ සටහන් සම්පාදනය
progress=අභ්‍යදය | අභිවෘද්ධිය | ඉදිරියට යාම | උන්නතිය | කෙරීගෙන යනවා | දියුණු වෙනවා | දියුණුව | ප්‍රගතිය | රජකු ගේ ගමන | වාද්ධිය | වැඩි දියුණුව
progression=ඉදිරියට යාම | ක්‍රමික වෘද්ධිය | ගමන | ප්‍රගමනය | ශ්‍රෙය | ශ්‍රේඩිය | ශ්‍රේණිය
progressive=ඉදිරියට යන | ක්‍රමයෙන් වැඩි වන | දියුණු වන | ප්‍රගතිශීලී | ප්‍රගම්‍ය | ප්‍රගාමි | ප්‍රගාමී
progressively=නොනැවත | වඩ වඩා
progressives=ප්‍රගතිශීලීහු | ප්‍රගාමීහු
proguanil=පෝගුවානිල්
progymnosperm=ප්‍රාග්විවෘතබීජකය
prohibit=එපා කරනවා | තහනම් කරනවා | වළක්වනවා
prohibition=තහනම | තහන්වය | වච්ච | වාරණ
prohibitionist=මත්පැන් විරෝධියා
prohibitive=බාධක | මිල අධික
prohibitory=තහනම් | තහනම් පිළිබඳ | නිෂේධක
project=අරමුණ | අරමුණු කරනවා | උපාය | එල්ල කරනවා | කෘත්‍යය | කෘතිය | නෙරවනවා | නෙරා සිටිනවා | ප්‍රක්ෂේප කරනවා | ප්‍රක්ෂේපණය කරනවා | ප්‍රයුක්තිය | යෝජනා ක්‍රමය | යෝජනාව | ව්‍යාපාර ක්‍රමය | ව්‍යාපාරය | ව්‍යාපෘතිය
projected=ප්‍රක්ෂිප්ත
projectile=ප්‍රක්ෂිප්තය | වීසිකළ හැකි
projection=නෙරා සිටින කොටස | නෙරා සිටින දේ | නෙරා සිටීම | නෙරුම | ප්‍රක්ෂේපණය | ප්‍රක්ෂේපනය | ප්‍රක්ෂේපය | වත්ත නිමිත්ත
projectionist=ප්‍රක්ෂේපනය කරන්නා
projective=ප්‍රක්ෂේපී
projectivity=ප්‍රක්ෂේපතාව
projector=ප්‍රක්ෂේපකය | ප්‍රක්ෂේපන යන්ත්‍රය | ප්‍රක්ෂේපය | ප්‍රොජෙක්ටරය | පෘක්ෂේපකය
prolan=ප්‍රොලාන්
prolapse=පහත වැටීම | ප්‍රපතනය
prolate=දීර්ඝ ගෝලාකාර | දීර්ඝ පරිමණ්ඩල | දීර්ඝගෝලාකාර
prolegomena=පූර්විකාව | පොතක ප්‍රස්තාවනාව
prolegomenon=ප්‍රස්තාවනාව | පූර්විකාව
prolepsis=ප්‍රලම්බනය
prolession=වෘත්තීය
proletarian=කම්කරු පන්තික | ගොවි කම්කරු | නිර්ධන පන්තික
proletarianization=නිර්ධනීකරණය
proletariat=කම්කරු පන්තිය | කම්කරු පිරිස | ගොවි කම්කරු ජනයා | නිර්ධන පන්තිය | ශ්‍රමිකජනයා
proletariate=කම්කරු පිරිස | ගොවි කම්කරු ජනයා
proliferate=ප්‍රගුණන වෙනවා | ප්‍රමාණාත්මක වශයෙන් වැඩිවෙනවා
proliferation=ප්‍රගුණනය | ප්‍රතෝකායනය
proliferous=ප්‍රගුණන
prolific=බහුප්‍රජ | බොහෝ දරුවන් ඇති | බොහෝ පල දරන | විශාල ලෙස නිපදවන
prolific-writer=බහුලේඛකයා
proligerous=ප්‍රගුණන
prolix=අතිවිස්තරීය | දිගින් දිගට වූ | නුවුවමනා විස්තර සහිත
prolixity=අතිදීර්ඝත්වය | අතිවිස්තරය | නුවුවමනා විස්තර
prologue=උපන්‍යාසය | ප්‍රස්තාවනාව | පූර්වකථනය
prolong=දික් කරනවා | දික්කරනවා | දිග්ගස්සනවා
prolongation=දික් කිරීම
promadine=ප්‍රොමන්
promenade=එහා මෙහා ගමනාගමනය | එහා මෙහා යනවා | විදහා පානවා | සක්මන් කරන තැන | සක්මන් කරනවා | සක්මන් මළුව
promeristem=ප්‍රාග්විභාජකය
prometaphase=ප්‍රාග්‍යෝගකලාව
promethium=ප්‍රොමිතියම්
promethlum=ලෝහමය මූලද්‍රව්‍යයක්
prominance=ප්‍රමුඛත්වය
prominant=ප්‍රමුඛ
prominence=නෙරා තිබෙන දේ | නෙරුම | ප්‍රභූත්වය | ප්‍රමුඛත්වය | ප්‍රසිද්ධිය
prominent=උන්නත | උස්ව පෙනෙන | නෙරා තිබෙන | ප්‍රමුඛ | ප්‍රසිද්ධ | මතු වී පෙනෙන | විශිෂ්ට
promiscuity=ව්‍යහි සංවාසය
promiscuous=අවිභාගී | කලවම් | වගවිභාගයක් නැති
promiscuously=ආවාට ගියාට
promise=ගිවිසුම | තරයේ කියනවා | ප්‍රතිඥාදෙනවා | ප්‍රතිඥාව | පූර්වනිමිත්ත | පූර්වනිමිති දක්වනවා | පොරොන්දු දේ | පොරොන්දු වෙනවා | පොරොන්දුව
promisee=පොරොන්දුලාභියා | පොරොන්දුව ලැබූ තැනැත්තා
promising=ප්‍රාපේක්ෂ්‍ය | මතු බලාපොරොත්තු සහිත
promisor=පොරොන්දු කාරයා | පොරොන්දුකරු | පොරොන්දුදායකයා
promissory=පොරොන්දුවක් ඇතුළත්
promizole=ප්‍රොමිශෝල්
promonotory=උස් තුඩුව | තුඩුව
promontary=තුඩාව | තුඩුව
promontory=උස් වූ දේශතුඩුව
promote=අන්‍රග්‍රහ දෙනවා | අනුග්‍රහ දක්වනවා | අනුබල දෙනවා | ආරම්භ කරනවා | ඉහළ දමනවා | උල්පන්දම් දෙනවා | උසස් කරනවා | තත්ත්වයෙන් උසස් කරනවා | දියුණු කරනවා | ප්‍රරෝහනය කරනවා | පොළඹවනවා | වඩනවා
promoter=අන්‍රග්‍රහකරු | අන්‍රග්‍රාහක | අනුග්‍රහකරු | අනුග්‍රාහකයා | ප්‍රරෝහක | ප්‍රවර්ධක | වර්ධකය
promotion=උසස් කිරීම | උසස් වීම | උසස්කිරීම | ප්‍රවර්ධනය | ප්‍රාවර්ධනය
promotor=ප්‍රවර්ධකයා
prompt=අප්‍රමාද | අප්‍රමාදව | අව්ලම්බ | අවිලම්බිත | ඉක්මන් | ඉඟිය | උනන්දු කරනවා | කටට දෙනවා | කඩිනම් | කල් නොවා | ක්ෂණික | ප්‍රේරකය | පොළඹවනවා | වහා කරනලද | ශීඝ්‍ර | සිහි කරනවා
prompter=නාට්‍යකරුවන්ට වචන මතක් කර දෙන්නා | පෙළසමරු | පෙළේගුරු | සිහිකරු
prompting=පෙළඹවීම
promptitude=අප්‍රමාදය | කඩිනම
promptly=අතපිට | අත්පිට | එවිගස | නුලස | විගහට
promptness=අප්‍රමාදය | කඩිනම
promulagate=ප්‍රකාශ කරනවා
promulgate=පනවනවා | ප්‍රසිද්ධ කරනවා | පුළුල් කරනවා
promulgation=පතළ කිරීම | ප්‍රඥාපනය | ප්‍රසිද්ධ කිරීම
promycele=ප්‍රමයිසීලිය
promycelial=ප්‍රමයිසීලිය
promycelium=ප්‍රමයිසීලිය
pronation=නිකුජ්ජනය
prone=ප්‍රණත | මුණින් වැටී සිටින | යමකට ආශාව දක්වන | යමකට හුරුකම් දක්වන | යමක් දෙසට නැමුණු
proneness=අවනත බව | මුනින් වැටී සිටීම
pronesis=ප්‍රායෝගික ප්‍රඥාව
prong=උල | කටුව | දැත්ත
pronged=දැති සහිත
pronomial=සර්වනාම පිළිබඳ වූ
pronoun=සර්වනාමය
pronounce=උච්චාරණය කරනවා | තීන්දුවක් ප්‍රකාශ කරනවා | ප්‍රකාශ කරනවා | ප්‍රඥාපනය කරනවා | මතයක් දක්වනවා | මතයක් ප්‍රකාශ කරනවා | ශබ්ද කරනවා
pronounceable=උසුරවිය හැකි
pronounced=නිශ්චිත | පැහැදිලි සේ පෙනෙන
pronouncement=තීන්දුව ප්‍රකාශ කිරීම | ප්‍රකාශය | මතය ප්‍රකාශ කිරීම
pronto=අප්‍රමාදව | ක්ෂණිකව
prontosil=ප්‍රොන්ටොසිල්
pronucleus=ප්‍රාග්න්‍යෂ්ටිය
pronunciation=උච්චාරණය | පාඨනය | ශබ්ද කිරීමේ ක්‍රමය | ශබ්දෝච්චාරණය
proof=අනතුරක් නොකළ හැකි | ඔප්පු කිරීම | ඔප්පුකරය | පරීක්ෂාකර බැලීම | මුල්පත | වැරැද්දක් නොකළ හැකි | ශුද්ධිපත්‍රය | ශෝධ්‍යපත්‍රය | සාක්ෂය | සාධකය | සාධනය | සෝදුපත | සෝදූපත
proof-plane=නැහැසුම් තලය
proof-reader=ශෝධ්‍යපත්‍රයෙහි හරි වැරදි බලන්නා
prop=අඩ තබනවා | අඩය | ආධාරය | කරු ගසනවා | කරුව | කුරුපාව | ගණ | බලකරුව | බළුව | මුක්කු ගහනවා | මුක්කුව | රුකුල | රුකුල් දණ්ඩ | රුකුල් දෙනවා
propaganda=ප්‍රචාරක කටයුතු | ප්‍රචාරක මණ්ඩලය | ප්‍රචාරය | සම්ප්‍රචාරණය | සම්ප්‍රචාරය
propagandist=ප්‍රචාරකයා
propagate=පතළ කරනවා | පතුරුවනවා | ප්‍රචාරණය කරනවා | ප්‍රචාරය කරනවා | බෝ කරනවා | බෝකරනවා | ව්‍යාප්ත කරනවා | හියාරනවා
propagating=ප්‍රචාරක
propagation=ප්‍රචාරණ | ප්‍රචාරණය | ව්‍යාපනය
propagative=ප්‍රචාරක
propagule=ප්‍රචාරකය
propagulum=ප්‍රචාරකය
propane=පැරපින කාණ්ඩයේ හයිඩ්‍රොකාබනයක්
propel=තල්ලු කරනවා | දුවවනවා | පදවනවා | ප්‍රචාලනය කරනවා | වේගයෙන් ඉදිරියට යවනවා
propellant=ගුවන්‍යානා ඉන්ධන
propeller=අවර පෙත්ත | අවරපෙත්ත | නැවේ අවර පෙත්ත | නෞකා ප්‍රේරකය | ප්‍රචාලකය | ප්‍රධාවකය
propension=ප්‍රවණතාව
propensity=නැමියාව | නැමීම | නැඹුරුව | ප්‍රණතිය | ප්‍රවණතාව | රුවය | හුරුකම
proper=අනුච්ඡවික | අසාමාන්‍ය | උවත | ඔබින | කළමනා | ක්ෂම | නියම | නිසි | යථා | යථා යෝගය | යෝග්‍ය | ශිෂ්ට | ස්වකීය | සුදුසු
properly=නියම ලෙස | සුදුසු ලෙස | හරියට
properties=අහාර්ය | ගුණ
property=අයිති දේ | අයිතිය | ඉඩකඩම් | ගුණය | ජාතිලක්ෂණය | දේපල | දේපළ | දේපොළ | ධනය | ලක්ෂණය | වස්තුව | විශේෂය | ස්වාභාවික ගුණය
property-mark=දේපල ලකුණ
prophase=ප්‍රාක්කලාව
prophecy=අනාගත වාක්‍යය | අනාගතවාක්‍යය | අනාවැකිය | භවිෂ්‍යත් විදර්ශනාව | භාවිකථනය
prophesy=අනාවැකි කියනවා | සාස්තරය
prophet=අනාගත දේ හෙළිකරන්නා | අනාගත වක්තෘ | අනාගතවක්තෘ | දිවැසිවරයා | ශාස්තෘවරයා | සෘෂිවරයා
prophetess=අනාවැකි කියන්නිය
prophetic=අනාගතය හෙළි කරන
prophylactic=නිවාරක | රෝග නිවාරක | ලෙඩ වැළඳීම වළකන
prophylaxis=නිවාරණය | රෝග නිවාරණය
prophyll=ප්‍රෝපීලය
prophyllum=නිපත්‍රිකාව
propinquity=කිට්ටුකම
propitiate=අනුග්‍රහය ලබාගන්නවා | උපගමනය කිරීම | විරෝධය මඟහරවා ගන්නවා | සතුටු කරනවා
propitiation=අනුග්‍රහ ලැබීම | උපශමනය | සන්තර්පණය
propitiatory=අනුග්‍රහ ලැබීමට සලසන
propitious=අනුකූල | ඉෂ්ට | කරුණාවන්ත | ශුභ
proplastid=ප්‍රාක්ලවය
proponent=යෝජකයා
proportion=අන්‍යෝන්‍ය ප්‍රමාණය | කොටස | පදම | ප්‍රමාණය | සමානුපාතය
proportional=ඉනංගු | ප්‍රමාණයට අනුකූල වූ | සමානුපාතික | සමානුපාතිකය
proportionality=සමානුපාතිකතාව
proportionate=කඩවසම් | සමප්‍රමාණ | සමභාග | සමානුපාතික
proportioning=ඉණංගු කිරීම | සමානුපාතනය
proposal=ප්‍රස්තුතය | මංගල යෝජනාව | යෝජනාව | විවාහ බස් ඉල්ලීම
propose=ඉදිරිපත් කරනවා | බලාපොරොත්තු වෙනවා | යෝජනා කරනවා | විවාහ බස් ඉල්ලනවා
proposed=ප්‍රස්තූත | යෝජිත
proposer=යෝජකයා | යෝජනාකරු
proposition=ඉදිරිපත් කරන යෝජනාව | ප්‍රමේයය | ප්‍රස්තුතය | වාක්‍යය | සාධ්‍ය
propositus=තෙස්තමේන්තුදායකයා | මුල් හිමිකරු
propound=තේරුම් කර දෙනවා | ප්‍රස්තවනය කරනවා | සත්‍ය ලෙස ඉදිරිපත් කරනවා
proprietary=ඉඩම් අයිති | ස්වාම්‍ය | හිමිකාර | හිමිකාරයන් පිළිබඳ
proprietas=හිමිකරතාව
proprietor=අයිතිකරු | අයිතිකාරයා | ස්වාමියා | හිමිකරු | හිමියා
proprietorial=අයිතිකාරයා ලෙස
proprietors/income=අයිතිකරුගේ ආදායම
proprietorship=අයිතිය | හිමිකම
proprietress=අයිතිකාරිය
propriety=උචිතබව | ඖවත්‍යය | යෝග්‍යත්වය | යෝග්‍යතාව | ශිෂ්ටත්වය | සුදුසුකම
proprioceptor=ස්වප්‍රතිහ්‍රාහකය
proprium=විශේෂ ලක්ෂණය
props=අහාර්ය
propulsion=ඉදිරියට දුවවීම | තල්ලු කිරීම | ප්‍රචාලනය | ප්‍රවාලනය | පැදවීම
prorata=අනුපාතානුකූල
prorogation=සභාවාරය අවසන් කිරීම
prorogue=වාරහමාර කරනවා | සභාව විසුරුවා හරිනවා
prosaic=අවිශිෂ්ට | ගද්‍යුමය | ගද්‍යුරූපී | නීරස | රසසුන් | සාමාන්‍ය
proscenium=නෘත්‍ය මණ්ඩපය | ප්‍රොසීනියම | වේදිකාවේ තිරය අභියස
proscribe=අවලේඛණය කරනවා | අවලේඛනය කරනවා | තහනම් කරනවා
proscription=ගහනම
proscriptive=ප්‍රතිෂේධක
prose=ගද්‍ය | ගද්‍ය රචනාව | ගද්‍යය | ගැදි
prosect=ප්‍රකණ්ඩනය
prosecute=අභිචෝදනා කරනවා | පරිශීලනය කරනවා | යමක යෙදී සිටිනවා
prosecuting=අභිචෝදන
prosecution=අභිචෝදනය | චෝදනා ඉදිරිපත් කිරීම | නඩුව ගෙනයෑම | පැමිණිල්ල | පැමිණිලි පක්ෂය
prosecutor=අභිචෝදකයා | චෝදක | නඩු පවරන්නා | පැමිණිල්ල මෙහෙයවන්නා
prosecutrix=අභිචෝදිකාව
proselyte=අන්‍යාගමකට හරවනු ලැබූ පුද්ගලයා
proselytize=අන් මතයකට හරවනවා | අන්‍යාගමකට හරවනවා
prosenchyma=දීර්ඝස්තරය
prosodic=ඡන්දස් ශාස්ත්‍රය පිළිබඳ වූ
prosody=ඡන්දස | ඡන්දස් | ඡන්දස් ශාස්ත්‍රය | සඳස් | සඳැස්
prospecive=ප්‍රකාශ පත්‍රය | බලාපොරොත්තු වියහැකි
prospect=අපේක්ෂාව | ඇවිද සොයා බලනවා | පෙරික්සුම | පෙරික්සුම් අගය
prospecting=පූර්වේක්ෂණය | පෙරික්සීම
prospection=ප්‍රලෝකනය
prospective=අනාගත | පෙරදක්නු | පෙරදිසි
prospector=ඇවිද සොයා බලන්නා
prospects=අනාගත කටයුතු | අනාගතය
prospectus=ප්‍රකාශ පත්‍රය | ප්‍රවිවරණය | පූර්වනිවේදනය | පෙරදක්නුව | විවරණිකාව | සංස්ථා ප්‍රකාශය
prosper=දියුණු වෙනවා | සඵල කරනවා | සඵල වෙනවා
prosperity=අභ්‍යදය | කල්‍යාණ | මංගල | ශ්‍රී | සපුව | සම්පත් | සමෘද්ධිය | සිරිසර | සෞභාග්‍යය
prosperous=ශ්‍රී | ශ්‍රීමත් | ශුභ | සමෘද්ධ | සව්සිරි | සශ්‍රී | සසිරි | සසිරිමත් | සිරිබර | සිරිසර
prosporangium=ප්‍රබීජාණුධානිය
prostate=පුරස්ථිතය | පුරහ්ස්ථ ග්‍රන්ථිය
prostatectomy=පුරස්ථිත විච්ඡේදනය
prosthesis=ශරීරාබාධ ප්‍රකෘතිමත් කිරීම
prosthion=පුරස්තමය
prostigmine=ප්‍රොස්ටිග්මින්
prostitute=කැපකරනවා | ගණිකාව | දූෂ්‍ය කරනවා | නොවටිනා දේට යොදනවා | වෙසඟන | වෙසාවා | වේශ්‍ය කමේ යොදවනවා | වේශ්‍යා කර්මයෙහි යොදනවා | වේශ්‍යා ස්ත්‍රී | වේස | වේසාවී | වේසිය | වේසී | වෛශ්‍යාව
prostitution=ගණිකා වෘත්තිය | ගණිකාවාරය | පණ්‍යා වෘත්තිය | පණ්‍යා වෘත්තිය | වෛශ්‍යාකර්මය
prostrate=අතිශයින් දුර්වල | දිගා වී සිටින | දිගා වෙනවා | ප්‍රණිපාතය | බිම හෙළනවා | බිම් බෑවු | මුණින් වැටී සිටින | මුණින් වැටෙනවා | වැතිරි | ශක්තිය වනසනවා | සම්පූර්ණයෙන් වෑරීගිය
prostrated=වෑරීගිය
prostration=දණ්ඩ නමස්කාරය | පරික්ලාන්තිය | පසඟ පිහිටුවා වැඳීම | ප්‍රණිපාතය | බලක්ෂය වීම
prosy=අවිශිෂ්ට | ගද්‍යමය | නීරස | සාමාන්‍ය
prosyllogism=පූර්ව සංවාක්‍යය
protactinium=ප්‍රෝටැක්ටිනියම්
protagonist=නායක | පක්ෂධරයා | ප්‍රධානයා
protalbumose=ප්‍රොටැල්බියුමෝස්
protandrous=ප්‍රපූංපරිණත
protandry=ප්‍රපුංපරිණතිය
protanomalous=ප්‍රවීෂම
protanopia=ප්‍රාග්නෛත්‍රය | ප්‍රෝටනෝපියාව
protargol=ප්‍රොටාගල්
protasis=අවයව ප්‍රස්තුතය | ප්‍රොටාසිය
protean=නොයෙක් සමර්ථකම් ඇති
protease=ප්‍රොටියේස් | ප්‍රෝටියේස්
protect=අරක්ගන්නවා | ආරක්ෂා කරනවා | ආවරණය කරනවා | රක්ෂා කරනවා | රකිනවා | රැක බලාගන්නවා | රැකගන්නවා
protected=ආරක්ෂිත | රක්ෂිත | සනාථ
protection=ආරක්ෂණය | ආරක්ෂාව | ත්‍රාණය | පරිත්‍රාණ | පරිහාරය | ප්‍රකාශන ආරක්ෂාව | පාදු | රකවරණය | රැක බලා ගැනීම | රැකවරණ | රැකවරණය | රැක්ම | රැකීම | රැකුම
protectionism=ආරක්ෂණවාදය
protectionist=ආරක්ෂණවාදියා
protective=ආරක්ෂක | රක්ෂක
protector=ආරක්ෂක උපක්‍රමය | ආරක්ෂකයා | පරිණායක
protectorate=ආරක්ෂිත ප්‍රදේශය | ආරක්ෂිත රාජ්‍යය | ආරක්ෂිතය
protege=ආරක්ෂිතයා | සංරක්ෂිතයා
proteges=ඇරැකියෝ
proteid=ප්‍රෝටීඩය
protein=ප්‍රෝටීන | ප්‍රෝටීන් | මාංශජනක ධාතු | මාංසජනක
proteinaceous=ඇල්බියුමන්
proteinic=ප්‍රෝටීනීය
protensity=ප්‍රවර්තන විස්තාරය | ප්‍රවර්තනය
proteolysis=ප්‍රෝටීන් රණය
proteolytic=ප්‍රෝටියොලිටික
proteose=ප්‍රෝටියෝස්
proteosynthesis=ප්‍රෝටීන් සංශ්ලේෂණය
proterandrous=ප්‍රපුංපරිණත
proterandry=ප්‍රපුංපරිණතිය
proteranthous=පුරාපුෂ්පන
proterogynous=ප්‍රජායාපරිණත
proterogyny=ප්‍රජායාපරිණතය
proterotype=පුර්වදර්ශය
protest=බලවත් නොකැමැත්ත | විරුද්ධත්වය ප්‍රකාශ කරනවා | විරෝධ ප්‍රකාශය | විරෝධය | විරෝධය පලකිරීම | විරෝධය පානවා | විරෝධාකල්පය | විරෝධාලාපනය කරනවා
protestant=රෙපරමාදු කාරයා
protestantism=රෙපරමාදු ආගම | රෙපරමාදුවාදය
protestation=ඒකාන්ත ප්‍රකාශය
protestelic=ප්‍රාක්ස්ථූණික
protesthesis=ප්‍රාග්වින්දනය
proteus=ප්‍රොටියස්
prothallial=ප්‍රාක්තලස්
prothalliform=ප්‍රාක්තලසාකාර
prothalline=ප්‍රාක්තලසීය
prothallium=ප්‍රාක්තලස
prothalloid=ප්‍රාක්තලසීය
prothallus=ප්‍රාක්තලස
prothrombin=ප්‍රොත්‍රොම්බින්
protium=ප්‍රෝටියම්
proto=ප්‍රථම | මූල
proto-esthesia=ප්‍රාග්වින්දනය
proto-renaissance=මූල පුනරුදය
protoactinium=ප්‍රෝටොඇක්ටිනියම්
protocaine=ප්‍රොටොකේන්
protochlorophyll=ප්‍රෝටොක්ලෝරොපිල්
protochlorophylline=ප්‍රෝටොක්ලෝරොපිලීන්
protocol=ප්‍රථම ලේඛනය | පෙරාතු කොළය | පෙරාතුකොළය | මූලපත්‍රය | මූලලේඛය
protocorm=ප්‍රෝටොකෝමය
protoderm=ප්‍රාක්චර්මය
protoepiphyte=ප්‍රාග් අපිශාකය
protogany=ප්‍රජායාපරිණතිය
protogynous=ප්‍රජායාපරිණත
protogyny=ප්‍රජායාපරිණතිය
protohistory=මූල ඉතිහාසය
protomeristem=ප්‍රාග්විභාජකය
protomycelium=ප්‍රාක්මයිසීලිය
proton=ප්‍රෝටෝනය
protonema=ප්‍රාක්තන්ත්‍රය | ප්‍රෝටොනීමය
protonemal=ප්‍රාක්තන්ත්‍රිය | ප්‍රෝටේානීමිය
protopathy=ප්‍රාග්වින්දනය
protopectinase=ප්‍රෝටොපෙක්ටිනේස්
protophile=ප්‍රෝටෝනකාමිය
protophilia=ප්‍රෝටෝනකාමිත්වය
protophloem=ප්‍රාක්ප්ලෝයම
protophyll=ප්‍රාක්පත්‍රය
protophylline=ප්‍රෝටොපිලීන්
protophyta=ප්‍රාග්ශාකය
protoplasm=ජීව ද්‍රව්‍යය | ප්‍රාක්පලාස්මය | ප්‍රාක්ප්ලාස්මය | ප්‍රොටෝප්ලාස්මය
protoplasma=ප්‍රාක්ප්ලාස්මය
protoplasmic=ප්‍රාක්ප්ලාස්මීය
protoplast=ප්‍රාක්ප්ලාස්ටය
protosiphonogamy=ප්‍රාක්නාලයෝගය
protostele=ප්‍රාක්ස්ථූණය
protostylic=පුරෝකීල
prototrophic=ප්‍රාක්පෝෂී
prototropic=ප්‍රෝටෝනාවර්ත
prototropy=ප්‍රෝටෝනාවර්තනය
prototype=ප්‍රතිරූපක | ප්‍රාග්දර්ශනය | ප්‍රාග්දර්ශය | පෝටෝටයිප් | මූලරූපය | මූලාකෘතිය | මූලාදර්ශනය | මූලාදර්ශය
prototypic=ප්‍රාග්දර්ශීය
protoxylem=ප්‍රාක්ශෛලම
protozoa=ප්‍රථම වියෝ | මූලසත්ව
protozoan=ඒකසෛලික ක්ෂුද්‍රවියා
protract=දිග්ගස්සනවා | ප්‍රමාද කරනවා
protracted=බොහෝ කල් ගතවන | වෙහෙස ඇතිකරන
protracting=කෝණ ඇඳීම | පරිමාණයට ඇදීම
protractor=කෝණ මානය | කෝණමානය
protrude=ඉලිප්පේනවා | නෙරනවා | නෙරවනවා | නෙරා සිටිනවා
protrusion=ඉලිප්පීම | නෙරා තිබීම | ප්‍රාසනය
protrusive=නෙරා ඇති
protuberance=ඉදිමුම | ගැටය | නෙරීම
protuberant=ඉල්පී තිබෙන | නෙරා තිබෙන | මතු වී තිබෙන
protyle=මූලෝහදානය
protype=ප්‍රදර්ශය
proud=අභිමානී | අහංකාර | ආඩම්බර | උඩඟු | උදාරම් | ප්‍රෙඩෙ | මාන්නක්කාර | මානී | සාඩම්බර
provable=සාධනීය | සාධ්‍ය
prove=අත්හදා බලනවා | ඔප්පු කරනවා | ඔප්පු කිරීම | ඔප්පු වෙනවා | ප්‍රත්‍යක්ෂ කරනවා | ප්‍රත්‍යක්ෂ වෙනවා | සනාථ කරනවා | ස්ඵූට කරනවා | සාධනය කරනවා
proved=අත්දුටු | ස්ඵූට
proven=ඔප්පු වූ | ප්‍රත්‍යක්ෂ වූ | සිද්ධ
provenance=නිදානය | ප්‍රභව ස්ථානය | ව්‍යද්භවය | සම්භවය
provencal=ප්‍රදේශයට අයිති
provender=ඝාසය
prover=නහස්නාව | පරීක්ෂකය
proverb=අතිශය ප්‍රකට දේ | ආප්තෝපදේශය | උපදේශ වාක්‍යය | ප්‍රස්තාව පිරුළ | පිරුළ | පිරුළු
proverbial=ඉතා ප්‍රකට
provide=උපයනවා | කලින් සපයනවා | සලසනවා
provided=ඉදින් | හොත්
providence=කලින් සූදානම් කිරීම | කලින් සූදානම් වීම | දුරදිග බැලීම | දේවාරක්ෂාව | පූර්ව විධානය | විධාතෘ | සකසුරුවම්කම
provident=දුරදර්ශී | සකසුරුවම්
providential=දේව පිහිටෙන් වූ | පුදුම සේ වාසනාවන්ත
provider=ගෙදර මූලිකයා | ප්‍රතිපාදක
providing=ප්‍රතිපාදක
province=අයිති විෂය | දැනගත් දේ | පලාත | පළාත | ප්‍රදේශය | මණ්ඩලය | මහදිසාව
provincial=දේශීය | පලාත් | පලාත්බද | පළාත්බද | ප්‍රත්‍යන්ත | ප්‍රාදේශික | ප්‍රාදේශීය | පිටිසර
provincialism=ග්‍රාම්‍ය ව්‍යවහාරය | දේශීය ව්‍යවහාරය | ප්‍රාදේශිකත්වය
proving=නුහැසුම
provision=ආහාර පාන සපයනවා | ආහාර සපයනවා | නියමය | ප්‍රතිපාදනය | විධිවිධාන | විධිවිධානය | වෙන් කිරීම | සැපයීම | සැපයුම | සැපැයුම | සැලසීම | සූදානම
provisional=අවස්ථානුරූප | කාලීන | තාවකාලික | යාවකාලික | යාවකාලීන
provisions=කළමනා | කෑම බීම | ගිවිසුමක ඇතුළත් නියෝග | ව්‍යවස්ථාවක ඇතුළත් නියෝග
proviso=අතුරු විධානය | අතුරුවිධානය | කොන්දේසිය | නියමය | විශේෂ නියමය
provisory=කොන්දේසියට යටත්
provke=කූද්දනවා
provocation=අවිස්සීම | කුපිත කිරීම | කුපිත කිරීම් | කුපිතය | තරහ උපදවන කාරණය | ප්‍රකෝපනය
provocative=අවුස්සන | කුපිත කරවන
provoke=අවුස්සනවා | උපදවනවා | පොළඹවනවා | යකා වැහෙනවා
provoking=කුපිත කරවන
provost-marshal=හමුදා පොලීසි ප්‍රධානියා
prow=ඇණිය | නැවේ ඉදිරි කොටස
prowess=පරාක්‍රමය | ශූරභාවය
prowl=සෙවිල්ලෙන් ඇවිදිනවා
prox=ලබන මාසේ
proximal=අවිදුර
proximate=අනන්තර | ආසන්න | ආසන්නකම | ඉතා ආසන්න | කිට්ටු | හමුදා සිරකරු භාර නිලධරයා
proximity=අසල | ඉතා කිට්ටුකම | කිට්ටුව | වෙළත | සන්නිකර්ෂණය | සම්බන්ධය | සමීපත්වය
proximo=ලබන මාසේ
proxy=නියෝජනය | ප්‍රතිපුරුෂයා | ප්‍රතියුක්තය | ප්‍රතියුක්තයා | පෙරකලාසිකරු | පෙරකලාසිය | බලකාරයා | බලපත්‍රය
prphan=අනාථයා
prude=ලජ්ජාකාරයා
prudence=නුවණක්කාර බව | මූල්‍ය ප්‍රඥාව
prudent=ඥානාන්විත | දූරදර්ශී | ප්‍රඥාන්විත | විචක්ෂණ | සිහි පරීක්ෂා ඇති
prudential=නුවණක්කාර
prudery=අධික කෝලය
prudish=අතිවිනීත | ලජ්ජාශීලි
pruinate=අළු සහිත
pruinose=අළු සහිත
pruinous=අළු සහිත
prunase=පෲනේස්
prunasin=පෲනසින්
prune=අතු පාහිනවා | කප්පාදු කරනවා | කොට කරනවා | පාහිනවා | පෲන් | වියලි ඵලවර්ගයක්
pruning=පෑහීම
prurience=අශ්ශීලභාවය
prurient=අධික කාමාශාව උපදවන | අශ්ලීල
pruritus=කණ්ඩුතිය
prussic=නිල්පාටට හුරු
pry=අමාරුවෙන් අරිනවා | කුතුහලයෙන් අනුන්ගේ දේ විමසනවා
pryingly=රහසින් බලා සෝදිසියෙන්
ps=සමමිතික ලක්ෂ්‍යය
psalm=ගීතිකාව | දේව ස්තෝත්‍රය | බැති ගීය | භක්ති ගීතිකාව
psalmist=ගීතිකා කාරයා | දේවස්තෝත්‍ර කාරයා
psalmody=ගීතිකා ගායනය | ස්තෝත්‍ර සංග්‍රහය
psalter=ගීතිකා පොත
psaltery=තූර්ය භාණ්ඩයක්
psammophile=වාලුකාමිය
psammophilous=වාලුකාමි
psephology=ඡන්ද විද්‍යාව | ඡන්දවේදය
pseudacranthic=ව්‍යාජාග්‍රපුෂ්පී
pseudaesthesia=ව්‍යාජ වින්දනය
pseudannual=ව්‍යාජවාර්ෂික | ව්‍යාජවාර්ෂිකය
pseudannulus=ව්‍යාජවලය
pseudanthium=ව්‍යාජපුෂ්පය
pseudapogamy=ව්‍යාජවිසංයෝගතාව
pseudaxis=ව්‍යජාක්ෂය
pseudembryo=ව්‍යාජකලලය
pseudesthesia=ව්‍යාජ වින්දනය
pseudinulin=සියූඩිනියුලින්
pseudo=මිථ්‍යා | ව්‍යාජ
pseudo-adventive=ව්‍යාජආගන්තුක
pseudo-antoicous=ව්‍යාජෛකගෘහී
pseudo-classical=සම්භාව්‍ය ප්‍රතිරූපක
pseudo-code=ව්‍යාජ කේතය
pseudo-crisis=ව්‍යාජ සංකටය
pseudo-hermaphrodite=ව්‍යාජද්විලිංගිකයා
pseudo-hermaphroditism=ව්‍යාජද්විලිංගිකතාව
pseudo-scalar=ව්‍යාජ අදිශය
pseudo-statement=ව්‍යාජෝක්තිය
pseudo-vector=ව්‍යාජ දෛශිකය
pseudobulb=ව්‍යාජ බල්බය
pseudocapillitium=ව්‍යාජකේශජාලය
pseudocarp=ව්‍යාජ ඵලය
pseudocephalodium=ව්‍යජශීර්ෂකාභය
pseudochromaesthesis=ව්‍යාජ වර්ණ වින්දනය
pseudochromesthesia=ව්‍යාජ වර්ණ වින්දනය
pseudochromesthesis=ව්‍යාජ වර්ණ වින්දනය
pseudocolumella=ව්‍යාජස්ථම්භිකාව
pseudocortex=ව්‍යාජබාහිකය
pseudocostate=ව්‍යාජපර්ශුක
pseudocotyledon=ව්‍යාජකොටීලය | ව්‍යාජබීජපත්‍රය
pseudodementia=ව්‍යාජ චිත්ත වික්ෂේපය
pseudoelator=ව්‍යාජපාජකය
pseudoepiphyte=ව්‍යාජ අපිශාකය
pseudofecundation=ව්‍යාජසංසේචනය
pseudogametangium=ව්‍යාජජන්මාණුධානිය
pseudogamy=ව්‍යාජයෝගය
pseudogenus=ව්‍යාජගණය
pseudograph=මිථ්‍යාලිඛිතය
pseudohymenium=ව්‍යාජසරුපටය
pseudoillium=ව්‍යාජපක්ෂ්මය
pseudoisotope=ව්‍යාජ සමස්ථානිකය
pseudomemory=ව්‍යාජ ස්මාරය
pseudomenesia=ව්‍යාජ ස්මෘතිය
pseudomerism=ව්‍යාජ සමාවයවිකතාව
pseudomonocotyledon=ව්‍යාජඒකබීජපත්‍රිකය
pseudomonocotyledonous=ව්‍යාජ ඒකබිජපත්‍රික | ව්‍යාජඒකකොටිල
pseudomorph=ව්‍යජාකාරය
pseudomorphism=ව්‍යජාකාරය
pseudomorphy=ව්‍යාජරූපතාව
pseudomyopia=ව්‍යාජ දෘෂ්ටිය
pseudonym=ආරූඩ නාමය | බොරු නම | ව්‍යාජ නාමය | ව්‍යාජනාමය
pseudonymous=ව්‍යාජනාම සහිත
pseudonystagmus=ව්‍යාජ නිස්ටැග්මස
pseudoparalysis=ව්‍යාජ පරාශ්ලථය
pseudoparaphysis=ව්‍යාජවඳරෝමය
pseudoparenchyma=ව්‍යජමෘදුස්තරය
pseudoparenchymatous=ව්‍යාජමෘදුස්තරීය
pseudoparesis=ව්‍යාජ පරාශ්‍රංසය
pseudoperception=ව්‍යාජ සංජානනය
pseudoperianth=ව්‍යාජපරිපුෂ්පය
pseudoperidial=ව්‍යාජපරිය
pseudoperidium=ව්‍යාජපරිඩිය
pseudophone=සියුඩෝපෝනය
pseudoplasmodium=ව්‍යාජප්ලාස්මෝඩිය
pseudopod=ව්‍යාජපාදය
pseudopodal=ව්‍යාජපාදීය
pseudopodium=ව්‍යාජපාදය
pseudopolyembryony=ව්‍යාජබහුකලලතාව
pseudopotential=ව්‍යාජ විභවය
pseudopresentimant=ව්‍යාජ අනාහැඟුම
pseudopsychology=ව්‍යාජ මනෝවිද්‍යාව
pseudoraphe=ව්‍යාජසේවනිය
pseudoreduction=ව්‍යාජඌනනය
pseudoscope=ව්‍යාජේක්ෂය
pseudosperm=ව්‍යාජශුක්‍රාණුව
pseudosphere=ව්‍යාජගෝලය
pseudoterminal=ව්‍යාජඅග්‍රස්ථ
pseudovascular=ව්‍යාජසනාල
pseudovector=ව්‍යාජ දෛශිකය
pshaw=තූ | වහ්
psilophyta=සිලොපීටා
psilophyte=සිලොපීටා ශාකය
psittacism=කීර වාදය
psittacosis=සිටකෝසියාව
psmmophyte=වාලුශාකය
psoas=ප්‍රොථකය
psoriasis=සෝරෛයසිස් නම් චර්මරෝගය
psychanalysis=මනෝ විග්‍රහය | චිත්ත විභාගය
psychasthenia=සයිකැස්තීනියාව
psychasthenics=සයිකැස්තීනිකය
psyche=ආත්මය | චෛතන්‍යය | මනස | මනස් | මනෝධාතුව | වය | සූක්ෂ්ම ශරීරය
psycheatrist=මනෝචිකිත්සක
psychedelic=අධි චිත්තවේගී | මනෝභ්‍රමික
psychergograph=මනහ්ශ්‍රම රේඛය
psychiatrist=මනෝචිකිත්සකයා
psychiatry=මනස් චිකිත්සාව | මනෝ චිකිත්සාව | මානසික | මානසික රෝග ප්‍රතිකාරය
psychic=ආධ්‍යාත්මික | ඉදු | චෛතසික | මනසීභූත | මනෝරේඛය | මානසික
psychic-blindness=චෛතසික අන්ධතාව
psychic-distance=මනෝදූරය
psychical=ආධ්‍යාත්මික | චෛතසික | මනස්ක | මනසීභූත | මානසික
psychism=අධ්‍යාත්ම විද්‍යාව
psycho-analyse=මානසිකත්වය විග්‍රහ කරනවා
psycho-analysis=මනෝ විශ්ලේෂණය | මනෝවිශ්ලේෂණය
psycho-neurosis=මනෝ ස්නායු විකාරය
psycho-social=මනෝසමාජ
psychoanalysis=මනෝ විග්‍රහය | මනෝවිශ්ලේෂණය | මානසිකතත්ත්ව පරීක්ෂණය | වත්ත විභාගය
psychoasthenics=සයිකොස්තීනිකය
psychobiology=මනෝව විද්‍යාව
psychodiagnostics=චේතක ප්‍රඥානය
psychodometer=සයිකොඩෝමීටරය
psychodrama=මනෝනාට්‍යය
psychodynamics=මනෝගති විද්‍යාව
psychogalvanometer=සයිකොගැල්වනෝමීටරය
psychogenesis=මනෝජනනය
psychognosis=මනෝජනනය | මනෝජානනය
psychogram=මනෝරේඛය
psychograph=මනෝරේඛය
psychography=මනෝරේඛනය
psychoid=වාහය
psychoild=චෛතන්‍යකය
psychokinesis=මනෝචලනය
psychological=මනෝ | මනෝමය | මානසික
psychologism=මනෝනුවර්තීවාදය | මනෝවිද්‍යා වාදය
psychologist=මනෝ විද්‍යාඥයා | මනෝවිද්‍යාඥයා
psychology=මනෝවිඥානය | මනෝවිද්‍යාව | මනෝවේදය | මානස ශාස්ත්‍රය | මානසික වේදය
psychometric=මනෝමිතික
psychometrician=මනොමිතිඥයා
psychometrics=මනෝමිතිකය
psychometrizing=මනෝමිතිකායනය
psychometry=මනෝමිතිය
psychoneurosis=මනස්නසාව | මානසික හේතූන් මත නහර දුර්වල වීම
psychonomics=මනෝමූලකය
psychopath=මනෝ ව්‍යාධිකයා | මනෝ ව්‍යාධියා | මනෝව්‍යාධිකයා
psychopathology=මනෝ ව්‍යාධි විද්‍යාව
psychopathy=මනෝව්‍යාධිය
psychophysics=මනෝ භෞතිකය
psychophysiology=මනෝ භෞතවේදය | මනෝභෞතවේදය
psychosexual=මනෝලිංගික
psychosis=මනෝ විකාරය | මනෝවිකාරය | සයිකෝසියාව
psychosocial=මනස් සමාක
psychosomatic=මනෝදේහ | මනෝදෛහික
psychostatics=මනෝස්ථීතිකය
psychosurgery=මානසික විකෘතිභාවය සුව කිරීමට මොලයට කරන ශල්‍යකර්මය
psychotechnology=මනෝ තාක්ෂණය
psychotherapeutics=මනෝරෝග චිකිත්සාව
psychotherapy=මනෝ රෝග චිකිත්සාව | මනෝරෝග චිකිත්සාව
psychotic=මනෝව්‍යාධික | මනෝවිකාරී | මානසික රෝගී
psychrometer=ආර්ද්‍රතාමානය | තෙත් හා වියලි බල්බ ආර්ද්‍රතාමානය | වාෂ්පමානය | සයික්‍රොමීටරය
psychrometric=ආර්ද්‍රතාමිතික
psychrophyte=තුහින ශාකය
psycopathology=මනෝව්‍යාධි විද්‍යාව | මනෝව්‍යාධිවේදය
psycyomotor=මනස්චාලක
psyshopharmacology=මනෝ භිෂග්වේදය
ptarmigan=කුරුලු විශේෂයක්
pteridophyte=ටෙරිඩොපීටා ශාකය | පර්ණාංග ශාකය
pteridophytic=ටෙරිඩොපීට
pteridosperm=ටෙරිඩොස්පෙර්ම්
pteridospermic=ටෙරිඩොස්පෙර්මිය
pteridospermous=ටෙරිඩොස්පෙර්මිය
pterion=ටෙරියනය
pterodactyl=ටෙරොඩැක්ටිල්
pteropsid=ටෙරොප්සිඩා ශාකය
pteropsida=ටෙරොප්සිඩා
pterygoid=ගරුකාභය
ptobe=කූරු ගසා බලනවා | ගවේෂණය කරනවා | බලවත් සෝදිසිය | හොඳට සෝදිසිකර බලනවා
ptomaine=කුණු වූ මස් ආදියෙහි ඇතිවන විෂ | ටෝමේන්
ptosis=පාතය
pty=හිමිවත් සමාගම
ptyalin=ටයලින්
ptysis=ප්‍රාගාකාරය
pub=අවන්හල
pubertas=යූනෝදය | යූවනෝදය | යොවුනුදය
puberty=මල්වර වීම | මල්වරවීම | යූනෝද කාලය | යූනෝදය | යොවුන් බව | යොවුනුදාව | යොවුනෝදය | යෞවනභාවය | යෞවනෝදය | ලිංගික පරිපාකය | වැඩිවිය | වැඩිවිය පැමිණීම
puberulus=මඳ බු
pubes=කෙසුරක | යටිබඩ
pubescence=තාරුණ්‍යයට පත්වීම | බු සහිත බව
pubescent=බූ සහිත | බූව ඇති | මල්වර වූ | යූනික | යෞවන
pubic=යූනික
pubic-leaves=යූනික පත්‍ර
pubis=උකුළු ප්‍රදේශයේ ඇති අස්ථිය | යූනිය
public=ජන | ප්‍රකට | ප්‍රසිද්ධ | පොදු | මහජන | මහජනයා පිළිබඳ වූ | රජය පිළිබඳ වූ | රාජ්‍ය | විඥාත | සාමාන්‍ය | සැල | හවුල්
public-house=තැබෑරුම
public-spirited=පොදු ජන හැඟීම් ඇති
publican=තැබෑරුම් කාරයා
publication=ප්‍රකටීකරණය | ප්‍රකාශනය
publicise=ප්‍රකට කරනවා
publicist=අන්තරජාතීය නීති ලේඛකයා | ආණ්ඩුක්‍රම ආදිය ගැන විශේෂඥයා
publicity=ප්‍රකටත්වය | ප්‍රචාරය | ප්‍රසිද්ධිය | සැල්
publicize=ප්‍රසිද්ධියට පමුණුවනවා
publish=පළ කරනවා | ප්‍රකට කරනවා | ප්‍රකටීකරණය කරනවා | ප්‍රකාශ කරනවා | ප්‍රකාශනය කරනවා | ප්‍රකාශයට පත් කිරීම | ප්‍රචාරය කරනවා | ප්‍රසිද්ධ කරනවා | ප්‍රසිද්ධ කිරීම
published=ප්‍රකාශිත
publisher=ප්‍රකාශක | ප්‍රකාශකයා | ප්‍රචාරකයා
publishing=ප්‍රකාශක | ප්‍රකාශන
puce=දුඹුරු පාට හා නිල් මිශ්‍ර වර්ණයක්
puck=හිතුවක්කාර දේවතාවා
pucka=ඉස්තරම්
pucker=රැල්ල | රැලි ගහනවා | රැලි ගැහෙනවා
puckered=වලිවන්
pudding=පුඩිම
pudding-face=මහත මුහුණක් ඇත්තා
pudding-head=මෝඩයා
puddle=අටවරල් | අළලනවා | මඩ කඩිත්ත
puddler=අළලනය
puddling=ඇළලීම | ඇළළුම් කිරීම
puddly=මඩ කඩිති ඇති
pudenda=රහස් අවයව
puell=නිසල කරනවා
puerile=තුච්ඡ | බොළඳ | ළාමක
puerility=ළාමකබව
puerperal=වැදූ ගෙයි
puerperium=අනුප්‍රසව සමය
puff=අමාරුවෙන් පිඹිනවා | අමාරුවෙන් හුස්ම හෙලනවා | ඉදිමෙනවා | දුම් අරිනවා | ප්‍රසිද්ධියට පමුණුවනවා | පාරට්ටු කරනවා | පාරට්ටුව | පිපෙනවා | පිම්බෙනවා | පුම්බනවා | පුයර මල | මහත් ප්‍රශංසාව | හති දමනවා | හතිය | හදිසි සුළං පහර | හුස්ම හෙළීම
puff-puff=කුඩා දරුවන් දුම්රියට කියන නම
puffer=වෙන්දේසි මිල පාරට්ටුකරු
puffery=පාරට්ටුව
puffin=කුරුල්ලෙක්
puffiness=ස්ථූලබව
puffing=දුමනය
puffy=ඉදිමුණු | පිපුණු | පිම්බුණු | ස්ථූල
pug=අටවරල් | කිරිමැටි | බලු වර්ගයක්
pug-nosed=මුක්කන්
puggaree=තොප්පිය වටේ දවටා බෙල්ලට වැටෙන සේ යෙදූ තුනී ස
puggree=තොප්පිය වටේ දවටා බෙල්ලට වැටෙන සේ යෙදූ තුනී ස
pugh!=වහ්
pugilism=බොක්සිං ක්‍රීඩාව | මුෂ්ටී යුද්ධය
pugilist=බොක්සිං ක්‍රීඩකයා
pugnacious=කලහකාමී | කලහප්‍රිය | පොරට කැමැති | රණකාමී
pugnacity=කලහකාරීත්වය | දබරයට ප්‍රියබව
puisne=කණිෂ්ඨ
puissance=ප්‍රබලබව
puissant=ප්‍රබල
puke=වමනය කරනවා
pukka=ඉස්තරම්
pulchritude=සුන්දරත්වය
pule=කෙඳිරිගානවා | කොඳුරනවා
pull=අදිනවා | ආකර්ෂණය | ඇද දමනවා | ඇදගෙන යනවා | ඇදිල්ල | ඇදීම | කඩනවා | බලපෑම | වාසිය | හැයුම
pull-off=ජය ගන්නවා
puller=හයනය
pullet=කුඩා කිකිළි
pulley=කප්පිය
pulling=ඇදීම
pullman=නිදන මැදිරි වලින් සමන්විත දුමිරිය
pullulate=අංකුර වැඩෙනවා | දලුලනවා
pullulation=අංකුරනය
pulmonary=පුප්ඵුසීය | පුපුඵුසීය | පෙනහැල්ල පිළිබඳ වූ
pulp=කල්කය | තළා පොඩි කරනවා | පල්පය | පාප්ප | මඳුළ | ලොඩිය | ලොඳ
pulpit=දේසනා කූඩුව | ධර්මාසනය
pulpy=ඉතා මෘදු | ලොඳ වැනි
pulsar=අඳුරු තාරකාව
pulsatance=ස්පන්දනාංකය
pulsate=නාඩි වැටෙනවා | විටින් විට ගැහෙනවා | ස්පන්දනය වෙනවා
pulsation=ස්පන්දනය | ස්ඵන්දනය | ස්ඵුරණය
pulse=ධාන්‍ය | නාඩි | නාඩි වැටීම | නාඩිය | ස්පන්දන | ස්පන්දනය | ස්පන්දය
pulser=ස්පන්දකය
pulses=මාධභෝග | මාෂ | මාෂබෝග
pulsometer=පල්සොමීටරය | ස්පන්දමානය
pulverization=කුඩු කිරීම
pulverize=කුඩු කරනවා | සුණුවිසුණු කරනවා
pulvinate=සෝපධාන
pulviniform=උපධානරූපී
pulvinus=උපධානය
puma=අමෙරිකාවේ දිවි වර්ගයක්
pumice=ලුහු යමහල් පාෂාණ
pumice(stone)=ඔප හතු
pummel=මිට මොළවා ගසනවා
pump=පොම්ප කරනවා | පොම්පය | වතුර ආදිය අද්දවනවා | හුළං ඇතුළට යවනවා | හුළං පිට කරනවා
pump-valve=පොම්ප වෑල්වය
pumpernickel=ජර්මනියේ පාන් විශේෂයක්
pumping=කැවීම | පොම්ප කිරීම | පොම්පකිරීම
pumpkin=පුහුල් | ලබු | වට්ටක්කා
pumpkins=පුහුල්
pumpship=මූත්‍ර | මූත්‍ර කරනවා | හුජ්ජ
pun=කොටනවා | ශ්ලිෂ්ට | ශ්ලේෂ | ශ්ලේෂය | ශ්ලේෂාර්ථ දක්වනවා | ශ්ලේෂාර්ථය | ශ්ලේෂෝක්තිය
punch=අනුගාමිය | කාවදින ගතිය | ඡිද්‍රකය | පොංචිය | පොන්සා | බහුබූතයා | බුකුල් පහර | මිටින් අනිනවා | මිටින් දෙන පහර | මුෂ්ටි පහර | වේගය | සැරකම | සිදුරු කරනවා | සිදුරුකරනය | සෙල්හිඳ
puncheon=අනුකුරුපාව | අනුගාමිය
puncher=පොංචිය
punching=ඡිද්‍රණය | විදීම
punchy=බලවත්
punctate=තිත් වැටුණු
punctiform=තිත් වැනි
punctilio=උත්සවයේ උච්ච අවස්ථාව
punctilious=සියුම් ලෙස සොයා බලන
punctual=කාලඥ | කාලානුගත | නියමිත වේලාවට වැඩකරන
punctuality=කාලඥතාව | කාලානුගතිකත්වය | නියමිත වේලාවට වැඩකිරීම
punctually=කලට වේලාවට
punctuate=විරාම තබනවා | විරාම ලකුණු යොදනවා
punctuation=විරාම ලකුණු | විරාම ලකුණු යෙදීම | විරාමය
puncture=කුඩා සිදුර | කොත්තු කරනවා | ද්‍රකය | විදුම | වේධනය | සිදුර | සිදුරු වෙනවා | හිල
pundit=උගතා | පණ්ඩිතයා
pungency=කටුකබව
pungent=අමිහිරි | කටුක | කාවදින | තියුණු | දිව හාරවන | සිත් රිදවන
punish=අච්චු කරනවා | දඬුවම් කරනවා
punishable=දඞුවම් කළ හැකි
punishment=අච්චුව | දඬුවම | දඩ | දණ්ඩනය | මට්ටුව | වද | වදක | වධ | වධක | වධය
punitive=දණ්ඩනීය | දාණ්ඩික
punk=නොවැදගත් දේ | නොවැදගත් පුද්ගලයා
punka=පංකාව
punkah=පංකාව
punkan=පලතුරු වට්ටිය
punkudutivu=පුවඟුදිවයින
punner=අත් තලනය | තාප්ප මෝල
punnet=වට්ටිය
punster=ශ්ලේෂප්‍රියයා
punt=රිටකින් බෝට්ටු පදිනවා | සූදුවෙහි යෙදෙනවා
punter=ඔට්ටු අල්ලන්නා
puny=ඉතා දුර්වල | කුරු | පුංචි
pup=කුක්කන් වදනවා | බලු කුක්කා
pupa=කෝශස්ථ ෂට්පදිකයා | පිලවා
pupil=අතවැසියා | අන්තේවාසික | ආරක්ෂිතයා | කණිනිකාව | ගෝලයා | ගෝළයා | ශිෂ්‍යයා
pupilage=ගෝළකම | බාලාවස්ථාව
pupilary=කළු ඉංගිරියාව පිළිබඳ | ශිෂ්‍යභාවය පිළිබඳ | ශිෂ්‍යාවස්ථාව පිළිබඳ
pupillage=ගෝළකම | බාලාවස්ථාව
pupillary=කළු ඉංගිරියාව පිළිබඳ | ශිෂ්‍ය | ශිෂ්‍යභාවය පිළිබඳ | ශිෂ්‍යාවස්ථාව පිළිබඳ | ශෛෂව
pupilloscope=කණිනිකේක්ෂය
puppet=කෝනංගියා | බෝනික්කා | රූකඩය | රූකඩයක් වැනි අය | රූකඩයා | සල ඉහකඩ
puppeteer=රූකඩ නටවන්නා | රූකඩ නටවන්නී
puppetry=රූකඩ කලාව | රූකඩ නැටවීම
puppy=ජේත්තුකාරයා | පැංචා | පැටවා | බලු කුක්කා
pur=සතුට දක්වනවා
purblind=අවිචක්ෂණ | මන්දබුද්ධික | මඳක් අන්ධ වූ
purchase=අමාරුවෙන් ලබා ගන්නවා,ක්‍රය | විකිණුම | ගැනුම | තුන්වාරු වාසිය | මිලට ගත් දේ | මිලට ගන්නවා | මිලට ගැනීම | මිලට ගැනුම | මිලදී ගැනීම
purchaser=කිණුම්කරු | ගැනුම්කරු | ගැනුම්කාරයා
purchasing=ක්‍රය | මිලදී ගැනීම
purdah=තිරය | පර්දාව
pure=අමිශ්‍ර | අසංකීර්ණ | තනි | තනිකර | නිමල | නිර්දෝෂ | නිර්මල | නුමුහුන් | පරිශුද්ධ | පවිත්‍ර | පිරිසිදු | පිරිසුදු | විමල | ශුද්ධ | සංශුද්ධ | සුද්ද | සුදු | හුදු
puree=යොදයක් ලෙස සාදා ගන්නා පොඩිකරන ලද එළවලු හා පල
purely=හුදෙක්
purgation=විමෝචනය | ශෝධනය
purgative=පවිත්‍ර කරන විරේචක | විරේකය | විරේචක | විරේචන බෙහෙත
purgatives=රේචකය
purgatory=පීඩා ස්ථානය | ශුද්ධ ගිනි ස්ථානය
purge=පවිත්‍ර කරනවා | විමෝචනය කරනවා | විරේකය | විරේචන
purgo=පර්ගා
purification=පරිශෝධනය | පවිත්‍රණය | පවිත්‍රිකරණය | පවිත්‍රීකරණය | ව්‍යවදානය | ශුද්ධිය
purificatory=පාචන | ශෝධක
purifier=සංශෝධකය
purifler=සංශෝධකරය
purify=පවිත්‍ර කරනවා | ශුද්ධ කරනවා | සාහනවා | සුපිරිසිදු කිරීම
purin=පියුරින්
purine=පියුරයින්
purism=පවිත්‍රතාවාදය | ශුද්ධතාවාදය | ශුද්ධවාදය
purist=භාෂාශුද්ධි වාදියා
puritan=අසභ්‍ය දේ අතිශයින් පිළිකුල් කරන
puritanic=අසභ්‍ය දේ අතිශයින් පිළිකුල් කරන
puritanical=අසභ්‍ය දේ අතිශයින් පිළිකුල් කරන
puritanism=අතිපරිශුද්ධිවාදය | උග්‍රචාර වාදය | උග්‍රාචාරවාදය | පියුරිටන් වාදය | පියුරිටන්වාදය
purity=නිර්මලත්වය | නුමුහුම | පවිත්‍රතාව | පාරිශුද්ධිය | පාශුද්ධිය | විශුද්ධිය | ශුද්ධිය | සංශුද්ධ කරනවා | සම්ප්‍රසාදය
purl=ගෙත්තම් කරනවා | ශබ්ද ගලා යනවා
purler=ඔළුව වදින සේ බිම වැටීම
purlieu=අවට | මුඩුක්කුව | හාත්පස ප්‍රදේශය
purlin=අට්ටවාලය | අතුරු යටලීය | මැද යටලීය | වහලක ඇති තිරස් බාල්කය
purloin=අට්ටවාලය | මැද යටලීය | සොරාගන්නවා
purple=දම්පාට | දඹ | රජුන්ගේ වස්ත්‍රය | රාජගුරුප්‍රසාදින්ගේ වස්ත්‍රය
purport=අදහස | අදහස් වශයෙන් දක්වනවා | අභිප්‍රාය | අරමුණු කරනවා
purpose=අදහස | අදහස් කරනවා | අදියස | අභිප්‍රාය | අභිමතාර්ථය | අරමුණ | අර්ථය | අරුත | කාරණය | බලාපොරොත්තුව
purposeful=අදහසක් ඇති
purposefulness=අභිප්‍රායපූර්ණත්වය
purposelessly=නිකරුණේ
purposely=ඕනෑවටම
purposive=අරමුණ ඇති | අර්ථවත් | සාර්ථ
purposiveness=සාරථභාවය | සාහිප්‍රායත්වය
purposivism=ආලම්බන වාදය
purpura=පර්පියුරාව
purr=ඤාව්ගානවා | සතුට දක්වනවා | සතුට දැක්වීම
purse=අකුළනවා | ඔලගුව | පසුම්බිය | මඩිය | මඩිස්සලය | සැඹිලිය | හැඹිලිය
purse-proud=ධනය නිසා උඩඟු
purser=නැවේ මුදල් භාරකාරයා | නෞගණකයා
pursuance=ක්‍රියාවෙහි යෙදීම
pursue=එළවාගෙන යනවා | කර ගෙන යනවා | නොනැවත කරගෙන යනවා | පසුපස්සේ යනවා | ලුහුබඳිනවා
pursuer=පැමිණිලිකරු | ලුහුබැඳ යන්නා
pursuit=නොනැවත කරගෙන යාම | පරිශීලනය | ලුහුබැඳ යාම | ව්‍යාපාරය | වැඩේ | සෙවීම
pursuitmeter=අනුසරණ මානය
pursy=හති දමන
purulent=සැරව වෑහෙන
purvey=ආහාර පානාදිය සපයනවා
purveyance=ආහාර පානාදිය සැපයීම
purveyor=ආහාර පානාදිය සපයන්නා | සපයන්නා
purview=අදහස | විෂය පාත්‍රතාව | විෂයපාත්‍රතාව | සීමාව
pus=පූයා | සජස | සාරේ | සැරව | හැරව
push=අමාරුව | ඉක්මන් කරවනවා | ඔබනවා | තද කරනවා | තල්ලු කරනවා | තල්ලු කිරීම | තෙරපනවා | බල කරනවා
push-pull=යැතුම් හැයුම්
pusher=හොරෙන් මත්ද්‍රව්‍ය විකුණන්නා
pushful=දියුණු වීමට උත්සාහ කරන | මහන්සි වී වැඩ කරන
pushing=දියුණුවට ආශා ඇති
pushy=උද්‍යෝගිමත්
pusillanimity=බයාදුකම
pusillanimous=නියාලු | බයාදු
puss=බළලා
pussy=බළලා
pussycat=බළලා
pussyfoot=ඉතා ප්‍රවේශමින් ක්‍රියාකරනවා
pustular=බිබිලි වැනි
pustulate=බිබිලි සහිත | සැරව ඇති ගෙඩියක් හැදෙනවා
pustule=පූයිකාව | බිබිල | සැරව ඇති බිබිල
pustulose=බිබිලි සහිත
put=ඉදිරිපත් කරනවා | තබනවා | දමනවා | යොදනවා | ලනවා
put-lock=පලංචි රැන්ද
put-log=පලංචි රැන්ද
put-up=කපටි
putative=අනුමාන ලෙස සලකනු ලබන | උත්ප්‍රේක්ෂීය
putrefaction=කුණු වීම | කුණුවීම | පූතිභවනය | පූතිය
putrefy=කුණු වෙනවා
putrescence=පූතිභවනය
putrescent=තරමක් කුණු වූ
putrid=කුණු වූ | දුගඳ හමන | පල් | පූති | පූයිත
putsch=දේශපාලන විප්ලවයක් කිරීමට උත්සාහ කිරීම
putt=බෝලයක් පිත්තකින් තල්ලු කරනවා
puttee=කකුලේ ඔතන පටිය
putter=බෝලයක් පිත්තකින් තල්ලු කිරීමට යොදන පිත්ත
putto=කුමර මල්සර
putty=පොටි
puy=පුවය
puzzle=තේරවිල්ල | නොතේරෙන ප්‍රශ්නය | ප්‍රහේලිකාව | වල්මත් කරනවා | ව්‍යාකූල කරනවා | ව්‍යාකූලත්වය
puzzle-experiment=ප්‍රහේලිකා සම්පරීක්ෂණය
puzzled=අන්දබූත
puzzlement=සංභ්‍රමය
puzzler=දුෂ්කර ප්‍රශ්නය
puzzolane=පොසොලානා
pyaemia=පූයරක් තතාව | ලේ විෂවීම
pycnidiophore=පික්නීඩිධරය
pycnidiospore=පික්නොකොනීඩිය
pycnidium=පික්නීඩිය
pycnoconidium=පික්නොකොනීඩිය
pycnogonidium=පික්නොකොනීඩිය
pycnometer=පික්නෝමීටරය
pycnospore=පික්නොස්පෝරය
pyelitis=නිපාත දාහය
pyelography=නිපාත රේඛණය
pygmies=පිග්මිවරු
pygmy=අඟුටුමිට්ටා | ඉතා කුඩා | ඉතා සුළු | පිග්මියා | වාමනයා
pyjamas=පිජාමා
pyknic=පික්නික් වර්ගය
pyknometer=පික්නොමීටරය
pylon=අටලුව
pylorus=අලාරය | පයිලොරසය
pyonephrosis=පයෝනැප්‍රෝසියාව | පූයවක්කෝසියාව
pyopneumothorax=පූය සමීරඋරස
pyorrhoea=දත්මුල් දියව යාම | පයරියව
pyosalpinx=සපූය කාහලිකය
pyracantha=සුදුමල් ඇති කටු සහිත සදාහරිත ශාකයක්
pyramid=චතුර්භුජාංශ ස්තූපය | පිරමිඩය | පිරමිඩ් | පිරමීඩය
pyramidal=පිරමිඩාකාර
pyramiding=කුළු නැගුම | කුළු නැඟුම
pyramidon=පිරමිඩොන්
pyranose=පයිරනෝස්
pyre=දරසෑය | චිතකය
pyrenoid=පයිරනොයිඩය
pyrenomycetes=පයිරනොමිසෙටේස්
pyrethrum=කෘමිනාශක සැදීමට ගන්නා මල් ගසක් | පයිරීත්‍රම්
pyretic=උණ ඇති කරවන
pyrex=වීදුරු විශේෂයක්
pyrexia=උණ | ජ්වරය
pyrheliometer=අග්නිහේළිමානය | සුර්යවිකිරණමානය
pyribenzamine=පිරිබෙන්සමින්
pyridoxine=පිරිඩොක්සින්
pyriform=පේරහැඩ
pyrimidine=පිරිමිඩින්
pyrites=පයරයිට් | යපස්
pyroborate=පයිරොබෝරේට්
pyrocondensation=තාපසංඝනනය
pyroelectricity=අග්නි විදයුතය | තාපවිද්‍යුතය
pyrolusite=තයිරොලුසයිට්
pyrolysis=තාපවිච්ඡේදනය
pyromania=දහනෝන්මාදය | දාහනෝන්මාදය
pyrometer=අග්නිමානය
pyrometric=අග්නිමිතික
pyrometry=අග්නිමිතිය
pyrophore=අග්නිධරය
pyrosis=බඩදැවිල්ල | රාමතැල්ල | රාමතෙල්
pyrotechnics=ගිනිකෙළි | ගිනිකෙළි කර්මාන්තය | ගිනිකෙළි තැනීමේ ශාස්ත්‍රය | ගිනිවෙඩි කර්මාන්තය
pyroxis=පයිරෝසියාව
pythagoreanism=පයිතගෝරියානුවාදය
python=දාර | පිඹුරා | පේන කියන්නා | පොළඟා | පොළොං
pythoness=පේන කියන්නිය
pyx=සත්ප්‍රසාද මංගල්‍යයට ආරක්ෂා කර තබන පාන්
pyxidate=සපිධාන
pyxidium=පිටකය
