r.a.x.=ග්‍රාමීය ස්වයංක්‍රිය විනිමය
r.a.x.=ග්‍රාමීය ස්වයංක්‍රිය විනිමය
r.f.=රේඩියෝ සංඛ්‍යාතය
r.p.m.=මිනිත්තුවට පරිභ්‍රමණ වාර
r.v=වරිපනම් අගය
r.v.=වරිපනම් අගය
r/d.=අණකරු විමසනු
rabbet=තට්ටුව | තට්ටුවක් ඇර පුරුද්දනවා
rabbi=යුදෙව් ධර්මාචාර්යයා
rabbin=යුදෙව් ආගමික නායකයා
rabbit=නිවටයා | රට හාවා
rabble=නොහික්මුණු රංචුව | නොහික්මුණු සමූහය | රැබල
rabbling=රැබල ගෑම
rabelaisian=අශ්ලීල | අසභ්‍ය | රැබලේසියානු
rabid=අන්තගාමි | උමතු | පිස්සු | වියරු වැටුණු
rabidity=උමතුව | පිස්සුව
rabidness=උමතුව | පිස්සුව
rabies=ජලභීතිකා රෝගය | පිස්සු බලුරෝගය රෝගය | පිස්සුබලු රෝගය | රභස | රහස
rabit=රටහාවා
rabrication=කල්පිතය
race=අසුන් විහිදීම | අසුන් විහිදුවනවා | ආර | ජතිය | ජාතිය | තරඟ දිවීම | තරඟයට දුවනවා | පෙළපත | රේසරය | රේස් දිවීම | වංශය | වර්ගය | වර්ගයා | විත ගමන | වේගයෙන් ක්‍රියා කරනවා | වේගයෙන් ක්‍රියා කරවනවා | වේගයෙන් දුවනවා | සනුවරු | සනුහර | සැර දියපහර
racegoer=තුරඟ තරඟයට යන්නා
racemate=රැසිමේටය
racemation=රැසීමිකරණය | රැසීමීකරණය
raceme=ඒකාක්ෂය | රැසීමය
racemic=රැසීමික
racemism=රැසීමිකතාව
racemization=රැසීමිකරණය | රැසීමීකරණය
racemize=රැසීමී කරනවා
racemized=රැසීමීකෘත
racemose=ඒකාක්ෂ
racer=දුවන්නා | රේස්කරත්තය
rachilla=අනුප්‍රාක්ෂය | ප්‍රාක්ෂිකය
rachis=ප්‍රාක්ෂය
racial=ජාතියක් පිළිබඳ | ජාතිවාදී | ජාතීය | වර්ගීය | වාර්ගික
racialism=ජාතිවාදය | වර්ගවාදය
raciness=සුරසභාවය
racing=අධිධාවනය | අසුන් විහිදුවීම | තරඟයට දිවීම | වේගයෙන් දිවීම
raciology=වර්ගවේදය
racism=වර්ගවාදය
rack=දැති තලව්ව | බක්කිය | රාක්කය | රාමුව | වධ කරනවා | වධ දෙනවා | වධකිරීමේ යන්ත්‍රයක් | විනාශය | වෙහෙස කරනවා | සහල්ල
rack-rent=අධිකතර කුලිය | ඉහලම බදු කුලිය | පූර්ණ බදු කුලිය
racket=උපා මාරුව | කූටකම් කරනවා | ගාල ගෝට්ටිය | ජාවාරම | ටෙනිස් පිත්ත | බලවත් කලබලය | ශබ්ද කරමින් තැන තැන යනවා
racketeer=කූට ජාවාරම්කාරයා | ජාවාරම්කාරයා | ප්‍රයෝගකාරයා | වංචාකාරයා
rackets=ක්‍රීඩාවක්
rackety=කලබල සහිත | ඝෝෂාකාර | විනෝදප්‍රිය
racking=ගැරීම | දැති තලව් දිවවුම
raconteur=විකට කථා කියන්නා
racoon=රැකූන්
racy=රසවත් | රාග නිහ්ශ්‍රිත | සප්‍රාණ
rad=අරය | රැඩය
radar=රේඩා | රේඩාර් කිරණ
raddle=අතු නමා වියාපු වැට | එකට ගොතනවා
radial=අරීය | කේන්ද්‍රගාමී | රශ්මි ආකාරයෙන් විහිදෙන | රැස් සහිත
radian=රේඩියන | රේඩියනය | රේඩියන්
radiance=තෙවුම | ද්‍යුති | දිදුල | දිලුම | දිස්නය | දිළිසීම | දීප්තිය | දෝ | ප්‍රභාව | බැබලීම | විකිරණය | සමුද්දීපනය
radiant=කාන්තිමත් | තේජස්වී | දීප්තිමත් | දුළ | ප්‍රීතියෙන් පිණාගිය | රශ්මි විහිදෙන | රුවර | විකිරණ | සරා
radiate=පැතිරෙනවා | මධ්‍යස්ථානයකින් නිකුත් වෙනවා | රැස් විහිදුවනවා | රැස් විහිදෙනවා | විහිදෙනවා | හාත්පස පතුරුවනවා
radiated=විකීර්ණ
radiation=කිරණ ස්ඵුරණය | රැස් විහිදීම | විකිරණ | විකිරණය
radiator=රේඩියේටරය | විකිරකය
radical=අත්‍යන්ත | අන්තගාමී | ආමූල | ආමූලය | කරණිය | ඛණ්ඩකය | ධාතුවෙන්ම අටගත් | ප්‍රධාන | මූලික | රැඩිකල්වාදී | විප්ලවවාදියා | සම්පූර්ණ
radicalism=උන්මූලවාදය | රැඩිකල්වාදය
radicand=ආමූලකය
radicellose=සමූලාභ
radices=මූල සංඛ්‍යා
radicle=බීජ මූලය | බීජමූලය
radio=ගුවන් විදුලි පණිවුඩ යවනවා | ගුවන් විදුලිය | ගුවන් විදුලිය ප්‍රචාරය | ගුවන්විදුලිය | රෙදෙව්ව | රේඩියොව | රේඩියෝ | රේඩියෝව
radio-active=විකිරණශීල
radio-activity=විකිරණශීලතාව
radio-carbon=විකිරණ කාබන්
radio-frequency=ගුවන් විදුලි තරංගවල සංඛ්‍යාතය | රේඩියෝ සංඛ්‍යාතය
radio-link=රේඩියෝ සම්බන්ධය
radioactive=විකිරණශීල
radioactivity=විකිරණශිලතාව | විකිරණශීල කාර්යය | විකිරණශීලතාව
radioautograph=විකිරණශීල ස්වයංරූපය
radiobeacon=රේඩියෝ සන්වැට
radiocar=රේඩියෝ කාරය
radiochemistry=විකිරණ රසායන විද්‍යාව
radiogram=ගුවන් විදුලි තරංග මගින් යවනු ලබන පණිවුඩය | විකිරණ ලේඛය
radiograph=විකිරණ රේඛකය
radiography=විකිරණ රේඛණය | විකිරණ ලේඛණය | විකිරණරේඛනය
radioisotope=විකිරණ සමස්ථානිකය | විකිරණශීලී සමස්ථානික
radiolead=විකිරණ ඊයම්
radiolocation=රේඩියෝ නිශ්චයනය
radiologist=රශ්මි විද්‍යාඥයා | විකිරණවේදිය
radiology=රශ්මි විද්‍යාව | විකිරණ වේදය | විකිරණවේදය
radiolucent=විකිරණභාසක
radioluminescence=විකිරණ සන්දීප්තිය
radiometal=රේඩියෝ ලෝහය
radiometallography=විකිරණ ලෝහරේඛය
radiometer=විකිරණමානය
radiometry=විකිරණ මිතිය
radiomicrometer=විකිරණ මයික්ක්‍රොමීටරය | සූක්ෂ්ම විකිරණමානය
radionitrogen=විකිරණ නයිට්‍රජන්
radionuclide=විකිරණ නියූක්ලයිඩය
radiophosphorus=විකිරණ පොස්පරස්
radioscope=විකිරණීක්ෂය
radiosonde=රේඩියෝ සොන්ඩේ
radiotelegraph=රේඩියෝ දුරරේඛය
radiotelegraphy=රේඩියෝ දූරරේඛනය
radiotherapy=විකිරණ චිකිත්සාව
radiothor=විකිරණ දර්ශකය
radiovision=විකිරණ දර්ශණය
radish=රාබු
radium=රේඩියම්
radius=අරය | අර්ධවිෂ්කම්භය
radix=ධාතුව | මුලක | මූලක | මූලකය | මූලසංඛ්‍යාව
radon=රේඩොන් | විකිරණශීලී වායුමය මූලද්‍රව්‍යයක්
radox=රේඩොක්ස්
raffinase=රැපිනේස්
raffinose=රැපිනෝස්
raffish=අශිෂ්ට | තක්කඩි
raffle=නොම්මර ඇදීම | ලොතරැයිය | සීට්ටු අදිනවා
raft=උඩුප | පඩව්ව | පසුර | පහුර | ප්ලව
rafter=ගොනැස | තෙප්පම | පරාලය
rag=කඩමාල්ල | කලබල කරනවා | කොංව කරනවා | පඩංගුව | පහන්කඩ | පාන්කඩ | බණිනවා | මාල්ල | රෙදිකඩ | වැරහැල්ල | විහිළු තහළු කිරීම | සමච්චලය | සමච්චල් කරනවා | හංකඩ
ragamuffin=කිලුටු ඇඳගත් කාලකණ්ණියා | කිලුටු ඇඳගත් කොල්ලා
rage=ඉතා තද ආශාව | ගෝළු ගන්නවා | ප්‍රකෝපය | පිස්සුව | බලවත් උදහස දක්වනවා | බලවත් කෝපය | බලවත් කෝපය දක්වනවා | මහත් වේගයෙන් පැතිරෙනවා | වියරුව | වියරුවෙන් මෙන් හැසිරෙනවා
ragged=කඩතොලු වූ | වැරහැලි ඇඳගත්
ragi=කුරක්කන්
raglan=කබා විශේෂයක්
rags=පහන්කඩ
ragtime=සංගීත විශේෂයක්
ragwort=කෑලෑ ගසක්
raid=ආක්‍රමණය | ප්‍රහාරය | පැමිණෙනවා | වටලනවා | වටලෑම | ව්‍යක්‍රමණය | වැටලීම
rail=අත්වැල | ගරහනවා | ගරාදි වැට | ගරාදිය | පීල්ල | බණිනවා | මාවරය | රාමු පටිය | රාමුපටිය | රේගලය | රේල් පීල්ල | හරස් පොල්ල
railex=රේලෙක්ස්
railing=ගරාදි වැට | වැට | වේදිය
raillery=උපහාසය | සමච්චලය | සරදම
railroad=මිරිය පාර
railway=පීලි මඟ | මිරිය | මිරිය පාර | මිරිය මඟ
railway-crossing=මිරිය මාර්ගය හරහා පාර වැටුණු තැන | මිරිය මාර්ගය හරහා පාර වැටුණු තැන පිහිටි ගේට්ටුව
railways=මිරිය මාර්ග
raiment=ඇඳුම් | වස්ත්‍ර
rain=ගලා වැටෙනවා | මේඝ | වර්ෂණය | වර්ෂාව | වසිනවා | වහර | වහිනවා | වාතවලාහක | වැස්ස | වැසි | වැසිවලාව | වැහි | වෘෂ්ටි
rain-bow=සුරසැව්
rain-proof=වැස්සෙන් අනතුරු නොවන
rainbow=ඉන්ද්‍රචාපය | දේදුන්න
rainfall=වර්ෂාපතනය | වැසිපල | වෘෂ්ටිපාතය
raingauge=වර්ෂාමානය
rainwash=වැහි සෝදාව
rainy=වැසි සහිත
raise=ඇති කරනවා | ඉදි කරනවා | ඉහළ දමනවා | උඩ ගන්නවා | උසස් කරනවා | උස්සනවා | ඔසවනවා | නංවනවා | නගනවා | නගිනවා | නඟනවා | නඟිනවා | නැඟිටුවනවා | පහළ කරවනවා | බෝ කරනවා | රැස් කරනවා | ලබාගන්නවා | වවනවා | වැඩි කරනවා | හුවනවා
raisin=වියලි මුද්‍රික ඵල
raising=උත්තරණය | මුදුන් කිරීම
raisins=වියැළි මිදි
raj=පාලක බලමණ්ඩලය | පාලනය | රාජ්‍යය
rajaghara=රාජඝරය
rajah=ඉන්දියාවේ ප්‍රධානයෙක් | ඉන්දියාවේ රජෙක්
rake=අවුස්සනවා | ආනතිය | එකතු කරනවා | දැතිගොයියා | ධුර්තියා | ධූර්තයා | පස්සට ඇල කරනවා | පස්සට ඇල වෙනවා | පැත්තකට ඇල කරනවා | පැත්තකට ඇල වෙනවා | පිළිබෑවුම | මතු කරනවා | මුවහත් කෝණය | රේක්ක ගානවා | රේක්කය | සල්ලාලයා
rakish=ඇල වූ | මනමාල | සල්ලාල
rallentando=ක්‍රමයෙන් වේගය අඩුවන සංගීතය
rally=ජනහමුව | නැවත රැස් කරනවා | පෙළපාළිය | යළි සඵලත්වයට එළඹෙනවා | රැලිය | රැළිය
ram=ජම්බාර ගහනවා | ජම්බාරය | තදකොට ඔබනවා | තළනය | තළනවා | තිරෙළුවා | පොඩිපට්ටම් කරනවා | බැටළුවා | මේෂ රාශිය | රැමිය | වැරෙන් පහර දෙනවා
ramadan=නෝම්බි කාලය | මුස්ලිම්වරුන්ගේ උපවාස සමය
ramal=ශාඛීය
ramapithecus=රාමාපිතෙකුස්
ramble=වැල්වටාරම් දොඩනවා
rambler=තැනින් තැන ඇවිදින්නා | රෝස වැල
rambling=අනියමිත | දිගින් දිගට වූ
rambutan=රඹුටන්
ramekin=පුලුස්සා ගන්නා කුඩා මත්ස්‍යයෙක්
ramenta=සුඹුළු
ramie=රැමී | රැමී කෙඳි
ramification=අතු විහිදීම
ramifications=අතු විහිදීම | ශාඛනය
ramiform=ශාඛාරූපී
ramify=අතු විහිදුවනවා | අතු විහිදෙනවා | අතු සේ විහිදෙනවා | නොයෙක් අතට පැතිරෙනවා | විහිදෙනවා | ශාඛා විහිදුවනවා
rammer=තළනය | මොහොළ
ramming=තැළීම
ramose=ශාඛා සහිත
ramous=ශාඛා සහිත
ramp=ගෝට්ටිය | පල්ලම | පස්සා ගාතයෙන් පනිනවා | බෑවුම | බෑවුම් මඟ | මහත් කලබලය | මහත් කලබලයෙන් හැසිරෙනවා | මහත් කෝපයෙන් හැසිරෙනවා | රැම්පය | හැඩ පෝරුව | හැඩපෝරුව
rampage=කලබලයෙන් දුවපැන යනවා | බැණ වදිනවා | මහත් කලබලය | මහත් කෝපය
rampageous=කලබල සහිත | ගෝට්ටි කරන
rampant=ඉවසුම් නැති | කෝපයෙන් හැසිරෙන | බහුලව පැතුරුණු | මැඩපැවැත්වීමට දුෂ්කර
rampart=ආරක්ෂාව | තාප්පය | පවුර | බලකොටුවේ ප්‍රාකාරය
ramshackle=ගරා වැටුණු
ramuli=රිකිලි
ramulous=රිකිලි බහුල
ramus=ඩාලය
ranch=විශාල ගොවිපළ
rancid=පිලුණු වූ | මුඩු
rancidity=මුඩු බව
rancorous=දේවේෂ සහගත
rancorously=දේවේෂ සහගතව
rancour=දැඩි ද්වේෂය | බද්ධ වෛරය
rand=දකුණු අප්‍රිකාවේ මුදල්
random=අහඹු | අහඹු ලෙස | ආවාට ගියාට කෙරෙන | නොතේරු | නොසැලකිල්ලෙන් කරනු ලබන | සසම්භාවිතාව | සසම්භාවී | සසම්භෘවී
random-courses=විසම ගල් වරි
randomisation=සසම්භාවී ගමන්
randomization=සසම්භාවීකරණය
randomness=සමසම්භාවිතාව | සසම්භාවිතාව
randy=කාමුක
ranee=දේවී | මෙහෙසිය
rang=ඉණිමං පෙත්ත
range=අඩු වැඩි වෙනවා | අන්තරය | කඳුවැටිය | ගමන් කරනවා | නිදැල්ලේ යනවා | පංක්තිය | පරාශය | පරාසය | පැතුරුම | පෙළ | පෙළ ගැසෙනවා | පෙළට තබනවා | පෙළට සිටිනවා | මාලාව | යාය | රැස | වැල | විෂය | ශ්‍රේණිය | හැසිරෙනවා
ranger=ආරණ්‍යපාලකයා | උයන්පල්ලා
ranging=පරාස මැනීම | පෙළ ගැන්වීම
rani=දේවී | මෙහෙසිය
rank=අධික | අනුතැන | අනුස්ථානය | අනුස්ථීතිය | ඇතුළත් කරනවා | උසස් තත්ත්වය | තනතුර | තරාතිරම | තරාව | දුගඳ හමන | නම්බුනාමය | නිලය | පංක්ති වශයෙන් බෙදනවා | පංක්තිය | පදවිය | පිළිකුල් කටයුතු | පෙළ | පෙළට තබනවා | පෙළට වැටෙනවා | ශ්‍රේණිය
rank-and-file=සේවක කාරකයෝ | හමුදා ශ්‍රේණිය
rank-list=තරා වැල
ranking=උසස් | තරා කිරීම | මානනීය
rankit=තරාකය
rankle=අමනාපකම් ඇති කරනවා | එදිරියක් මෙන් පවතිනවා | සිතේ පැසවනවා
rankness=අධික බව | දුගඳ
ranks=නිල නොලත් සාමාන්‍ය භටයෝ
ransack=අවුස්සා බලනවා | කොල්ලකනවා | බඩුබාහිරාදිය පැහැරගන්නවා
ransom=කප්පම | කප්පම් දී නිදහස් කරගන්නවා | මිදුම් දඩය | මිදුම් මිල | මිදුම්මිල | වන්දි ගෙවා නිදහස් කරගන්නවා | වන්දිය
rant=තර්ජනය කරනවා | බැණ වදිනවා | වල්පල් දොඩවනවා
ranter=වල්පල් දොඩවන්නා
ranunculus=ගස් වර්ගයක්
rao=රාස
rap=අවලංගු කාසිය | ඉක්මන් පහර | ඉක්මන් පහරක් දෙනවා | තට්ටු කරනවා | තට්ටු කිරීම | සොච්චම
rapacious=අතිලෝභී | ඉතා කෑදර | ඉතා ගිජු | ගසාකන
rapacity=මසුරුකම
rape=කන්‍යා දූෂණය කරනවා | තනිස් කරනවා | තනිස්කරණය | දූෂණය | බලාත්කාරය | බලෙන් කරන දූෂණය | බලෙන් ගෙනයනවා | බලෙන් පැහැරගෙන යාම | ස්ත්‍රි දූෂණය | ස්ත්‍රී දූෂණය | සාහසය
raphe=සේවනිය
raphia=රැපියා
raphide=සුවස්ඵටිකය | සුවිස්ඵටිකය
rapid=ඉක්මන් | ශීඝ්‍ර
rapidity=ඉක්මන් බව | යුහුව | වේගය
rapids=ඇල්ල | සැඩවරය
rapier=දෙපැත්ත කැපෙන සිහින් කඩුව
rapina=රපිනාව | සැහැසි කොල්ලය
rapine=කොල්ලය | බලෙන් පැහැරගෙන යාම | රපිනාව | සැහැසි කොල්ලය
rapping=තට්ටු කිරීම
rapport=අනුවර්තන | අනුසන්ධානය | ප්‍රියමනාප ඵලදායී සම්බන්ධතාව | සංග්‍රහණය | සබඳතාව | හිතවත්කම
rapproachment=සමගි සන්ධානය
rapprochement=නැවතත් මිත්‍ර වීම
raps=හඬසන්
rapscallion=තක්කඩියා
rapt=නිමග්න | ප්‍රීතියෙන් පිනාගිය
raptorial=කොල්ලකන | සොරාගන්නා
rapture=අත්‍යානන්දනය | අධික ප්‍රීතිය | ප්‍රහර්ෂය | මහත් ප්‍රමෝදය
rapturous=ප්‍රමුදිත
raquet=ටෙනිස් පිත්ත
rare=අරුම | කලාතුරකින් | කලාතුරකින් සිදුවන | ඝන නොවූ | තුනී වූ | දුර්ලභ | දුලබ | විරල | විශිෂ්ට
rarefaction=විරලනය
rarefication=විරලීකරණය
rarefied=විරලීකෘත
rarefy=ඝනත්වය අඩු කරනවා | ඝනත්වය අඩු වෙනවා
rarely=කලාතුරකින්
rareness=දුර්ලභත්වය
rarified=විරලීකෘත
rarity=දුර්ලභ දේ | දුර්ලභත්වය
rascal=කපටියා | තක්කඩියා | දුර්ජනයා | නීචයා | මගෝඩියා | හොරා
rascality=තක්කඩිකම
rascally=චණ්ඩි | තක්කඩි
rase=මකා දමනවා
rash=ඇඟේ සෑදෙන පලු | ඇඟේ සෑදෙන පලුකුෂ්ඨය | ඉක්මන් | කරප්පන් | කලබල සහිත | කුශ්ඨ | පලුව
rasher=තුනී ලුණු දැමූ ඌරුමස් පෙත්ත
rashly=අපරීක්ෂාකාරීව | ඉක්මන්
rashness=අවිචාරවත් බව | ඉක්මන්කම
rasp=කුපිත කරනවා | දැති ලොකු පීර | පීරකින් මෙන් සූරනවා | පීරිගානවා | පුල්ලෝරම | රාස්තුව | රාස්පය | රාස්පුව | වටපුල්ලෝරම
raspberry=ඔච්චමට කියන පදයක්
rasping=අමිහිරි | රළු හඬඇති
rat=මීයන් අල්ලනවා | මීයා | මූෂිකයා
rat-snake=ගරයා | ගැරයා,ගැරඬියා
rat-tat=තට්ටු කරන හඬ
rat-trap=මීකතුර
ratable=තක්සේරු කළ හැකි
ratafia=පලතුරු මද යොදා සාදනු ලබන බිස්කට් වෙසෙසක්
ratan=මාවේවැල | වේවැල | වේවැලින් කළ
ratatouille=එළවලු වලින් පිසින ලද ආහාරයක්
ratchet=දැතිරෝදය | රැවට්ටුව
rate=අනුපාතය | අනුපාතික | අනුපාතිකය | අර්ඝය | ගාස්තුව | තදින් බැණ වදිනවා | තරාතිරම | ප්‍රමාණය | වටිනාකම නියම කරනවා | වේගය | ශීඝ්‍රතාව
rate-cutting=ගාස්තු තරක් කිරීම
rate-payer=බදු ගෙවන්නා | වරිපණම් ගෙවන්නා | වරිපනම් ගෙවන්නා
rateable=තක්සේරු කළ හැකි
rateably=අනුපාතික ව
rated=ප්‍රමත | වැගැයූ
rates=පරිපනම් | පොළී | වරිපණම් | වරිපනම්
rather=අනික් අතට | එසේ නොවන | තරමක් | වඩා කැමැත්තෙන් | වැඩියෙන් | සත්තකින්ම
ratification=අනුමත කිරීම | අපරානුමත කිරිම | වලංගු කිරීම | සනාථ කිරීම
ratify=අපරානුමත කරනවා | වලංගු කරනවා | ස්ථිර කරනවා
rating=අනුපාතිකතාව | ඇගැයුම | තක්සේරු කිරීම | ප්‍රමාණනය | වැගයීම | වැගැයීම
ratings=යුද්ධ නැවේ නිල නොදරන නැවියෝ
ratio=අනුපාතය | අනුපාතිකය | ප්‍රමාණය | විචාර ශක්තිය
ratio-arms=අනුපාත බාහු
ratiocinate=තර්ක | වාද කරනවා
ratiocination=විතර්කණය | විතර්කනය
ration=අන්නාංශය | පංගුව | ලහ | ලා | ශලාක | සලාක | සලාක කරනවා | සලාකය | සීමාකොට බෙදා දෙනවා
rational=ආනුබුද්ධිය | තර්කාන්විත | තාර්කනික | තාර්කික | පරිමේය | බුද්ධිමත් | බුද්ධිමය | යුක්ති සහගත | සහේතුක | සිහිබුද්ධි ඇති | සුදුසු
rationale=තාර්කිකත්වය | තාර්කිකය | තාර්කිතත්වය | මූලකාරණය
rationalisation=තර්කාපණය | පරිමේයකරණය
rationalism=බුද්ධිවාදය | බුද්ධිස්වාතන්ත්‍රවාදය | හේතු ධර්ම වාදය | හේතුවාදය
rationalist=බුද්ධිවාදිය | බුද්ධිවාදියා | බුද්ධිස්වාතන්ත්‍ර වාදියා | හේතුවාදියා
rationality=තාර්කිකත්වය | බුද්ධිමත් භාවය | සහේතුකත්වය
rationalization=තර්කාපණය | පරිමේයකරණය | යථාර්ථකරණය | යුක්ත්‍යාභාසය | යුක්තියුක්තය | සුවිධානය
rationalize=පරිමේය කරනවා | සහේතුක කිරීම | සාධාරණ බව දක්වනවා | හේතු මවනවා
rationing=සලාකනය
ratline=නැවක ආවරණයක් සේ අදින ලණු
ratoon=නිරි | නිරි කිරීම | නිරිය
ratsbane=මී පාසානම්
ratsnake=ගැරයා
rattan=මාවේවැල | වේ | වේවැල | වේවැලින් කළ
rattle=ඉක්මන් දෙඩවිල්ල | කටකට යන ශබ්දය | කටකටායනය | කලබල කරනවා | කියවනවා | ශිංජනය
rattling=ඉතා හොඳ | ඉස්තරම්
rattus=රැටස්
ratty=මීයන්ට සම්බන්ධ
raucous=කර්කශ
raumparasite=අවකාශ පරපෝෂිතයා
ravage=ආලාපාළු කරනවා | කොල්ල කනවා | නාස්තිය | විනාශ කරනවා | විනාශය
rave=ගෝරනාඩු කරනවා | දොඩවනවා
ravel=පටලවනවා | පටලැවෙනවා
ravelling=සමාහාර ඉදිරී යෑම
raven=ඉතා කෑදර | දෝණකාකයා | බොහෝ බඩගිනි ඇති | ලොකු කළු කපුටා
ravenous=ඉතා කෑදර
ravenousness=කෑදරකම
ravine=කඳුර | ගිරිකඳුර
raving=බෙරිහන් දීම | මහත් ඝෝෂාව | වල්පල් කතාකරන
ravish=ධර්ෂය කරනවා
ravisher=ධර්ෂකයා
ravishing=සිත් කුල්මත් කරන
ravishment=අත්‍යානන්දය | අපහරණය | පැහැරගෙන යාම
raw=අඥ | අපාක | අමිශ්‍ර | අමු | ආම | ආමක | දළ | නිමුඩු | නිවුඩු | නුපුරුදු | නොනිමි | නොපිසනලද | පච්ච | පිළියෙල නොකළ | වතුර නොයෙදූ | ශීත සුළං ඇති | සුකුමාර
raw-material=අමු ද්‍රව්‍ය
rawlbolt=රෝල් බදැණය
rawlplug=රෝල් පේනුව
rawness=අමුබව | නොපැසීම
ray=අංශුමාත්‍රය | ඉතා ටික | කැලුම | කිරණ | කිරණය | තර | පැතලි මත්ස්‍යවර්ගයක් | බා | මඩු මාලුවා | මරිව | මෙර | මෙරජ | රද | රශ්මි | රශ්මිය | රස් | රැස්
rayon=කෘත්‍රිම පට වර්ගයක් | රේයොන්
rayonnism=කිරණවාදය
raze=මකා දමනවා
razor=ක්ෂුරය | කැරකැත්ත | ඛර | ඛුරය | දැළි පිහිය | දැළිපිහිය | වාසිය
razzle=දඩාවතේ යනවා
razzle-dazzle=මත්පැන් බොමින් කරන කලබල සහිත උත්සවය
razzmataz=අවනත නොවන ක්‍රියාව | ගාලගෝට්ටිය | රැවටිල්ල
re=ආපසු | ගැන | නැවත | පන | ප්‍රති | පිළි | පිළිබඳව | පිළිබඳව | පුන | පුනර් | පුනහ් | සම්බන්ධව
re-adjustment=පිළිසැකසුම
re-circulation=ප්‍රතිසංසරණය | පුනහ් සංසරණය
re-cross=පුනරේඛනය කරනවා
re-current=පුනරාවර්තන
re-cycle=ප්‍රතිචක්‍රීකරණය
re-delivery=නැවත බාරදීම
re-determination=පුනර්නිශ්චය
re-discount=පිළිවට්ටම් කරනවා
re-education=පුනරධ්‍යයනය
re-enact=නැවත පනවනවා
re-entrant=ඇතුළට යොමු වූ කෝණය | ප්‍රත්‍යාවෘත | ප්‍රතිඛාත | ප්‍රතිඛාතය
re-entry=නැවත ඇතුළුවීම
re-evaporation=ප්‍රතිවාෂ්පීකරණය
re-examination=නැවත පිරික්සුම | පිළි පිරික්සුම | පිළිපිරික්සුම
re-examine=නැවත පරීක්ෂා කරනවා
re-exchange=පිළිවිනිමය
re-exports=ප්‍රති අපනයන | ප්‍රති නිර්යාත | ප්‍රති නිර්යාථ
re-grading=නැවත ශ්‍රේණිගතකිරීම | ප්‍රති ශ්‍රේණිකරණය
re-hearing=නැවත ඇසීම
re-imbrusement=ප්‍රතිපූරණය
re-imbursement=ප්‍රතිපූරණය
re-incarnation=පුනරාවතාරය
re-infection=ප්‍රත්‍යාසාදනය
re-insurance=ප්‍රතිරක්ෂණය
re-living=ප්‍රතිවනය
re-magnetise=ප්‍රතිචුම්බකන කරනවා
re-present=ප්‍රත්‍යර්පණය කරනවා
re-presentation=ප්‍රත්‍යර්පණය
re-rout=වෙන පාරකින් යවනවා
re-structure=ප්‍රතිව්‍යහගත
re-treading=ටයර අළුත් කිරීම
re-webbed=නැවත හුය ලූ
reach=අත දිගුකොට ගන්නවා | අතින් රැගෙන දෙනවා | දියමානය | දුර ප්‍රමාණය | පැතිර පවත්නා දුර | පැතිරෙනවා | පොකුණ | වක්කලම් මානය | විෂය | වෙත පැමිණෙනවා | සැපත් වෙනවා | සේ පියෝ | සේන්දු වෙනවා | ළඟා වෙනවා
reach-me-down=වහා පාවිච්වයට සුදුසු
reached=අනුප්‍රාප්ත | උපගත | ප්‍රාප්ත | වං | විත් | වුත් | සම්ප්‍රාප්ත
react=අන්‍යෝන්‍ය වශයෙන් බලපවත්වනවා | පරස්පරව පවතිනවා | ප්‍රතික්‍රියා කරනවා | ප්‍රතික්‍රියා වෙනවා | ප්‍රතිචාර දක්වනවා | ප්‍රතිඵල වශයෙන් ඇතිවෙනවා | ප්‍රතිවිරුද්ධව ඇති වෙනවා | බලපවත්වනවා
reactance=ප්‍රතිබාධකය | ප්‍රතිබාධනය
reactant=ප්‍රතික්‍රියකය
reaction=ආපසු ගමන | ප්‍රතික්‍රියාව | ප්‍රතිගාමීත්වය | ප්‍රතිචාරය | පිරීහීම | බල පැවැත්වීම | වික්‍රියාව | විපාකය
reactionary=දියුණුවට ප්‍රතිපක්ෂ වූ | ප්‍රගතිශීලී නොවූ | ප්‍රතික්‍රියාත්මක | ප්‍රතිගාමී | ප්‍රතිගාමී තැනැත්තා
reactivate=නැවත ක්‍රියාත්මක කරනවා | සක්‍රියතාවට පත් කරනවා
reactivation=ප්‍රතිසක්‍රිය කිරීම
reactive=ප්‍රතික්‍රියක | ප්‍රතික්‍රියාවක් පෙන්වන
reactivity=ප්‍රතික්‍රියතාව
reactor=පතික්‍රියාකාරකය | ප්‍රතිකර්තෘ | ප්‍රතික්‍රියාකාරකය
read=ඉගෙනගන්නවා | කියවන ලද | කියවනවා | කියවන්න | කියවෙනවා | තේරුම් කරනවා | තේරුම් ගන්නවා | දක්වනවා | හදාරනවා
readable=පහසුවෙන් කියවිය හැකි | ප්‍රිය උපදවන
reader=කියවනය | කියවන්නා | පාඨක | පාඨකයා | පාඨකාචාර්ය | පාඨග්‍රන්ථය | පාඩම් පොත | සෝදුපත් කියවන්නා
reader-printer=කියවීම් මුද්‍රණයන්ත්‍රය
readership=පාඨක සමූහය | පාඨකගණයා | පාඨකගනය
readily=පහසුවෙන් | මහත් කැමැත්තෙන්
readiness=උත්තේජකය | උද්‍යුතතාව | කැමැත්ත | ලෑස්තිය | ලේස්තිය | සීරුව | සූදානම
reading=අර්ථය | කියවීම | දැක්වෙන දේ | පාඨනය | පාඨය | පාඨාංකය | වාග්පරිචය | සිතියම් කියවීම
ready=අත්පිට | අප්‍රමාදී | දක්ෂ | පහසු | යමකට ලෑස්ති | සූදානම | සූදානම් | ළැදි
ready-made=නිමි
ready-witted=විචක්ෂණ
readymade=පිරිනිමි | පිරීනිමිය
reaf=පරය
reafforestation=යළි කැලෑ වැවීම
reagent=උත්තේජකය | ප්‍රතිකාරකය
real=අව්‍යාජ | තතු | තථ්‍ය | තාත්ත්වික | තාත්වික | නියම | නිශ්චල | මූර්ත | යථා | යථාභූත | වාස්තව | සත් | සත්‍ය | සැබෑ
realgar=මනෝශිලා | මනෝසීල | රීයල්ගා
realia=තථ්‍ය වස්තු
realign=නැවත සංවිධානය කරනවා
realignment=නැවත එකෙල්ල කිරීම
realisation=උපලබ්ධි කිරීම | උපලබ්ධි වීම | පටිවේධය | ප්‍රතිවේදය | ප්‍රතිවේධය
realise=උපලබ්ධ වෙනවා | උපලබ්ධි ලබනවා | උපලබ්ධි වෙනවා | උපලබ්ධිය ලබනවා | කුළුගන්නවා | ලබනවා | සාක්ෂාත් කරනවා
realised=ලබ්ධ
realism=තාත්විකත්වය | තාත්විකවාදය | යථාර්තවාදය | යථාර්ථනිරූපණය | යථාර්ථවාදය | යමක් තත්ත්වාකාරයෙන්ම තේරුම්ගැනීම | යමක් තත්ත්වාකාරයෙන්ම දැක්වීම | සත්වාදය
realist=යතාර්ථවාදියා | සත්වාදියා
realistic=ඇති සැටියෙන්ම දැක්වුණු | තාත්වික | පරිමේය | යතාර්ථනිරූපිත
reality=ඇති සැටිය | තථ්‍යතාව | නියම ස්වභාවය | යතාර්ථය | යථාතත්වය | යථාර්ථතාව | යථාර්ථය | සත්තාව | සත්‍ය | සත්‍යය
realization=අධිගමය | අභිසමය | උපලබ්ධි වීම | උපලබ්ධිය | යථාර්ථනිරූපණය | යමක් තත්ත්වාකාරයෙන්ම තේරුම්ගැනීම | යමක් තත්ත්වාකාරයෙන්ම දැක්වීම | සාක්ෂාත්කරණය
realize=අවබෝධ කරනවා | ඉෂ්ට කරගන්නවා | ප්‍රත්‍යක්ෂ වශයෙන් දැනගන්නවා | ලබාගන්නවා | විකිණීමෙන් ලැබෙනවා
realized=අධිගත
really=ඉඳුරාම | සැබවින්ම
realm=ක්ෂේත්‍රය | බලවත්වන ප්‍රදේශය | රාජධානිය | රාජ්‍යය | විෂය
reals=යථාර්ථයෝ | සත්ධාතු
realta=පාමරජන වත්‍රය
realty=නිශ්චල දේපල
realy=ඇත්තෙන්ම | ඉඳුරාම | හැබෑටම මට පුදුමයි
ream=තව් පදම් කරනවා | රයිමර කරනවා | රීම
reamer=තව් පදම් කරනවා | රයිමරය
reamering=තව් පදම් කිරීම
reaming=තව් පදම් කිරීම
reanimate=නැවත ප්‍රාණවත් කරනවා
reap=අස්වැන්න කපාගන්නවා | කපනවා | ගොයම් කපනවා | විපාක වශයෙන් ලබනවා | විපාක වශයෙන් ලැබෙනවා
reaper=ගොයම් කපන යන්ත්‍රය | ගොයම් කපන්නා | ගොයම් කපන්නී
reappointment=නැවත පත්කිරිම | නැවත පත්වීම
rear=ඇති කරනවා | ඔසවනවා | ගොඩනඟනවා | පස්සා කොටස | පස්සා පැත්ත | පසුපස | පිටිපස | පිටුපස | පෘෂ්ටභාගය | වවනවා
rear-guard=පසුපස රැකවල
rearm=නැවත යුද්ධායුධ ලබාදෙනවා
rearrangement=ප්‍රතිසංවිධානය
reason=කරුණ | කාරණය | තර්ක කරනවා | තර්කය | බුද්ධිය | යුක්තිය | විචාරය | සිහිකල්පනාව | හෙ | හේතු | හේතුව
reasonable=බුද්ධික | යුක්ති සහගත | යුක්තිගරුක | යුක්තියුක්ත | යුක්තිසහගත | සාධාරණ | සෑහෙන | සිහිමොලේ ඇති
reasonably=සෑහෙන තරම් | හුඟක් දුර
reasoning=අපෝහනය | තර්කණය | තර්කනය
reassembling=යළි එකලස් කිරීම
reassurance=පුනආරක්ෂණය
reassure=ධෛර්යවත් කරනවා | සනසනවා
reave=බලෙන් උදුරා ගන්නවා | බලෙන් ගෙන යනවා
rebald=අශික්ෂිත | අසභ්‍ය | ග්‍රාම්‍ය
rebate=අඩු කිරීම | තට්ටු ගානවා | තට්ටුව | ප්‍රතිදානය | පිළිදතුව
rebatement=අඩු කරන ගණන | අඩු කිරීම
rebating=තට්ටු ඇරීම | තට්ටු ගෑම
rebel=කැරලි ගසනවා | කැරලිකරු
rebellion=කැරැල්ල | බලවත් විරෝධය
rebellious=කැරලිකාර | දුර්දම | හිතුවක්කාර
rebirth=ගතිය | ප්‍රතිසන්ධිය | පුනර්භවය | පුනරුත්පත්තිය
rebirth-fantasy=උත්පත්ති මනස්සෘෂ්ටිය
reble=කැරලි ගසනවා | කැරලිකාරයා | බලවත් අප්‍රසාදය දක්වනවා
rebore=නැවත බෝර කැපීම
reboring=බෝර පිළිකැපීම
rebound=ආපසු පනිනවා | නැවත බැඳි | පරාවර්තනය | පැමිණනවා | පොලා පනිනවා | පොළා පනිනවා
rebuff=තරවටු කරනවා | තරවටුව | බලාපොරොත්තු නොවූ බාධාව | බලාපොරොත්තු නොවූ විරෝධය
rebuke=චෝදනාව | තරවටු කරනවා | තරවටුව
rebus=වචනයක් රූප මඟින් පෙන්වීම
rebut=උපමර්දනය කරනවා | දෝෂාරෝපණය නිරාකරණය කරනවා | බිඳහෙළනවා | බොරු බව ඔප්පු කරනවා | බොරුබව ඔප්පු කරනවා
rebutement=ඛණ්ඩනය | නිරාකරණය | නිෂ්ප්‍රභ කිරීම
rebuttal=ඛණ්ඩනය | නිරාකරණය | නිෂ්ප්‍රභ කිරීම
recalcitrance=අකීකරුකම | මුරණ්ඩුකම
recalcitrant=දුර්දම | විරෝධතා දක්වන
recalescence=තපෝත්සර්සජනය | තාපෝත් සර්ජනය | තාපෝත්සර්ජනය | ප්‍රතිසංදීප්තිය
recall=ආපසු කැදවනවා | ආපසු කැඳවනවා | ආපසු කැඳවීම | තහනම් කරවා | ප්ර්රත්‍යානයන කරනව | ප්‍රත්‍යානයනය | ප්‍රත්‍යානයනය කරනවා | මෙනෙහි කරනවා | යළි කැඳවීම | සිහිපත් කරගන්නවා
recalld=ආපසු කැඳවුණු | ප්‍රත්‍යානීත
recant=ආගම අත්හරිනවා | කී දේ අස්කර ගන්නවා | ප්‍රත්‍යාලපනය කරනවා | ප්‍රත්‍යාලාපනය කරනවා | බැහැර කරනවා
recantation=ප්‍රත්‍යාඛ්‍යානය | ස්වමතහරණය
recapitulate=උපසංහරණය | සංග්‍රහ කොට දක්වනවා | සාරාංශය දක්වනවා
recapitulation=උපසංහාරය | පුනරාවර්ජනය
recapitulatory=සංග්‍රහාත්මක
recaptor=නැවත අල්ලාගත් තැනැත්තා
recapture=අත්පත් කරගන්නවා | නැවත අල්ලාගන්නවා
recarbonize=ප්‍රතිකාබනීකරණය
recarburisation=ප්‍රතිකාබියුරීකරණය
recast=අමුතුවෙන් සකස් කරනවා | නැවත වාත්තු කරනවා | ප්‍රතිවරණය | පිළිවාත්තුව | වෙනස් කරනවා
recede=අඩු වෙනවා | ආපසු යනවා | පස්සට නෙරනවා | පසුබසිනවා
receding=පස්සට නැඹුරු වූ | පසුබාන
receipt=අය | කුවිතාන්සිය | කුවිතාන්සියක් දෙනවා | භාර ගැනීම | රිසිට්ටුව | ලදු පත | ලදුපත | ලැබීම | ලැබුණු දේ | සීට්ටුව
receipts=අය | ආදායම
receivable=අය විය යුතු
receive=අල්ලනවා | ගන්නවා | බාර ගන්නවා | බාරගන්නවා | ලබනවා | ලැබෙනවා
received=ඇවිල්ලා
receiver=ආදායකය | ග්‍රාහක | ග්‍රාහකයා | ප්‍රතිග්‍රාහක | ප්‍රතිග්‍රාහකය | ප්‍රතිග්‍රාහකයා | බලයක් බාරගන්නා තැනැත්තා | බාර ගන්නා | බාරගන්නා | භාජනය | භාරගන්නා | මුදලක් බාරගන්නා තැනැත්තා | රිසීවරය | ලබන්නා | ලැබුම්කරු | හොරබඩු පිළිගන්නා
receiving=ප්‍රතිග්‍රාහක
recense=සංශෝධනය කරනවා
recension=පොතේ පෙළ | සංශෝධනය
recent=අධුනා | අලුත් | නුතන | නූතන | නොබෝදා වූ | මෑත
recently=අලුත | නොබෝදා
recept=ග්‍රාහය
receptacle=ආශය | ග්‍රාහකය | ග්‍රාහය | පුෂ්ප අක්ෂය | භාජනය | ස්ථානය
receptacular=ග්‍රාහක
reception=ආදානය | ප්‍රතිග්‍රහණය | පිළිගැන්ම | පිළිගැනීමේ උත්සවය | සම්මානය
receptionist=අමුත්තන් පිළිගැනීමේ නිලධාරියා | ප්‍රතිග්‍රාහක | ප්‍රතිග්‍රාහිකා | පිළිගැනුම් නිලධාරියා
receptive=ග්‍රාහ්‍ය | ප්‍රතිග්‍රාහී | යමක් ඉක්මනින් වැටහෙන | සුඛග්‍රාහී
receptivity=ග්‍රාහකත්වය
receptor=ග්‍රාහකය | ග්‍රාහකයා | ප්‍රතිග්‍රාහක | ප්‍රතිග්‍රාහකය
receptors=ප්‍රතිග්‍රාහක
recess=ඉඩවරය | ගිල්ලුම් කට | ගිල්ලුම් කපනවා | ගුප්ත ස්ථානය | විරාමය | විවික්තිය | විවේක ස්ථානය
recession=අඩුවීම | ආපසු බාරදීම | නිලීන වීම | පසු බැස්ම | පසුබැස්ම | පසුබැසීම | පසුබෑම | ප්‍රතික්‍රමය | මන්දාවධමනය
recessive=නිලීන | නිලීනය | පස්සට නෙරායන | පසුබසින
recharging=නැවත සැර කැවීම | පුනරාරෝපණය
recherche=දුර්ලභ | විශිෂ්ට
reches=වත්පොහොසත්කම
rechristen=අලුත් නමක් දෙනවා
rechucking=නැවත සක්කයෙහි ලෑම
reciaim=පිළිසකසනවා
recidivation=ප්‍රත්‍යාසරණය
recidivism=පුනරාවෘත්තීය
recidivist=අපරාධයට යොමුවන්නා | ප්‍රත්‍යාසාරී | පුනඅපරාධකරු
recipe=උපාය | වට්ටෝරුව | සංයෝගක්‍රමය
recipient=ප්‍රතිග්‍රාහකයා | ප්‍රදානලාභියා | ලබන්නා
reciprocal=අන්‍යෙන්‍ය | අන්‍යෝන්‍ය | උභයතා | උභයභාවී | එකිනෙකා පිළිබඳ | පරස්පර | පරස්පරය | ප්‍රතිකාරක | ව්‍යතිෂංගික
reciprocally=පරස්පර වශයෙන්
reciprocals=පරස්පර
reciprocate=එකටෙක වශයෙන් කරනවා | පරස්පර කරනවා | පරස්පර වශයෙන් කරනවා | මාරුවෙන් මාරුවට කරනවා
reciprocating=අනුවැටුම්
reciprocation=පරස්පර ක්‍රියාව | පරස්පරනය
reciprocity=අන්‍යෝන්‍යතාව | උභයභාවත්වය | පරස්පරත්වය | පරස්පරතාව
recirculation=ප්‍රතිසංසරණය | පුනහ්සංසරණය
recital=කියැවිය | ගායනය | තොරතුරු කියාදීම | නර්තනය | නෘත්‍යය | ප්‍රකථනය | වාදනය | විස්තර වාක්‍යය | සංගීතය | සංගීතිය
recitalist=ගායක | නර්තක | වාදක
recitation=කට පාඩමින් කීම | ගායනය | පාඨනය | සජ්ක්ධායනය
recitative=ගායනා විශේෂයක්
recite=උදෙසනවා | කටපාඩමෙන් හඬනඟා කියනවා | ගායනය කරනවා | පිරිවහනවා | පිරුවනවා
reciting=උද්දේශය
reck=පරෙස්සම් වෙනවා | ප්‍රවේසම් වෙනවා
reckless=අනවධාන | අනවධානී | ඔලමොට්ට | ඔළමොට්ටළ | නිර්භය | නොසැලකිලිවන්ත | සහසි | සහසික | සාහසික
recklessness=අනවධානය
reckon=ගණනට ගන්නවා | ගනිනවා | ගිණීම | සලකනවා
reckoners=ගණන් වගු
reckoning=ගණන් ගැනීම | ගණන් බැලීම
reckshaw=රික්ෂෝව
reclaim=ශිෂ්ට බවට පමුණුවනවා
reclamation=ඉඩ සංස්කරණය | පිළිසැකැස්ම | බේරා ගැනීම
reclinate=පහතට නැමුණු
reclination=ඇලවීම
recline=ඇල කරනවා | ඇල ගැහෙනවා | ඇලවෙනවා | ඇළ වෙනවා | ඇළට තබනවා | ශයනය | සැතපෙනවා | හාංචි වෙනවා | හාන්සි කරනවා | හාන්සි වෙනවා
reclining=ඔත් | වැදහෝනා
recluse=තාපසයා | වෛරාගියා | ශමණ | ශ්‍රමණ
recogitions=විකර්ශණය
recognise=හඳුනනවා
recognition=අභිඥානය | ප්‍රත්‍යභිඥානය | ප්‍රත්‍යාභිඥානය | පිළිගත් | පිළිගැනීම | පිළිගැනුම | සඤ්ජානනය | සම්භාවනය | සම්භාවනාව | හඳුන්වාදීම | හඳුනාගැනීම
recognizance=ඇපය | බැඳුම් ඔප්පුව | බැඳුම් පත්‍රය | බැඳුම්පත | බැඳුම්පත්‍රය
recognize=අඳුනනවා | අඳුනාගන්නවා | ඇඳින ගන්නවා | පිළිගන්නවා | මතක් වෙනවා | හඳුනාගන්නවා
recognized=ප්‍රත්‍යභිඥාත | පිළිගත් | හඳුනාගත් | හැඳිනගත්
recoil=ආපසු පනිනවා | පරාවර්තනය | පස්සට පනිනවා | පසුබසිනවා | පෙරළා පැනීම | වාංගුව
recoinage=පුනටංකනය
recollect=නැවත මතක් කරගන්නවා | මතක් කරනවා | මතක් වෙනවා | සිතනවා | සිහි එළවනවා
recollection=අනුස්මරණය | නිණව්ව | මතක | ස්මරණය | සිහි
recombination=ප්‍රතිසංයෝජනය
recommend=උපදෙස් වශයෙන් කියනවා | නිර්දේශ කරනවා | නිර්දේශකරනවා | පවරා බාර දෙනවා | රෙකමදාරු කරනවා
recommendation=උපදේශය | නිර්දේශ කිරීම | නිර්දේශය | රෙකමදාරුව
recommit=නැවත සලකා බැලීමට ආපසු යවනවා
recommital=නැවත සලකා බැලීමට ආපසු යවන ලද
recommitment=නැවත සලකා බැලීමට ආපසු යැවීම
recompense=ප්‍රතිඵල ලබාදෙනවා | ප්‍රතිඵලය | පාරිතෝෂිකය | වන්දිය | හිලව් කරනවා
recompile=ප්‍රතිසම්පාදන කරනවා | ප්‍රතිසම්පාදනය කරනවා
recompose=නැවත තනනවා
recompute=ප්‍රත්‍යාගණනය
reconcile=සමඟි වෙනවා | සමාදාන කරනවා | සසඳනවා | සාමාධානය කරනවා
reconcilement=එකඟබව | සමඟිසන්ධානය | සාම්‍යය
reconciliation=එකඟබව | පුනස්සමථය | සංසන්දනය | සමගිකිරීම | සමඟිසන්ධානය | සමාදානවීම | සාම්‍යය | සාමාධානය | සැසැඳීම
recondite=ගුප්ත | තේරුම් ගැනීමට දුෂ්කර
recondition=අලුත්වැඩියා කර සකස් කරගන්නවා
reconditioning=පිළිසැකැසුම
reconnaissance=නැවත සලකා බැලීම | පෙරික්සුම
reconnection=ප්‍රතිසම්බන්ධය
reconnoitre=පරීක්ෂා කරනවා | පෙරික්සනවා
reconnoitring=පෙරික්සීම
reconsider=යළි සලකා බලනවා
reconsideration=නැවත සලකා බැලීම | යළි සලකා බැලීම
reconstitute=නැවත සකස් කරනවා | ප්‍රතිනිර්මාණය කරනවා
reconstitution=නැවත සකස් කිරීම
reconstruct=නැවත ගොඩනඟනවා | යළි නිර්මාණ කරනවා
reconstruction=ප්‍රතිකරණය | ප්‍රතිනිර්මාණය | ප්‍රතිසංස්කරණය | ප්‍රතිසන්දර්භනය | පිළිසකරණය | යළි ඉදි කිරීම
reconvention=ප්‍රතිඉල්ලීම
reconversion=ප්‍රතිපරිවර්තනය
reconvert=ප්‍රතිපරිවර්තනය කරනවා
reconvey=නැවත පවරා දෙනවා
reconveyance=නැවත පවරාදීම | පුනහිමිකරණය
reconvict=යළි දෝෂණය කරනවා
reconviction=යළි දෝෂණය
record=අභිලේඛනය | ඉතිහාසය | තැටිගතකරනවා | තැටිය | පොතනය | පොතනය කරනවා | පොත්ගත කරනවා | රෙකෝඩය | ලියා තැන්පත් කරනවා | ලේඛනය | වාර්තා කිරීම | වාර්තාව | ශබ්දවාහිනී තැටිය | ශබ්දවාහිනී තැටියකට ගන්නවා | සටහන | සටහන් කරගන්නවා | සටහන් කරනවා | සටහන් කිරීම | සැටැහුම
record-keeper=ලේඛන භාරකරු | සටහන් තබන්නා
record-room=ලේඛනාගාරය
recorded=වාර්තාගත
recorder=නළා වර්ගයක් | රෙකෝඩරය | රේඛකය | වාර්තාකරු | සටහන්කරු | සටහුව | සැටැහුව
recording=සැටැහීම
records=අභිලේඛන | ලේඛන | වාර්තා | සටහන්
recount=කථාවක් කියනවා | තොරතුරු විස්තර කරනවා | නැවත ගණන් කරනවා | නැවත ගණන් කිරීම | නැවත ගණන්කරනවා | නැවත ගණිනවා | යළි ගනිනවා | යළි ගැනීම
recoup=පාඩුව පිරිමසා ගන්නවා | හිලව් වශයෙන් දෙනවා | හිලව් වශයෙන් ලබනවා
recoupment=හිලව්ව
recourse=උපයෝජනය | උපාය | පිහිට | වගකීම්
recover=අයකරවා ගන්නවා | ආපසු ලබාගන්නවා | ඇති කරගන්නවා | නැවත අයිති කරගන්නවා | ප්‍රකෘති ස්වභාවයට පැමිණෙනවා | පිළිලබනවා
recoverable=සුව විය හැකි
recovery=අයකරවා ගැන්ම | ආපසු ලබාගැනීම | ප්‍රතිප්‍රාප්තිය | ප්‍රතිසාධනය | ප්‍රලාභය | පිළිලැබුම | ව්‍යපනය | සුවය
recreancy=බියගුලු යටත් වීම
recreant=ද්‍රෝහියා | බයගුල්ලා | බියසුලු
recreate=නැවත සාදාගන්නවා
recreation=ක්‍රීඩාව | විනෝද ක්‍රියා | විනෝදය | විනෝදායනය | විශ්‍රාන්තිය
recreative=විනෝදාත්මක
recrement=ඉවත ලන දෑ | මණ්ඩි | රොඩු
recriminate=දොස් කී අයට දොස් කියනවා
recrimination=ප්‍රතිචෝදනා
recrudescence=පුනර්භවය | යළි පැතිරීම
recrudescent=අභිනවයෙන් ව්‍යාප්තියට පැමිණි
recruit=අලුතෙන් බඳවාගත් පාක්ෂිකයා | අලුතෙන් බඳවාගත් භටයා | අළුතෙන් ආධාරකාරයන් බඳවාගන්නවා | කෝඩුකාරයා | ප්‍රතිවෘංහිතය | බඳවා ගන්නවා | බලය වැඩි කරගන්නවා | ශක්තිය වැඩි කරගන්නවා | සනීපය වැඩි කරගන්නවා
recruiting=බඳවා ගැනීම
recruitment=අලුතෙන් බඳවා ගැනීම | ප්‍රතිවෘංහනය | බඳවා ගැනීම | සමූර්ජනය
recrystalization=ප්‍රතිස්ළුටිකරණය
recrystallization=ප්‍රතිස්ඵටිකීකරණය | පුනස්ඵටිකීකරණය
rectal=ගුද | ගුදීය
rectangle=සෘජු කෝණාස්‍රය | සෘජුකෝණාශ්‍රය | සෘජුකෝණාස්‍රය
rectanguhyperbola=සෘජුකෝණාස්‍ර බහුචලය
rectangular=ආයතචතුරශ්‍ර | සෘජුකෝණාස්‍ර | සෘජුකෝණාස්‍ර අක්ෂ
rectification=උදු කිරීම | උදුකිරීම | නිදොස් කිරීම | නිවරද කිරිම | නිවැරදි කිරීම | පරිරේඛණය | පරිරේඛනය | පරිශෝධනය | ප්‍රතිශෝධනය | වරද නිවැරදි කිරීම | සෘජුකරණය
rectified=කලවම් නැති | ප්‍රතිශෝධිත | වරද පහකළ
rectifier=උදුකුරුව | සෘජුකාරකය | සෘජුකාරකය උදුකුරුව
rectify=නිවරද කරනවා | වරද හරිගස්සනවා | සෘජු කරනවා
rectiineal=සරල | සෘජු රේඛා ඇති
rectilinear=ඒකජ | සරල | සරල රේඛීය | සරලරේඛීය | සෘජු රේඛා ඇති
rectipetality=සෘජුශීලතාව
rectitude=අකුටිලත්වය | අවංකකම | සෘජුභාවය
recto=දකුණු පැත්තේ කොළය | පෙරපිට
rectocele=ගුද පුඤ්ඡය
rector=ප්‍රධාන දේවගැතියා
rectory=අධ්‍යක්ෂකගේ නිවාසය
rectum=අධෝමාර්ගය | ගුද මාර්ගය | ගුදපෘෂ්ටය | ගුදමාර්ගය | ගුදය | මලමඟ | මලමාර්ගය
rectus=සෘජුකය
recumbent=ඇල වූ | ඔත් | ධත් | වැදහොත් | ශයිත | සැතපුණු | හාන්සි වූ
recuperate=නැතිවූ ධනය නැවත ලබාගන්නවා | නැතිවූ බලය නැවත ලබාගන්නවා | ප්‍රකෘතිමත් වෙනවා | පියවනවා | සුවය ලබනවා
recuperateative=නැති වූ දෙයක් යළි ලබා ගත හැකි
recuperatores=ප්‍රීටර යොමුලද්දෝ
recur=නැවත සිද්ධ වෙනවා | සමාවර්ත වෙනවා | සිතට නැවත නැඟෙනවා
recurent=පුනරාවර්තී | වරින්වර ඇතිවන
recurrence=නැවත සිදුවීම | ප්‍රතිවර්තනය | පුනපුනායනය | පුනරාගමනය | පුනරාවර්තනය | සමාවර්තිතාව
recurrent=පුනරාවර්තන | පුනරාවර්තී
recurring=ආවර්ත | නැවත නැවත ඇතිවන | ප්‍රත්‍යාවර්තී | පුරාවර්ති | සමාවර්ත
recursiveness=ආවර්තනිකතාව
recurvate=ප්‍රතිවර්ත
recurved=ප්‍රතිවර්ත
recusant=නොපිළිගන්නා | යටත් නොවන
red=ඉතා බරපතළ | රත | රත් | රතු | රතුපාට | විප්ලවවාදියා | සරාග | සාහසික
red-deer=සලුමුවා | සලුවා
red-handed=ලේ තැවරුණු අතැති
red-lead=සින්දුර | සින්ධුර
red-sighted=රක්ත දෘෂ්ටික
redactor=කර්තෘ | සංශෝධනය කරන්නා
redcoloured=රක්ත
redden=රතු කරනවා
reddendum=බදු මිල වැකිය
reddish=මඳක් රතු වූ
reddle=රෙඩ්ල්
redeem=නිදහස් කිරීම | පිරිමුදනවා | මුදා ගැනීම | මුදා හැරීම
redeemable=නිදහස් කරවාගත හැකි | පිරිමුදවිය හැකි
redeemer=ක්‍රිස්තුස්වහන්සේ | ගැලවුම්කාරයා
redeeming=සතුටුදායක
redemption=ගැළවීම | නිදහස් කිරීම | නිදහස් වීම | නිදහස්කරවා ගැන්ම | පිරිමුදනය | මිදැවීම | මුක්තිය | මුදා ගැනීම | මෝක්ෂය
redendancy=සමරික්තතාව
redeploy=නැවත මෙහෙයවනවා
redeyed=රක්තාක්ෂ | රක්තාක්ෂි
redicule=අපහාසය | පරිහාසය
rediculous=වහසි
redintegrate=ප්‍රකෘතිමත් කරනවා
redintegration=ප්‍රත්‍යනුකලනය | පුනප්‍රතිස්ථාපනය කිරීම | පුනරාවකලනය
redirect=ආපසු හරවා යවනවා
rediscount=පිළිවට්ටම | පිළිවට්ටම් කරනවා
rediscounting=පිළිවට්ටම් කිරීම
redistribution=ප්‍රතිව්‍යාප්තිය | පුනර්ව්‍යාප්තිය
redo=නැවත කරනවා
redolence=සුගන්ධය
redolent=ගඳ වහනය වන | සුගන්ධී
redouble=වඩා බලවත් වෙනවා
redoubt=බලකොටු වර්ගයක්
redoubtable=භයජනක | ශූරවීර
redound=වාසිය පිණිස පවතිනවා
redox=රෙඩොක්ස්
redpoll=පක්ෂියෙක්
redquirement=නියමය | වුවමනාව | ඕනෑ කරන දේ
redress=ප්‍රතිකර්ම | පිළියම් | වන්දිය | සහන සලසනවා | සහනය
redressible=ප්‍රතිකර්ම දිය හැකි
redshank=දිග හොටක් ඇති විශාල කුරුල්ලෙක්
reduce=අඩු කරනවා | අඩුකරනවා | ඌන කරනවා | ඌනනය කරනවා | ඔක්සිහරණය කරනවා | කප්පාදු කරනවා | තුනී කරනවා | දුර්වල කරනවා | පරිවර්තනය කරනවා | පහත හෙළනවා | පූට්ටු කරනවා | යටත් කරනවා
reduced=ඌනිත | ඔක්සිහෘත
reducible=අඩු කළ හැකි | ඌනනීය | ඔක්සිහාර්ය | දුර්වල කළ හැකි | ලඝු කළ හැකි
reducing=ඌනනය කිරීම | ඔක්සිහරණය
reduction=අඩු කිරීම | අඩුකිරීම | අන්‍ය වර්ග කිරීම | අවකරණය | ඌණනය | ඌනකරණය | ඌනනය | ඌනනය ප්‍රාකාරාන්තරණය | ඔක්සිහරණය | ක්ෂය | පරාජය | පරිවර්තනය | ප්‍රකාරාන්තරණය | ලඝුකරණය | හානිය | හායනය
reduction-division=ඌනන විභාජනය
redundance=අනවශ්‍යකත්වය | පුනරුත්පත්තිය
redundancy=අතිරික්තතාව | අධිකත්වය | අනවශ්‍යකත්වය | ප්‍රමාණාධිකතාව | පුනරුත්පත්තිය | රික්තතාව | සමතිරික්තතාව | සමතිරික්තය
redundant=අතිරික්ත | අධික | අනවශ්‍ය | පරිබාහිර | ප්‍රමාණාධික්‍ය | රික්ත | සමතිරික්ත | සමරික්ත
reduplicate=ද්වීගුණ කරනවා | ද්වීගුණ වෙනවා
reduplication=ද්විගුණනය | ද්විත්වරූප | ද්විත්වරූපය | ද්විත්වීකරණය | ප්‍රතිද්විගුණනය | ප්‍රතිද්විත්ව කරණය
reduplicatively=ද්විරුක්තියෙන්
reed=ඉපිය | ඉපියාව | ඊය | නළාව | පන් | පනාව | බට | බටය
reed-pipe=ඉපි නලාව
reed-swamp=බට වගුර
reedy=බටවලින් ගැවසුණු
reef=ඉල්ලම | ගල්දුව | ගල්පරය | පරය
reek=ගඳ ගහනවා | ගඳ විහිදෙනවා | දුම් ගහනවා
reeking=කාබනාලේපනය
reel=ඉක්මනින් කරන නැටුමක් | පටය | බීරළුව | රීලය | රෝදය | වැනි වැනී යනවා | වේගයෙන් සෙලවෙනවා
reeling=වට නිමැවුම
reeper=රීප්පය
reeve=නැව් යොතක් අමුණනවා
refection=අතුරුපස
refectory=දන්සාලාව | භෝජනශාලාව
refer=කෙනෙකු වෙත යවනවා | පංගාඩම් කරනවා | මතක් කරනවා | යමක් කිරීමට බාරදෙනවා | යොමු කරනවා | යොමුකරනවා | සඳහන් කරනවා | සිත යොමු කරවනවා
referandum=ජනමත විචාරණය
referee=තරඟ විනිශ්චයකරු | තිරක | තීරකයා | නිර්දේශකයා | බේරුම්කාරයා | මධ්‍යස්ථයා | යොමුලදුවා | විචාර්යයා
referen=ප්‍රඥප්තිය
reference=ආශ්‍රේය | නිර්දේශනය | නිර්දේශය | යමක් පිළිබඳ සටහන | යොමුව | සඳහන් කිරීම | සම්බන්ධය | සමුද්දේශ | සමුද්දේශය | සැඳහුම
referend=ප්‍රඥප්තකය
referendum=ජන විචාරණය | ජනමත විචාරණය | ජනමත විමසුම | යොමු විමසුම
referent=අභිධේය | ප්‍රඥප්තය
referential=ප්‍රඥාපනීය
refill=නැවත පුරවනවා
refine=ප්‍රසාදනය කරනවා | පිරිසිදු කරනවා | ශුද්ධ කරනවා
refined=ප්‍රසාදිත | රසාත්මක | ලලිත | ශිෂ්ට | ශුද්ධ කළ | ශෝධිත | සුවිනීත
refinement=ප්‍රසාධනය | ලාලිත්‍යය | විශෝධනය | ශිෂ්ටත්වය | ශෝධනය | සංස්කෘතිය | සුශිෂ්ටතාව
refinery=පට්ටලය | ප්‍රසාදනාගාරය | පිරිපහදුව | ශෝධනාගාරය
refingent=වර්තනාකාර
refining=ප්‍රසාදනය
refit=අලුත්වැඩියා කරනවා | අලුතෙන් සපයනවා
reflate=සංසරණයේ ඇති මුදල් ප්‍රමාණය වැඩි කරනවා
reflation=ප්‍රතිධමනය
reflect=ආපසු හරවනවා | ආවර්ජනා කරනවා | දොස් පවරනවා | නින්දා පිණිස පවතිනවා | පරාවර්තනය කරනවා | පරාවර්තනය වෙනවා | පරාවාර්තනය කරනවා | ප්‍රතිබිම්බිතව දක්වනවා | ප්‍රශංසා පිණිස පවතිනවා | පැවරෙනවා | මෙනෙහි කරනවා
reflection=අන්තරාවලෝකනය | ආවර්ජනය | ආවර්ජනාව | කල්පනා කොට බැලීම | ඡායාව | දොස් පැවරීම | නින්දාව | පරාවර්තනය | ප්‍රත්‍යවේක්ෂණය | ප්‍රතිබිම්බය | ප්‍රතීකඥානය | පිළිබිඹුව | මනස්කාරය
reflective=කල්පනාවෙහි යෙදුණු | පරාවර්තක | වන්තාපර
reflectivity=පරාවර්තකතාව
reflector=පරාවර්තකය | පරාවර්තනය
reflex=ඉබේ කෙරෙන ක්‍රියාව | පරාවර්තන | ප්‍රත්‍යාවර්තිත | ප්‍රතිච්ඡායාව | ප්‍රතිරූපය | ප්‍රතීක | ප්‍රතීකය
reflexion=ආවර්ජනය | කල්පනා කොට බැලීම | ඡායාව | දොස් පැවරීම | නින්දාව | පරාවර්තනය | ප්‍රත්‍යවේක්ෂණය | ප්‍රතිබිම්බය | මනස්කාරය
reflexive=පරාවර්තී
reflexivity=පරාවර්තතාව
refluence=ආපසු ගැලීම | පසු බෑම
refluent=පසු බසින
reflux=ප්‍රතිවාහ | ප්‍රතිවාහී
reforestation=ප්‍රතිරෝපණය | ප්‍රතිවනරෝපණය | ප්‍රතිවනරෝපනය | පුනර්වනරෝපණය | වනසංස්කරණය
reform=ප්‍රකෘතිමත් කරනවා | ප්‍රතිසංස්කරණය | ප්‍රතිසංස්කරණය කරනවා
reformation=ගුණවර්ධනය | ප්‍රතිශෝධනය | ප්‍රතිසංස්කරණය | ශෝධනය
reformative=ප්‍රතිසංස්කරණය සඳහා වූ
reformatory=චරිත ශෝධනාගාරය | විනයාලය
reformed=ප්‍රතිසංස්කෘත
reformer=ප්‍රතිසංස්කාරකයා | සංශෝධකයා
reformism=ප්‍රතිසංස්කරණවාදය | පිළිසකස්වාදය
reformist=ප්‍රතිසංස්කරණවාදියා
reformulation=පුනස්සූත්‍රකරණය
refract=භින්න කරනවා | රශ්මිය කඩනවා | වර්තනය වෙනවා
refracted=වර්තිත
refracting=වර්තක
refraction=වර්තනය
refractive=වර්තන | වර්ත්‍ය
refractivity=වර්තකතාව | වර්ත්‍යතාව
refractometer=වර්තනාංකමානය
refractor=වර්තකය
refractories=තාපසහ ඇතුරුම්
refractoriness=තාපසහතාව | මුරණ්ඩුව
refractory=අකීකරු | ඇට්ටර | තාපසහ | දුර්දාන්ත | නොවිරෙන
refrain=ධ්‍රැවපදය | ධෘවපදය | වළකිනවා | වැළකී සිටිනවා
refrangibility=වර්ත්‍යතාව
refrangible=වර්තනය විය හැකි
refresh=නැවත ප්‍රාණවත් කරනවා | වෙහෙස නිවනවා | සතප්පනවා
refresher=නවමුව | සිසිල් බීමක්
refreshing=අභිනවන | ප්‍රබෝධවත් කරන | සැපදායක | සිසිල්
refreshment=තර්පණය | විශ්‍රාන්තිය | වෙහෙස නිවීම | සන්තර්පණය
refreshments=අවුළු | කෑමබීම
refrigerant=ශීතකාරක ද්‍රව්‍යය | ශීතකාරකය
refrigerate=ශීත කරනවා
refrigeration=ශීතකරණය | ශීතනය
refrigerator=අයිස් පෙට්ටිය | ශීතකරණය | ශීතකරය | සීතකරණය | සීතකරය
refringent=වර්තනාකාර
refuel=නැවත ඉන්ධන ලබාදෙනවා
refuge=ආවරණය | නිස්සරණ | පිහිට | මුවාව | රක්ෂාස්ථානය | ශරණ | සරණ
refugee=අනාථයා | ශරණාගත | සරණාගත | සරණාගතයා
refulgence=දීප්තිමත්කම
refulgent=ජ්වලිත | දීප්තිමත්
refund=ආපසු දුන් මුදල | මුදල් ආපසු දෙනවා
refurbish=නැවත සකස් කරනවා | යළි ඔප දමනවා
refusal=ප්‍රතික්ෂේප කිරීම | පිළිකෙවුම
refuse=අකැමැති වෙනවා | අහක දමන දේ | කැළිකසළ | කුණුකසළ | කෙහෙට | නොවටිනා කොටස | ප්‍රතික්ෂේප කරනවා | රොට | රොඩ්ඩ | රොඩු | රොඩුබොඩු | ව්‍යය | හප | හපය
refutable=ප්‍රතික්ෂේප කළ
refutation=ඛණ්ඩනය | නිශ්ප්‍රභ කිරීම | බිඳීම | වාක්‍ය ඛණ්ඩනය | විඛණ්ඩනය
refute=ඛණ්ඩනය කිරීම | නිෂ්ප්‍රභ කරනවා | වැරදි බව ඔප්පු කරනවා
refuting=ඛණ්ඩනය
reg=කතර තලාව
regain=නැවත ලබාගන්නවා
regal=අත්‍යත්කෘෂ්ට | රාජකීය | රාජාර්හ
regale=ඉන්ද්‍රියයන් පිණවනවා
regalia=රාජ කකුධ | රාජභාණ්ඩ | වරප්‍රදේශය
regality=රජකම
regard=ආදරය | තකනවා | තකා | තැකීම | තැකුම | නිරීක්ෂණය | සලකනවා | සැලකිල්ල
regardless=අනවධාන | නොසලකන | නොසලකා
regards=ශුභාශිංසන
regatta=ඔට්ටුවට ඔරු පැදීම | නෞකා තරඟය
regelation=ප්‍රතිශීතනය
regency=ආධිපත්‍යය | රාජ්‍යාධිකාරී පදවිය
regenerate=උසස්බවට පමුණුවනවා | නැවත ප්‍රකෘතිමත් කරනවා | ප්‍රකෘතිමත් | ප්‍රතිජනනය කරනවා
regeneration=ප්‍රතිජනනය | පුනර්ජනනය | පුනර්වනය | පුනර්වර්ධනය | පුනරුත්ථානය
regenerative=ප්‍රතිජනක | පුනර්ජනක
regenerator=ප්‍රතිජනකය | පුනර්ජනකය
regent=උපරාජයා | ප්‍රතිනිධි | රාජ්‍යාධිකාරී | වැඩබලන රජ
regicide=රාජඝාතකයා | රාජඝාතනය
regime=ආධිපත්‍යය | තන්ත්‍රය | දියමාව | පත්තියම | රජයනය | රාජ්‍යපාලනය | රැජැයුම
regimen=පත්තියම | හැසිරවීම
regimenals=හේවා ආයිත්තම්
regiment=රෙමේන්තුව | හේවා කණ්ඩායම
regimental=රෙමේන්තුවට අයත්
regimentation=ක්‍රමිකකරණය | පාලනය කිරීම | පෙළගැස්වීම | පෙළගැසීම | රෙමේන්තුකරණ | රෙමේන්තුකරණය
regina=දේවීන්වහන්සේ
region=අවට ප්‍රදේශය | කලාපය | කොට්ඨාසය | දශාව | දිගන | දිසාභාගය | දිසාව | පළාත | ප්‍රදේශය | ප්‍රාන්තය | පෙදෙස | මණ්ඩලය | මණ්ඩිය | රට | ශරීරයේ කොටස | සාවිය | හරිය
regional=පළාත්බද | ප්‍රාදේශික | ප්‍රාදේශීය | ප්‍රාන්තීය
regionalism=ප්‍රදේශවාදය | ප්‍රාදේශිකවාදය
register=අඟවනවා | අනුලැකිය | අනුලැකීම | ආස්ථාපනය කරනවා | තෝම්බුව | දක්වනවා | නාදපරාසය | නාමලේඛනය | පිරිවද්දනවා | රෙස්ටරය | රෙස්තර කරනවා | රෙස්තරය | ලැයිස්තුව | ලියාපදිංචි කරනවා | ලේකම්පොත | ලේඛන ගත කරනවා | ලේඛනගත කරනවා | ලේඛනය | සටහන් පොත | සිතෙහි තබාගන්නවා
registered=ලියාපදිංචි කල | ලියාපදිංචි වූ | ලේඛනගත
registrar=රෙජිස්ටාර් | ලේකම් | ලේඛන භාර නිලධාරියා
registrar-general=ලේකම්පති
registration=ලියා පදිංචිකිරීම | ලියාපදිංචි කිරීම | ලියාපදිංචිය | ලේඛනගත කිරීම | ලේඛ්‍යාරූඩ කිරීම
registry=රෙස්ත්‍රාර් කාර්යාලය | රෙස්ත්‍රාර්ගේ කාර්යාලය | ලියාපදිංචි කිරීමේ කාර්යාලය | ලේඛනගත කිරීමේ කාර්යාලය
reglette=රෙග්ලට් පතුර
regma=ඒ‍රණ්ඩය
regnal=රාජ්‍යකාලය පිළිබඳ
regolith=ප්‍රාවරණ පාෂාණ
regot=රයි ධාන්‍යගසේ සෑදෙන රෝගයක්
regrading=ප්‍රතිශ්‍රේණිකරණය
regress=අපහසුකම | චක්‍රය | ප්‍රතිගමන | ප්‍රතීති | පිරිහීම
regressand=ප්‍රතීපගම්‍යය
regression=අපහසුකම | ප්‍රත්‍යාගමනය | ප්‍රතික්‍රමණය | ප්‍රතිගමන | ප්‍රතිගමනය | ප්‍රතීපායන | ප්‍රතීපායනය | පිරිහීම | වක්‍රය
regressive=පසුගාමී | ප්‍රතික්‍රම | ප්‍රතික්‍රමණ | ප්‍රතිගතික | ප්‍රතිගමන | ප්‍රතිගාමි | ප්‍රතිගාමී
regressor=ප්‍රතීපකය
regret=කනගාටු වෙනවා | කනගාටුව | පශ්චාත්තාපය | පසුතැවිලි වෙනවා | මඳෑ | විපිළිසර | ශෝකය | සංතාපය | ළතැවිල්ල | ළතැවෙනවා
regretful=කනගාටු සහිත
regrettable=ඛෙදජනක | ශෝචනීය
regualar=ක්‍රමවත්
regul=ඒ‍රණ්ඩය
regular=ඒකාකාර | ක්‍රමවත් | ක්‍රමානුකූල | ක්‍රමික | කුමවත් | නිත්‍ය | නියත | නියම | නියමවිධ | විධිමත් | විධිවත් | වෛධ | සම | සමාකාර | සවිධි | ස්ථාවර සේනාවට අයත් | ස්ථාවර සේනාවේ භටයා | ස්ථීර | හරි
regularity=නිත්‍යතාව | නියමයට එකඟකම | සමමිතිය | සවිධිතාව
regularize=නියමානුකූල බවට පමුණුවනවා | නිවැරදි බවට පමුණුවනවා
regularly=ක්‍රමයෙන්
regulate=ක්‍රමවත් බවට පමුණුවනවා | නියාමනය කරනවා | නියෝග පනවනවා | පාලනය කරනවා | යාමනය කරනවා | විධිමත් කරනවා | හරිගස්සනවා | හසුරුවනවා
regulating=පාලනය කිරීම
regulation=නියමය | නියාමනය | නියෝගය | යාමනය | රෙකුලාසිය | රෙගුලාසිය | ව්‍යවස්ථාව | විධිය
regulations=රෙගුලාසි | විධිනියම
regulative=යාමක
regulator=ආමාන දොරටුව | නියාමකය | පාලකය | යාමක | යාමකය
regulus=දළ ලෝහය | රාකය
regur=රේගුර්
regurgitate=වමාරනවා
rehabilitate=පළමු තත්වයට පමුණුවනවා | පුනරුත්තාපනය කරනවා | පුනරුත්ථාපනය කරනවා
rehabilitation=පුනරුත්ථාපතය | පුනරුත්ථාපනය
rehash=පැරණි බඩු වලින් සෑදූ දෙය
rehearsal=පූර්වනර්තනය | පෙරහුරුව | සජ්ක්ධායනය
rehearse=අස්වනවා | කලින් පුරුදු වෙනවා | කියවනවා | පෙරහුරු කරනවා
reheat=ප්‍රතිතාපය
reheater=අන්තර්තාපකය | ප්‍රතිතාපකය
reheating=නැවත රත් කිරීම | ප්‍රතිතාපනය
reich=ජර්මන් රාජ්‍යය
reign=ආධිපත්‍යය | බලපවත්වනවා | රාජ්‍යකාලය | රාජ්‍යය කරනවා | රාජ්‍යෝදය | විෂය
reimburse=උපදානය කරනවා | ගිය වියදම දෙනවා | වැය වූ මුදල් ආපසු ගෙවනවා
reimbursement=ප්‍රතිපූරණය
rein=තෝන්ලනුව | නාස්ලනුව | පාලනබලය | රේනිස් ලනුව | හසුරුවනවා | හැඩපවත්වනවා
reincarnation=අවතාරය | නැවත නැවත ඉපදීම | පුනර්භවය | පුනරාවතරණය | පුනරුත්පත්තිය
reindeer=පිනි මුවා | පිනිමුවා
reinforce=බලය වැඩි කරනවා | ශක්තිමත් කරනවා | ශක්තිය වැඩි කරනවා | සවිගන්වනවා
reinforced=සවිගැන්වූ
reinforcement=ප්‍රතියත්නය | ප්‍රතිස්ථම්භනය | වඩා දැඩි කිරීම | වැර ගැන්නුම | වැරගැන්නුම | වෙරගැන්වුම
reins=තෝන් ලණුව | යහඬුමිට
reinstate=නැවත සේවයට ගැනීම | නැවත සේවයෙහි පිහිටුවනවා | පුනස්ථාපනය | පුනස්ථාපනය කරනවා | යථා තත්ත්වයට පත් කරනවා
reinstated=පුනර්යුක්ත
reinsure=නැවත රක්ෂණය කරනවා
reintegration=ප්‍රත්‍යනුකලනය
reisemark=රීසෙමාර්කය
reism=යථාර්ථිකරණවාදය
reissue=නැවත නිකුත් කරනවා | නැවත නිකුතුව
reiterate=නැවත නැවත කරනවා | නැවත නැවත කියනවා | පුනර්වාචනය
reiteration=නැවත නැවත කීම | පුනහ්කරණය
reiterative=නැවත නැවත කියන
reject=ඉවතලනවා | නිෂ්ප්‍රභකරනවා | පහ කරනවා | ප්‍රතික්ෂේප කරනවා | පිළිකෙව් කරනවා | බෑ කියනවා | විසි කරනවා
rejected=ප්‍රතික්ෂිප්ත | භ්‍රෂ්ට
rejection=නික්ෂේපණය | ප්‍රතක්ෂේපණය | ප්‍රතික්ෂේප | ප්‍රතික්ෂේප කිරීම | ප්‍රතික්ෂේපණය | ප්‍රතික්ෂේපය
rejector=ප්‍රතික්ෂේපකය
rejig=අලුත් වැඩකට අලුතින් ආවුධ සපයනවා
rejoice=උත්සව පවත්වනවා | ප්‍රමුදිත කරනවා | සන්තෝෂ කරනවා | සන්තෝෂ වෙනවා
rejoicing=අනුමෝදනාව
rejoicings=උත්සව පැවැත්වීම | සන්තෝෂය
rejoin=නැවත සම්බන්ධ වෙනවා | ප්‍රත්‍යත්තර වශයෙන් කියනවා
rejoinder=උත්තරයට උත්තරය | ප්‍රත්‍යක්තිය | ප්‍රත්‍යත්තරය
rejuvenate=තරුණභාවය නැවත ලබාගන්නවා | තිරිහන් කරනවා | තිරිහන් වෙනවා | නව යොවුන් වෙනවා
rejuvenated=තිරිහන්
rejuvenatim=තිරිහන් කිරීම | වාකරණය
rejuvenation=තිරිහන් කිරීම | තිරිහන් කිරීම | තිරිහන් වීම | නවයොවුන් වීම | ප්‍රතියුවීකරණය | ප්‍රතියුවීභවනය | පුනර්යෞවනය | වාකරණය
rejuvenescence=තිරිහන් වීම | නවපණ ගැන්වීම
rekindle=නැවත දල්වනවා
rel-variance=සාපේක්ෂ විචලතාව
relapse=නරක අතට හැරෙනවා | නැවත නරක තත්ත්වයට වැටෙනවා
relapsing=පුනර්පතන | පුනරාවර්තක
relate=අදාළ වෙනවා | අදාළව පවතිනවා | කථනය කරනවා | තොරතුරු කියනවා | විස්තර කරනවා | විස්තර දක්වනවා | සම්බන්ධය ඇති කරනවා
related=අදාළ | ආශ්‍රිත | ඥාති | නෑවූ | සගෝත්‍රීය | සබැඳි | සම්බන්ධ | සම්බන්ධී
relation=කථනය | ඤාතියා | ඥාතියා | තොරතුරු කීම | නෑකම | නෑදෑයා | නෑයා | බන්ධනය | බන්ධු | බන්ධුතාව | සබඳ | සම්බන්ධතාව | සම්බන්ධය | සිය | සියෝ
relations=මිත්‍රත්වය | සබඳකම | හොඳ හිත
relationship=ඥාතිත්වය | නෑකම | බන්ධුතාව | සබැඳියාව | සම්බන්ධතාව | සම්බන්ධය
relative=නෑයා | පරස්පර සම්බන්ධ | සම්බන්ධවාචක | සම්බන්ධී | සාපේක්ෂ | සාපේක්ෂක | සාපේක්ෂකය
relatively=අන්‍යෝන්‍ය අපේක්ෂාවෙන්
relativism=සාපේක්ෂතාවාදය
relativistic=සාපේක්ෂතාශ්‍රිත
relativity=අපරිනිෂ්පන්නතාව | අපේක්ෂාව | ආන්තර්යය | පරස්පරය | සම්බන්ධතාව | සාපේක්ෂතා වාදය | සාපේක්ෂතාව
relator=සම්බන්ධකය
relax=අඩු කරනවා | ඉහිල් | ඉහිල් කරනවා | නිස්කලංකව සිටිනවා | බුරුල් කරනවා | බුරුල් දෙනවා | ලිහිල් කරනවා | විශ්‍රාම ගන්නවා | විස්‍රංස
relaxation=ඉහිල් කිරීම | බුරුල | ලිහිල් කිරීම | විනෝදය | විශ්‍රාන්ති | විශ්‍රාන්තිය | විශ්‍රාමය | ශ්‍රිථිලභාවය | ශිථිලනය
relay=අලුතෙන් සපයන බඩුබාහිරාදිය | නව සම්භාරය | ප්‍රතිචාරණය | ප්‍රතිප්‍රචාරය | ප්‍රතියෝජකය | පිළියවනය
relayrace=කඩින් කඩ දිවීම | රිලේ දිවුම
relearning=ප්‍රත්‍යද්ග්‍රහණය
release=අත හරිනවා | නිකුත් කිරීම | නිදහස | නිදහස් කරනවා | නිදහස් කිරීම | ප්‍රචාරයට පමුණුවනවා | ප්‍රචාරයට පැමිණවීම | මිදැවුම | මිදීම | මිදුම | මුක්තිය | මුඤ්චනය | මුදනය | මුදනවා | මුදා හරිනවා | මුදාහරිනවා | මුදාහැරීම | මොක් | මෝක්ෂය | මෝචනය | ලිහනවා | විහිදුවනවා
released=වුහුටු
relegate=නියම කරනවා
relent=අනුකම්පාව දක්වනවා | ක්‍රෝධය අඩු කරනවා | තදකම අඩු කරනවා | මොළොක් බව දක්වනවා
relentless=ක්‍රෑර | නපුරු | නිර්දය
relevance=අදාළතාව
relevancy=අදාළත්වය | අදාළතාව | අනුකූලත්වය | ඖවත්‍යය
relevant=අදාළ | අනුකූල | අර්ථාන්විත | උචිත | ඖවත්‍ය | ප්‍රස්තුත | සම්බන්ධකමක් ඇති
reliability=විශ්වසනීයත්වය | විශ්වස්‍යතාව | විශ්වාසකම | විශ්වාස්‍යතාව
reliable=විශ්වාස කළ හැකි
reliance=විශ්වාසය
reliant=විශ්වාස ඇති
relic=අවශිෂ්ට | අවශිෂ්ටය | කෞතුක වස්තුව | දා | ධාතුව | නෂ්ටාවශේෂය
relics=අවශේෂ | ධාතු | මෘතශරීරය
relict=අවශිෂ්ට | අවශිෂ්ටය | වැන්දඹු ස්ත්‍රී
relief=අත්උදව්කාරයා | අත්උදව්ව | උන්නත | උන්නතය | නෙරීම | පහසුව | ප්‍රලම්බතාව | පිහිට | පේකඩ | භූ විෂමතාව | භූමිනිර්මාණය | මිදවීම | යහනය | සහන | සහනදායක | සහනය | සහනසාධක | සහාය වීම
relieve=පහසුව සලසනවා | පැහැරගන්නවා | පිහිට සලසනවා | මුදාහරිනවා | සහනය සලසනවා
relieving=සහන | සහනදායක | සහනය කිරීම
religeusx=තාපසිය
relighting=ප්‍රතිජ්වලනය
religieuse=තාපසී
religieux=තාපසයා
religiology=ආගම්වේදය
religion=ආගම | ආගමය | භක්තිය | ලබ්ධිය | සමය
religionist=භක්තිකයා
religiosity=අධික භක්තිභාවය | ආගමිකත්වය
religious=ආගම් පිළිබඳ වූ | ආගමික | ආගමික නිකායකට අයත් | ධාර්මික | භක්තිමත් | ශ්‍රද්ධාසම්පන්න | ශාසනික | සමයානුකූල | සාමයික
religiously=මහත් භක්තියෙන් | ශ්‍රද්ධාවෙන්
religiousness=භක්තිවන්තකම
relining=පිළිපෝරු දැමීම | පෝරු දැමීම
relinquish=අත අරිනවා | අත හරිනවා | අත්අරිනවා | අත්හරිනවා
relinquishment=අත්හැරීම
reliquary=කරඬුව | ධාතු කරඬුව
relique=කෞතුක වස්තුව | නෂ්ටාවශේෂය
relish=අභිලාෂය | ආශා කරනවා | ආස්වාදය | කෙළ ගිලිනවා | තලු මරනවා | රස කරනවා | රසට ප්‍රිය කරනවා | රසනය | රසය | රසවත් බව | රුවය | ස්වාදනය
relive=තව වතාවක් වත් වෙනවා
relocate=අලුත් තැනකට යනවා | ප්‍රතිනිශ්චයනය කරනවා
relocation=බද්ද නවීකරණය
reluct=අදිමදි කරනවා | කෙඳිරිගානවා
reluctance=අකමැතිකම | අමනාපය | විරමණනය | විරමණය
reluctant=අකැමැති | නොකැමැති | පසුබට | ළැදිකමක් නැති
reluctivity=විරමණතාව
rely=බලාපොරොත්තු වෙනවා | විශ්වාසය තබනවා
rem=මාරොස | රෙම්
remain=ඉතුරු වෙනවා | තිබෙනවා | නවතිනවා | පොරොත්තු වෙනවා | රැඳෙනවා
remainder=අවශේෂය | ඉතිරි පංගුව | ඉතිරිය | ඉතුරුව | ශේෂය | සෙස්ස
remained=රැඳි
remaining=ඉතිරි | ඉතුරු | තෙසු
remains=නෂ්ටාවශේෂ | භස්මාවශේෂ | මෘතශරීරය | සුන්බුන්
remand=පරිබන්ධනය කරනවා | රඳවා ගන්නවා | රිමාන්ඩ් කරනවා | රිමාන්ඩ් බාරයේ තබනවා | හිරභාරයේ තබනවා
remanence=අවශේෂය | ධාරණශීලතාව
remark=උපවදන | කතාබහ | දකිනවා | ප්‍රකාශ කරනවා | ප්‍රකාශය | සංලක්ෂ්‍යය | සටහන | සටහන් කරගන්නවා
remarkable=අපූර්ව | පුදුම | විශිෂ්ට
remarque=සලකුණු සෝදුපත
remate=පාරනිශ්වත
remedial=ප්‍රතිකාර වශයෙන් වූ | ප්‍රතිකාර්මික
remediless=අප්‍රතිකාර
remedy=චිකිච්සසාව | ප්‍රතිකර්මය | ප්‍රතිකාරය | පිළියම | පිළියම් යොදනවා | චිකිත්සාව | වෙදකම
remelting=නැවත ද්‍රව කිරීම
remember=මතක තබා ගන්නවා | මතක තබාගන්නවා | මතක් වෙනවා | මෙනෙහි කරනවා | සිතෙහි ධාරණව පවතිනවා | සිහි එළවනවා | සිහි කරනවා | සිහිකරනවා | සිහිපත් කරනවා
remembering=ආවර්ජනය | ස්මරණය | සිහිකිරීම
remembrance=අනුස්මරණය | ස්මෘතිය | සිහිය
remembrances=සමාචාර
remind=නගනවා | නඟනවා | මතක් කරනවා | සරනවා
reminder=මතක් කිරීම සඳහා වූ උපක්‍රමය | මතක්කිරීම
reminiscence=පිළිසැමරුම
reminiscences=අත්දැකීම් සිහිවීම
reminscence=මතක් වීම | සිහිකිරීම
remiss=නොසැලකිලි සහිත | ප්‍රමාදී
remissable=සමාවිය හැකි
remission=දඩසමාව | දණ්ඩශමය | නිවෘත්තිය | පරිහාරය | බලනොපවත්වා නැවතීම | සමාව දීම
remissness=නොසැලකිල්ල
remit=නගනවා | නඟනවා | පවරනවා | ප්‍රේෂණය කරනවා | හරිනවා
remittal=පැවරීම | බාරදීම
remittance=ප්‍රේරණය | ප්‍රේෂණය | මුදල් යැවීම | යැවූ මුදල් | සම්ප්‍රේෂණය
remittances=ප්‍රෙෂණ | යවන මුදල්
remittent=විටින් විට වැළඳෙන
remnant=අවශිෂ්ට | ඉතිරි වූ කැබෙල්ල | කුඩා පංගුව | සෙස්ස
remodel=නැවත සකස් කරනවා
remonstrance=විරෝධතාවය
remonstrate=තරවටු කරනවා | විරෝධය පානවා
remorse=අනුකම්පාව | අනුතාපය | කනස්සල්ල | පසුතැවිල්ල | බලවත් කනස්සල්ල | මහත් පසුතැවිල්ල | විප්‍රතිසාරය
remorseful=බලවත් පසුතැවිලි ඇති
remorseless=අනුකම්පා රහිත | ක්‍රෑර | නිර්දය
remote=අප්‍රසිද්ධ | ඈත | ඉතා දුර වූ | එපිට | එපිටහ | දුරස්තර | දුරස්ථ | දූරස්ථ | යන්තම් | විදුර | විවික්ත
remoteness=විදුරතාව
remoter=විදුරතර
remould=නැවත වාත්තු කරනවා
remoulding=පිළිහැඹීම
removable=අස් කළහැකි | ඉවත් කළ හැකි
removal=අපහරණය | අස් කිරීම | ඉවත්කිරීම | නීහරණ | ප්‍රහරණය | වෙන තැනකට යාම
remove=අරිනවා | අස් කරනවා | අස්කරනවා | අහක් කරනවා | ඈත් කරනවා | ඉවත් කරනවා | ඉවත්කරනවා | උගුළනවා | ඔරවනවා | ගසනවා | ගළවනවා | තල්ලු කරනවා | තුරන් කරනවා | තේරෙනවා | දමනවා | දුර ප්‍රමාණය | නෑකමේ කිට්ටුකම | නෙරපනවා | බැහැර කරනවා | වෙන තැනකට යනවා | වෙන තැනකට යවනවා
removed=අස් කළ | අළ | දුරස්තර | භේද වූ
remunenation=වේතනය
remunerate=ප්‍රත්‍යපකාර කරනවා
remuneration=අර්ථ ලාභය | ගාස්තුව | ප්‍රතිඵලය | පාරිතෝෂිකය | පාරිශ්‍රමිකය | වේචය | වේතනය
remunerative=අභිනව ප්‍රබෝධය | අර්ථලාභි | අර්ථලාභී | නවවනය | පාරිශ්‍රමික | පුනර්වය | පුනරුත්පත්තිය | ඵලදායී | ලාභ උපදින
renaissance=පුනරුදය
renal=වකුගඩු පිළිබඳ වූ | වෘක්ක | වෘක්කීය
renascence=අභිනව ප්‍රබෝධය | නවවනය | පුනරුත්පත්තිය
renascent=නැවත ප්‍රාණවත්භාවයට පැමිණි | පුනර්ජායී
rend=ඉරනවා | උදුරා දමනවා | කැබලි කරනවා | දෙපළු කරනවා | පළනවා
render=ආපසු දෙනවා | ඉදිරිපත් කරනවා | ගයනවා | ගෙනහැර දක්වනවා | දෙනවා | පරිවර්තනය කරනවා | පිරිනමනවා | යම් තත්ත්වයකට පමුණුවනවා | වයනවා | විදහාපානවා | සලකනවා
rendering=ගායනය | පරිවර්තනය | ප්‍රවාචනය | යෙදීම | වාදනය
rendervous=තිප්පොල
rendezvous=රහස් හමුව | සංකේතස්ථානය
rendzina=රෙන්සිනා
renegade=ද්‍රෝහියා | ස්වකීය ආගම අත්හරින්නා
renege=ප්‍රතික්ෂේප කරනවා
renegrade=නිෂේධකයා
renew=අමුතුවෙන් ප්‍රාණවත් කරනවා | අලුත්වැඩියා කරනවා | නැවත ආරම්භ කරනවා
renewal=අලුත් කිරීම | අළුත් කිරීම | ප්‍රතිසංස්කරණය | පිළිසකරණය
renewing=නවකරණ
reniform=වෘක්කාකාර
renin=රෙනින්
rennet=මුහුන්
renormalization=ප්‍රතිප්‍රමතකරණය
renounce=නොහිමියනය කරනවා | සම්බන්ධය ප්‍රතික්ෂේප කරනවා
renovate=අලුත්වැඩියා කරනවා | කටු කොහොල් අරිනවා | ප්‍රකෘතිමත් කරනවා
renovated=ප්‍රතිසංස්කෘත
renovation=අලුත්වැඩියාව | අළුත්වැඩියා කිරීම | කටුකොහොල් හැරීම | පිළිසකර කිරීම
renown=කීර්තිය | ප්‍රසිද්ධිය | විසුළ | සුප්‍රසිද්ධිය
renowned=කීර්තිමත්
rent=ඉරුණු | ඉරුම | කුලිය | කුලියට ගන්නවා | කුලියට දෙනවා | ගෙවල් කුලිය | පැළුණු | පැළුම | බද්ද | බද්දට ගන්නවා | බද්දට දෙනවා | බදු කුලිය | බදු මිල | බදුකුලිය | භාටකය | භාටනය කරනවා | භේදය | රේන්දය
rent-purchase=කුලීකිණුම
rental=කුලිය | ගෙවල් කුලිය | බදු කුලිය | බදු මිල | බදුකුලිය | ශුල්කය
renter=කුලී ගෙවන්නා | බදු ගෙවන්නා | බදුකරු | බදුකාරයා | රේන්දකරු | රේන්දකාරයා
rentes=රොන්ට්
rentier=පොලීකන්නා | බදුකරු
rentiers=පොළි කන්නෝ
renumbered=පුනරංකිත
renunciation=අත් හැරීම | ත්‍යජනය | නිෂ්ක්‍රමණය | නෛෂ්ක්‍රම්‍යය | නොහිමියනය | ප්‍රතික්ෂේපය | සන්‍යාසය
renvoi=රොංවො
reorganisation=ප්‍රතිසංවිධානය
reorganize=ප්‍රතිසංවිධානය
rep=ඝන රෙදි වර්ගයක් | භෞතික රොන්ජන් සමකය | භෞරොස | රෙප්
repaint=ප්‍රතිචිත්‍රණය
repair=අලාභය ගෙවනවා | අලුත් වැඩියා කරනවා | අලුත් වැඩියාව | අලුත්වැඩියා කරනවා | අලුත්වැඩියා කිරීම | අලුත්වැඩියාව | අළුත්වැඩියා කිරීම | අළුත්වැඩියාව | කටු කොහොල් අරිනවා | පිලියම් කරනවා | ප්‍රකෘතිමත් කරනවා | ප්‍රකෘතිමත් කිරීම | ප්‍රතිසමාධානය | පිරියම | පිරියම් කරනවා | පිළියම | පිළියම් කරනවා | පිළිසකර කරනවා | බානවා | වරද හරිගැස්වීම | හරිගස්සනවා
repairable=පිළියම් කළ හැකි
repairs=අලුත්වැඩියා | නවකම්
repar=සදනවා
reparable=හරිගැස්සියහැකි
reparation=ප්‍රකෘතිමත් කිරීම | වන්දිය | වරද හරිගැස්සීම | හානිපූරණය | හානිපූර්ණය
reparations=වන්දි
repartee=මුඛරි ප්‍රත්‍යත්තරය
repartriation=ප්‍රතිදේශීයනය
repast=භෝජන සංග්‍රහය | භෝජනය
repatriate=දේශප්‍රත්‍ය වර්තකයා | දේශප්‍රත්‍යා වර්තනය කරනවා | නැවත සියරට පමුණුවනවා | මව්බිමායනය කරනවා
repatriation=දේශප්‍රත්‍යාවර්තනය | නැවත සියරට පැමිණවීම | පෙරළා සියරට යැවීම | මව්බිමායනය
repay=ආපසු ගෙවනවා | ආපසු දෙනවා | ආපසු ලැබෙන්නට සලසනවා | නැවත ගෙවනවා | නැවත දෙනවා | නැවත ලැබෙන්නට සලසනවා | පලිගන්නවා | ප්‍රත්‍යපකාර කරනවා
repayable=ආපසු ගෙවිය හැකි
repayment=ආපසු ගෙවීම
repeal=අවලංගු කරනවා | අස් කරනවා | සමාලෝපනය කරනවා
repealable=අවළංගු කළ හැකි
repealed=අවලංගු
repeat=අනුව කරනවා | අනුව කියනවා | අස්වනවා | කට පාඩමෙන් කියනවා | නැවත කරනවා | නැවත කියනවා | නැවත කිරීම | නැවත දැක්වෙනවා | නැවත සිද්ධ වෙනවා
repeatability=පුනරාවර්තතාව
repeated=ප්‍රනරාවර්ත | පුනරාගත
repeatedly=පිට පිට | පුනපුනා
repeater=පනරාවර්තකය | පිළිකුරුව | පුනර්යෝජකය
repel=ආපසු පලවා හරිනවා | නෙරපා දමනවා | ප්‍රතික්ෂේප කරනවා | විකර්ෂණය කරනවා | විකර්ෂණය වෙනවා
repellent=ඉතා අරුව වූ | පිළිකුල් ඇති කරන | විකර්ෂකය
repent=පසුතැවිලි වෙනවා | ළතැවෙනවා
repentance=කුකුස | පශ්චාත්තාපය | විප්‍රතිසාරය | සංතාපය | සන්තාපය | සිත්තැවුල | ළතැවිල්ල
repentant=පසුතැවිලි වූ
repentence=පශ්චාත්තාපය | පසුතැවිල්ල | සංකා
repercussion=දෝංකාරය | පරාවර්තනය | පස්සට පැනීම
repercussions=ප්‍රතිවිපාක
repere=අනුයොමුව
reperforator=ප්‍රතිඡිද්‍රකය
repertoire=ඉන්ද්‍රජාලිකයෙකු දත් විජ්ජා රාශිය | සමාහාරය
repertory=කෝශග්‍රන්ථය | භාණ්ඩාගාරය | වර්ගගත ලේඛනය | සංගීත සමූහය | සමාහාර
repetant=පුනරාවර්තිතය
repetend=පුනරාවර්ත්‍යය
repetition=කටපාඩමින් කීම | නැවත කිරීම | නැවත කීම | ප්‍රාසය | පාසා | පිටපත | පුනරාවර්තනය | පුනරාවෘත්තිය | පුනරුක්තිය | පුනරුච්චාරණය
repetitive=පුනර්වර්තී | පුනරුක්තික
repine=කනස්සල්ලෙන් සිටිනවා | පලිගහනවා | ළත වෙනවා
repining=ළත වෙන
repitition=පුනරාවර්තනය
replace=කෙනෙකු වෙනුවට පත් කරනවා | ප්‍රතිස්ථාපනය කරනවා | ප්‍රතිස්ථාපනය කරන්න | සිලව් කරනවා | හිලවු කරනවා
replaceable=ප්‍රතිස්ථාපනය කළ හැකි | ප්‍රතිස්ථාප්‍ය
replacement=ආදේශනය | ප්‍රත්‍යාදේශනය | ප්‍රතිසංස්ථාපනය | ප්‍රතිසම්පාදනය | ප්‍රතිස්ථාපනය | ප්‍රතිස්ථාපනය කිරීම | සිලව්ව
replacent=ප්‍රතිසම්පාදනය
replay=නැවත ක්‍රීඩා කරනවා | නැවත විකාශය කරනවා
replenish=නැවත පුරවනවා | පාඩු පිරිමසාගන්නවා
replenisher=ප්‍රතිපූරකය
replenishment=නැවත පිරවීම
replete=ආඩ්‍ය | පරිපූර්ණ | පෙත්තට පිරුණු | සමෘද්ධ
repletion=පරිපූර්ණත්වය | පරිපූර්ණතාව | බඩපුරා කෑම
replica=අනුරුව | තදාකාරය | දෙවෙනි පිටපත | ප්‍රතිකෘතිය | ප්‍රතිමූර්තිය | ප්‍රතිරූපය
replicate=ප්‍රතිවලිත
replication=ප්‍රත්‍යක්තිය | ප්‍රත්‍යත්තරය | ප්‍රතිඋත්තරය | ප්‍රතිගුණනය | ප්‍රතිගුනය | ප්‍රතිචලිතතාව
replier=උත්තර දෙන්නා
replotted=නැවත ලකුණු කළ
replotting=නැවත ලකුණු කරනවා
reply=උත්තර දෙනවා | උත්තරය | ප්‍රතිවචනය | පිළිතුර | පිළිතුරු දෙනවා | පිළිවදන
report=ආරංචිය | කථාබහ | ජනප්‍රවාදය | ප්‍රසිද්ධ කරනවා | ප්‍රසිද්ධිය | පැමිණිලි කරනවා | රපෝර්තු කරනවා | රපෝර්තුව | වාර්තා කරනවා | වාර්තාකරනවා | වාර්තාව
reporter=වාර්තාකාරයා
repose=තබනවා | තැන්පත් කරනවා | විශ්‍රාන්තිය | විශ්‍රාම ගන්නවා | විශ්‍රාමය | ශයන | ශයන කෝණය | ශ්‍රාන්තිය | ශාන්ත භාවය | සැතපීම | සැතපෙනවා | හාන්සි වෙනවා
reposeful=කලබල නැති | ශාන්ත
reposit=ආරක්ෂාවට තබනවා
repository=කෝශය | කෝෂ්ඨය | කෝෂ්ඨාගාරය | ගබඩාව | ගර්හය | භාණ්ඩාගාරය | සුරක්ෂිතාගාරය
repossess=නැවත බුක්තිය ලබා ගන්නවා
repoussage=සුමටනය
repousse=තලි කැටයම්
repoussoir=අවධායකය
repp=ඝන රෙදි වර්ගයක්
reprecipitation=පුනරවක්ෂේපණය
reprehend=තරවටු කරනවා | දොස් පවරනවා | දෝෂාරෝපණය කරනවා
reprehensible=ගර්භණිය | ගර්හා කළයුතු | දුෂ්ට
reprehension=චෝදනාව | තරවටුව
represent=ඉදිරිපත් කරනවා | ඉදිරිපත් වෙනවා | කියා සිටිනවා | දක්වනවා | නිදේශනය කරනවා | නියෝජනය කරනවා | නිරූපණය කරනවා | පෙනී සිටිනවා | රැඟුම් දක්වනවා
representation=ආදර්ශය | කියාපෑම | දැක්වීම | නියෝජනය | නිරූපණය | චිත්‍රය | සංදර්ශනය
representational=නිරූපාත්මක
representationalism=සංදර්ශකවාදය
representative=ආදර්ශ වශයෙන් දැක්වෙන | නියෝජක | නියෝජනාත්මක | නියෝජිත | නියෝජිතයා | නියෝජීතයා | නිරූප්‍ය | නිරූප්‍යය | සන්දර්ශක | සම්පූර්ණ
representativeness=නිරූප්‍යතාව
represontationism=සංදර්ශකවාදය
repress=යටපත් කරනවා
repressed=අවරෝධිත | යටපත් කල මර්දන
repression=අවරෝධනය | මැඬ පැවැත්වීම
repressive=අවරෝධන | නපුරු | යටපත් කරන | වළක්වන
repressuring=පුනර්පීඩනකරණය
reprieve=තාවකාලික සහනයක් දෙනවා | දඬුවම අත්හිටුවනවා | දණ්ඩනය අත්හිටවනවා
reprimand=තදින් තරවටු කරනවා | තරවටු කරනවා | තරවටු කිරීම
reprint=අභිනව මුද්‍රණය | අභිනව මුද්‍රණයෙහි පිටපත | නැවත මුද්‍රණය කරනවා | ප්‍රතිමුද්‍රණය | පුනර්මුද්‍රිතය
reprisal=එකටෙක කිරීම | පලිගැනීම | ප්‍රතිප්‍රහාරය | ප්‍රතිහිංසාව
reprise=නැවත වාදනය කරනු ලබන සංගීත ඛණ්ඩය
reprive=දඬුවම් අත්හිටුවනවා
reproach=අපකීර්තිය | අපවාදය | අවලාද කරනවා | අවලාදය | ගරහනවා | තදින් දොස් නගනවා | දෝෂාරෝපණය | නින්දාලාපය | නින්දාව
reproachful=අවලාද සහිත | නින්දාත්මක
reprobate=අවලම් | ජඩ | දුෂ්ට | දුෂ්ටයා | පාපිෂ්ටයා | භ්‍රෂ්ට | විසාධනය කරනවා | ශාපලත්
reprobateness=දුෂ්ටකම | නීචකම | පාපිෂ්ටකම
reprobation=ශාප කිරීම
reproduce=නැවත උපදවනවා | ප්‍රතිනිෂ්පාදනය කරනවා | පිටපත් කරනවා | ස්වකීය වර්ගය බෝකරනවා
reproducibility=ප්‍රතිනිෂ්පාද්‍යතාව | පුනර්ජන්‍යතාව
reproduction=අභිජනනය | උත්පාදනය | ප්‍රජනනය | ප්‍රත්‍යත්පාදය | ප්‍රතිනිෂ්පාදනය | ප්‍රතිප්‍රනයනය | පිටපත | පුනනීපැයුම | පුනර්ජනනය | පුනරුත්පාදනය | බෝකිරීම
reproductive=උත්පාදක | ප්‍රජනක | ප්‍රජනන | ප්‍රතිප්‍රනයනක
reprography=ප්‍රතිකෘති ශිල්පය
reprojection=ප්‍රතිප්‍රක්ෂේපණය
reproof=තරවටුව | දෝෂාරෝපණය
reprove=තරවටු කරනවා | බණිනවා
reptile=උරගයා | නීච | නීචයා
reptilian=උරග වර්ගයට අයත්
republic=ජනරජය | සමූහාණ්ඩුව
republican=ජනරජ
republicanism=සමූහාණ්ඩුවාදය
republication=පුනර් ප්‍රකාශනය
repudiate=ප්‍රජහනය කරනවා | ප්‍රතික්ෂේප කරනවා
repudiation=නොපිළිගැනීම | ප්‍රජහනය | ප්‍රතික්ෂේප කිරීම | ප්‍රතික්ෂේපණය | ප්‍රතික්ෂේපනය
repugnance=නුරුස්නාබව | ප්‍රතිකුලතාව | ප්‍රතිකූලතාව | පිළිකුල | බලවත් පිළිකුල | විරෝධය
repugnant=අතිශයින් අප්‍රිය | අනනුකූල | අනනුරූප | අසංගත | නොගැළපෙන | විරුද්ධ
repulse=පරදවනවා | පරාජය | පලවාහරිනවා | පසුබස්වනවා | පසුබැස්වීම | ප්‍රත්‍යාවර්තනය | ප්‍රතික්ෂේප කරනවා | ප්‍රතික්ෂේපය
repulsion=ජුගුප්සාව | නිෂ්කර්ෂණය | විකර්ෂණය | විදැහීම
repulsive=ඉතා කැත | ජුගුප්සිත | පිළිකුල් උපදවන
repulsiveness=ප්‍රති විරුද්ධබව
reputable=සම්භාවනීය
reputation=කීර්තිය | ජනප්‍රවාදය | ප්‍රකීර්තිය | ප්‍රසිද්ධිය
repute=අන්‍යයන්ගේ හැඟීම | කීර්තිය | විශ්‍රැතිය
reputed=ප්‍රකට | ප්‍රසිද්ධ | පිළිගත් | සම්මත
request=අභියාචනය | අයදිනවා | අයදුම | ආයාචනය | ආයාචනය කරනවා | ආරාධනය | ආරාධනා කරනවා | ආරාධනාව | ඇවටිල්ල | ඇවිටිල්ල | ඉල්ලනවා | ඉල්ලීම | ඕනෑකමින් ඉල්ලනවා | සම්ප්‍රයාචනය
requested=ආරාධිත
requets=ක්‍රීඩාවක්
requiem=මෘතශාන්තිකර්මය
require=අණ කරනවා | අවශ්‍ය වෙනවා | නියම කරනවා | ඕනෑ කරනවා
required=අවශ්‍ය | ඇවැසි
requirement=අවශ්‍යකතාව | වුවමනා
requirements=අවශ්‍යතා | කළමනා
requisite=අවශ්‍ය | අවශ්‍ය දෙය | ප්‍රත්‍යය | සාධ්‍යතාව
requisites=අඩුවැඩිය | අවශ්‍ය කරුණු | අවශ්‍යතා | පරිෂ්කාර | පිරිකර
requisition=අදිගැනුම | අධිග්‍රහණය | කොන්දේසිය | බලෙන් ගැනීම | බුකතිය අත් කර ගන්නවා
requisitionist=අධිග්‍රාහකයා | බලෙන් ගන්නා
requital=එකටෙක කිරීම | පලිගැනීම | ප්‍රත්‍යපකාරය
requite=එකටෙක කරනවා | ප්‍රතිදානය කරනවා
rerailing=නැවත පීලි ගැන්වීම
reredos=අල්තාර පරිධාය | අල්තාරය පිටුපස ඇති විසිතුරු තිරය
rerun=නැවත දුවනවා | ප්‍රතිධාවනය
resale=යලි විකුණනවා | යලි විකුණුම
rescind=අවලංගු කරනවා | නිෂ්ප්‍රභ කරනවා | පිරිසුන් කරනවා | පිරිසුන්කරනවා
rescission=අවලංගු කිරීම | පිරිසුන් කිරීම
rescript=ආඥාව | ප්‍රකාශය
rescue=බේරා ගන්නවා | බේරාගන්නවා | මුදවාගැනීම
rescuer=බේරා ගන්නා පුද්ගලයා
research=ගවේෂණය | පර්යේෂණ | පර්යේෂණය | වන්තන වස්තුව
researcher=පර්යේෂක
resection=පරිකණ්ඩනය | ප්‍රතිච්ඡෙදනය | ප්‍රතිඡේදනය
resemblance=අනුහාරය | සාදෘශ්‍යය | සාම්‍යය
resemble=සමානව තිබෙනවා | සමානව වෙනවා | සමානව සිටිනවා
resent=අප්‍රිය කරනවා | අමනාපය දක්වනවා
resentful=අමනාපව සිටින | නුරුස්නා
resentment=අමනාපය | තරහ | ප්‍රතිවිරෝධය
resercher=ගවේෂක
reservation=අපහ්නුතිය | අවශේෂිතය | පිරිසෙය | විශේෂ කොන්දේසිය | විශේෂ නියමය | විශේෂයෙන් වෙන් කිරීම | වෙන් කළ දේ | වෙන් කිරීම | වෙන්කරය | වෙන්කරවා ගැනීම
reservatory=අවශේෂණීය
reserve=අතිරේකය | අපේක්ෂිත ඛනිජය | අමතර | අවශේෂණය | ආරක්ෂිත | ඉතිරි කරන ලද්ද | ඉතිරි කරනවා | කොන්දේසිය | කොහොල්කම | නියම කරනවා | රක්ෂිත ලෙස තබනවා | රක්ෂිතය | විරන්තිය | විශේෂ භටසෙනඟ | වෙන් කරනවා | වෙන් කළ කොටස | වෙන්කළ තැනැත්තා | වෙන්කළ දෙය | ශේෂය | සංචිතය
reserved=අල්පභාෂී | අවශේෂිත | රක්ෂිත | වැඩියක් කතා නොකරන | විශේෂයෙන් නියමිත | වෙන් කළ | සංචිත
reserves=සංචිත
reservist=විශේෂ අවස්ථාවන්හි පමණක් සේවයේ යොදවන හමුදා
reservoir=ආශය | කටාරය | ජලාශය | රදාර | වතුර ටැන්කිය | සංචය | සඤ්චය
reset=ප්‍රත්‍යාරම්භ කරනවා | යළි පිහිටුවනවා
resetting=නැවත පිහිටුවීම
resettle=නැවත පදිංචි කරනවා | පුනස්ථාපනය කරනවා
resettlement=ප්‍රතිවාසනය
reshuffle=කලවම් කරනවා
reside=පදිංචිව සිටිනවා | වාසය කරනවා
residence=ආවාසය | උන්හිටි තැන | නිකේතනය | නිකේතය | නිවස | නිවාසය | නිවෙස | නේවාසික | පදිංවය | මන්දිරය | වලව්ව | වලවුව | වාසභවනය | වාසය | වාසස්ථානය | සිටීම
residency=නිලධාරීන්ගේ වාසස්ථානය
resident=ආවාසික | නිවාසී | නිවැසි | නිවැසියා | නේවාසික | පදිංචි | පදිංචිකරු | පදිංචිකාර වාසික | පදිංචිකාරයා | පදිංවිව සිටින | පොරොත්තු වූ | වාසස්ථානයේ වූ නිලධාරියා | වාසිකයා | වැසි | වැසියා
residential=නේවාසික | පදිංචිය පිළිබඳ | පදිංචියට යෝග්‍ය | මිනිසුන් පදිංචිව සිටින | යහපත් ගෙවල් ඇති
residing=නේවාසික
residual=අවශිෂ්ට | අවශිෂ්ඨ | අවශේප | අවශේෂ | අවශේෂය | ඉතිරි | ඉතුරුව | ශේෂ | ශේෂය | ශේෂ්‍ය
residuary=අවශිෂ්ට | අවශේෂ | ඉතිරි | ශෙෂ්‍ය
residue=අවශිෂ්ටය | අවශේෂය | ඉතිරි පංගුව | ශෙෂ්‍ය | ශේෂය
residues=අවශිෂ්ට | අවශේෂයන්
residuum=අවශිෂ්ටය | දිළිඳුතම කෙට්ඨාශය | පරිශේෂය
resign=අස් වෙනවා | අහක් වෙනවා | ඉල්ලා අස් වෙනවා | ඉල්ලා අස්වෙනවා | අස්වීමේ ලියවිල්ල | ඉල්ලා අස්වීම | ඉවසීම | යටත්වීම | ව්‍යපකර්ෂය
resigned=ඉවසිලිවන්ත | යටහත් පහත්
resilience=ප්‍රත්‍යස්ථිතිය | ප්‍රත්‍යාස්ථිතිය
resilient=පහසුවෙන් ඇදෙන | පහසුවෙන් නැමෙන | ප්‍රත්‍යාස්ථ
resin=ගස්වලින් වෑහෙන ලාටු | දුම්මල | බිම් දුම්මල | රෙසින් | රේසීන් | ලහටු
resiniferous=රෙසිනිධර
resinification=රෙසිනීකරණය
resinosis=රෙසින ගැලීම
resinous=අරාලීය | දුම්මල සහිත | රෙසින්
resins=මැලියම් | රෙසින් | ලහ
resist=ප්‍රතිරුද්ධ කරනවා | ප්‍රතිරෝධ කරනවා | ප්‍රතිරෝධ වෙනවා | බාධා කරනවා | විරුද්ධ වෙනවා | විරුද්ධකම් පානවා | විරොධනය කරවා | විරෝධය පානවා | සටන් කරනවා
resistance=ප්‍රතිරෝධය | බලපෑම | විරුද්ධකම් පෑම | විරෝධනය | විරෝධය | සටන්කිරීම
resistant=දැඩි | ප්‍රතිරෝධ | ප්‍රතිරෝධක | ප්‍රතිරෝධකය | යටත් නොවන
resistence=අවශේෂ රීතිය
resistentialism=අධිෂ්ඨානය | ප්‍රතිරෝධතාවාදය | ප්‍රතිරෝධය
resistivity=ප්‍රතිරෝධකතාව | විශිෂ්ට ප්‍රතිරෝධය
resistless=බාධා නොකළැකි
resistor=ප්‍රතිරෝධකය
resociolization=ප්‍රතිසමාජානුයෝජනය
resoluble=විශ්ලේෂණය කළ හැකි
resolute=තිරසර | දැඩි | නිර්භීත | නිශ්වත | විභින්නය | ස්ථීර
resoluteness=අධිෂ්ඨානය
resolution=අධිෂ්ඨානය | අභිප්‍රාය | අභියෝජනාව | ඤප්තිය | තීරණය | ධෛර්යය | නිශ්චය | ප්‍රනිධිය | ඵලාගමය | බේරුම් කිරීම | යෝජනාව | විච්ඡේදනය | විභේදනය | විශ්ලේෂය | විසර්ජනය | විහේදන බලය | වෙන් කිරීම | සම්මතය
resolve=අධිෂ්ඨානය | ධෛර්යය | නියම කරනවා | නිශ්චය කරනවා | බේරුම් කරනවා | ලිහනවා | විසඳනවා | විසඳෙනවා | වෙන් වෙනවා | සම්මත කරගන්නවා | ස්ථීර අරමුණ
resolved=තීරණය කරන ලද
resolvent=පිළිවිසඳුම | පිළිවිසඳුම්
resolver=පිළිවිසඳුව
resonance=අනුධ්වනිය | අනුනාද | අනුනාදය | දෝංකාරය | ප්‍රතිධ්වනිය | සම්ප්‍රයුක්තතාව
resonant=අනුනාදක | අනුනාදී | මහත් ධ්වනි ඇති
resonate=අනුනාද වෙනවා
resonating=සම්ප්‍රයුක්ත වන | සම්ප්‍රයුජ්‍යමාන
resonator=අනුනාදකය
resorption=ප්‍රත්‍යාවශෝෂණය | ප්‍රතිශෝෂණය
resort=ආයනය | ආශ්‍රය | උපාය | ගැවසීම | ගැවසෙන තැන | සේවනය | සේව්‍යස්ථානය
resound=දෝංකාර දෙනවා | රැව්දෙනවා
resounding=අනුනාදී | ඒකනින්නාදී | මහත් ශබ්ද ඇති
resource=උපකරණය | උපක්‍රමය | උපාය | විචක්ෂණභාවය | විනෝද කාරණය | සම්පත්
resourceful=උපාය දක්ෂ | විචක්ෂණ
resourcefulness=උපාය කෞශල්‍යය
resourceless=අසරණ | උපක්‍රමයක් නැති
resources=උපකරණ සමූහය | ධනය | බලපුළුවන්කම් | සම්පත්
respect=ආකාරය | ආදරය | උපහාරය | ගරු කරනවා | ගරු බුහුමන | ගෞරවය | බහුමානය | බුහුමන | විෂයය | සම්බන්ධය | සම්මානය | සැලකිලි දක්වනවා
respectable=නම්බුකාර | පූජ්‍ය | වැදගත් | සෑහෙන
respectful=ගෞරව සහිත | විනීත
respecting=පිළිබඳ
respective=අනුපිළිවෙලට | පටාකූර | විෂය වූ | ස්වකීය
respectively=අනුපිළිවෙළින් | තනි තනිව | පිළිවෙළින් | වෙන් වෙන්ව
respects=අභිවාදනය | ගෞරවය
respirastion=ශ්වසනය
respiration=ආශ්වාස ප්‍රශ්වාස | ශ්වසනය | ශ්වාසය
respirator=ආශ්වාසයකය | මුඛාවරණය | ශ්වාසකය
respiratory=ශ්වසන
respire=ආශ්වාස ප්‍රශ්වාස කරනවා | හුස්ම ගන්නවා
respirometer=ශ්වසනමානය
respite=අවකාශය | නැවතිල්ල | නිස්කලංකය | පමාතුර | විරාමය
resplendence=දීප්තිය | බැබලීම
resplendent=ඉතා දීප්තිමත් | ඒකාලෝක | ලජ්ජ්වලිත
responce=ප්‍රතිචාරය
respond=අනුකූල ක්‍රියා කිරීම | අනුකූලතා දක්වනවා | උත්තර දෙනවා | ප්‍රතිචාර දැක්වීම | ප්‍රතිවචන කියනවා | පිළිතුරු දෙනවා
respondent=වගඋත්තරකරු
respondentia=නැව් බ බැඳුම්කරය
responsales=පාප් නියෝජිතවරු
response=අනුකූලතාව | උත්තරය | ප්‍රතික්‍රියාව | ප්‍රතිගීතය | ප්‍රතිචාරය | ප්‍රතිවචනය | විසර්ජනය
responsibilities=වගකීම්
responsibility=ප්‍රතිචාරය | වගකීම
responsible=දැනුම් තේරුම් ඇති | භාරදූර | වග කියනවා | වගකිය හැකි | වගකියන | වගකියයුතු | වගකිව යුතු | වැදගත් | සැලකියයුතු
responsive=අනුකූලතා දක්වන | ප්‍රත්‍යත්තර දෙන | වහා පෙළඹෙන
responsiveness=ප්‍රතිචාර්යතාව
rest=ආධාරකය | ආධාරය | ආශ්‍රය | ඇන්ද | ඉතුරු | කමසිරියාව | කමිස්සිරියාව | ගිම නිවනවා | නවතිනවා | නැවතිල්ල | නින්ද | නිඳාගන්නවා | නිවාඩු ගන්නවා | නිවාඩු දෙනවා | නිවාඩුපාඩුව | නිවාඩුව | නිශ්චල | නිශ්චලතාව | නිශ්චලව සිටිනවා | බරව තිබෙනවා | මඩම | මරණය | මැරී සිටිනවා | මුක්කුව | රඳා පවතිනවා | රැන්ද | වාසස්ථානය | විරාමය | විවේකය | විශ්‍රාන්තය | විශ්‍රාමය | ශාන්තිය | සංහිඳ | සංහිඳියාව | සැතපුම | හාන්සි වෙනවා | හැතපුම | හැතැප්ම | හිඳුපත | හේත්තු කරනවා | හේත්තු වෙනවා | හොවනවා
rest-pause=විශ්‍රාම විරාමය
restart=නැවත පටන් ගන්නවා
restatement=පිළිපවසුව | පුනප්‍රකාශය
restaurant=අවන්හල | ආපණය | ආපණශාලාව | ආපන ශාලාව | භෝජනාගාරය
restaurateur=ආපන ශාලාවෙහි පාලකයා
rested=විශ්‍රාමය නිසා සනීප ලත්
restful=කලබල නැති | ශාන්ත
resthouse=ගිමන්හල
resting=අක්‍රිය | සන්ධාරක | සුප්ත
restinga=රෙස්ටීංගා
restitution=ප්‍රත්‍යාගතිය | ප්‍රත්‍යාස්ථාපනය | ප්‍රතිෂ්ඨාපනය | ප්‍රතිසංස්ථාපනය | වන්දි ගෙවීම
restive=අවිනීත | දඟ සහිත
restless=කලබල සහිත | චංචල | දඟලන | නින්ද නැති
restlessness=අනිශ්චලතාව | අසහනය | කසිලිබිසිලි | කහඹිලියාව | නොසන්සුන්කම
restoration=ප්‍රතිෂ්ඨාපනය | ප්‍රතිසංස්කරණය | ප්‍රතිසංස්ථාපනය | ප්‍රතිසාධනය | පුනරුත්ථානය | පුනස්ථාපනය
restorative=ශක්තිජනක ඖෂධය
restore=නැවත පත් කරනවා | නැවත පිහිටුවනවා | නැවත සකස් කරගන්නවා | ප්‍රකෘතිමත් කරනවා | ප්‍රත්‍යර්පණය කරනවා | ප්‍රතිෂ්ඨාපනය කරනවා | ප්‍රතිසංස්ථානය | පිළිසකරනවා | යථාතත්ත්වයට පමුණුවනවා | සනීප කරනවා
restorer=පිළිසකරුව | පුනස්ථාපක
restrain=අඩංගු වෙනවා | අවහිර කරනවා | ප්‍රතිබාධනය කරනවා | මැඩපවත්වනවා | වළක්වනවා | සංවරය | හික්මවනවා
restraining=නිවාරණය | සංහරණය
restraint=අවහිරය | තහනම | ප්‍රතිබාධනය | සංයමය | සංවරය | හික්මීම
restrick=ක්ෂීණ මුද්‍රණය
restrict=අවහිර කරනවා | පරිසීමා කරනවා | සීමා කරනවා
restricted=සසීම | සීමිත
restriction=තහනම | නියමය | පරිසීමාව | සීමා කිරීම | සීමාව
restrictions=අවහිර | සීමා කිරීම
restrictive=බාධක
restructure=නැවත පිළියෙල කරනවා
result=අවසානය | ආනිසංසය | කෙළවර වෙනවා | තීන්දුව | පඩිසන් දෙනවා | පලදෙනවා | පලය | ප්‍රතිඵල වශයෙන් ලැබෙනවා | ප්‍රතිඵලය | ඵල | ඵලය | විපාකය | සිද්ධ වෙනවා
resultant=ඵලජ | ඵලරූපය | සම්ප්‍රයුක්ත | සම්ප්‍රයුක්තය | හේතුවෙන් ඇතිවන
results=ඵලාඵල
resume=නැවත අරඹනවා | නැවත ආරම්භ කරනවා | නැවත පටන් ගන්නවා | පුනර්ග්‍රහණය කරනවා | පුනරාරම්භ කරනවා | සංක්ෂේපය | සංග්‍රහය | සාරාංශය
resumed=පුනර්ගෘහීත | පුනරාරබ්ධ
resumption=ආරම්භ කිරීම | නැවත ගැනීම | පුනර්ග්‍රහණය | පුනරාරම්භය
resumptive=නැවත ඇරඹෙන
resurface=මතුපිටට එනවා
resurgence=පුනරුජ්වනය | පුනරුත්ථානය
resurgent=නැවත නැඟී සිටින
resurrect=ඉදිරිපත් කරනවා | නැවත පණ උපදවනවා
resurrection=ප්‍රත්‍යත්ථානය | පුනරුජ්වනය | පුනරුත්ථානය | මළවුන්ගෙන් නැගිටීම | මෘතෝත්ථානය
resuscitate=නැවත ප්‍රාණවත් කරනවා | ප්‍රබෝධ කරනවා
resuscitation=ප්‍රබෝධ කිරීම
retail=බෙදා විකුණනවා | සිල්ලර | සිල්ලරට | සිල්ලරට විකිණීම
retailer=සිල්ලර වෙළෙන්දා
retailing=සිල්ලර වෙළෙඳාම
retain=අත් නෑර තබාගන්නවා | අල්ලාගන්නවා | තබා ගන්නවා | නවත්වා ගන්නවා | නියුක්ත කරනවා | පත්තියම් වෙනවා | රඳවනවා | රඳවා ගන්නවා | ශක්තිමත් කරනවා
retainer=අනුවරයා | නියුක්ත මිල | භටයා | සේවකයා | හෙංචප්පු
retake=නැවත ගන්නවා
retaliate=එකට එක කරනවා | එකටෙක කරනවා | පලිගන්නවා
retaliation=එකටෙක කිරීම | පලි ගැනීම | ප්‍රතිහිංසාව
retaliatory=පලිගැනීමේ අදහසින් කරන
retamer=නියුක්ත මිල
retard=පමා කරනවා | ප්‍රමාද කරනවා | බාධා කරනවා | වේගය අඩු කරනවා
retardant=මන්දකය
retardation=පමා කිරීම | මන්දනය
retarded=ආබාධිත
retarder=මන්දකය
retch=ඔක්කාර කරනවා
retention=අත්නෑර තබාගැනීම | ධාරණය | වැළැක්ම
retentive=දරා සිටින | ධාරණ ශක්තිය ඇති
retentiveness=ධාරණ ශක්තිය
retentivity=ධාරණ ශක්තිය | ධාරණශීලතාව
reterntiveness=වගකීම
reticence=නිශ්ශබ්දතාව
reticent=කුලෑටි | යමක් කීමට මැළි | වඩා කථා නොකරන
reticle=ජාලිකාව
reticulate=ජලාභ | ජාලාකාර | ජාලාභ | දැලක් වැනි
reticulated=ජාලිකාවත්
reticulation=ජාලය | ජාලිතය | දැලක් වැනි සැලැස්ම
reticule=ජාලිකාව | දැල් පසුම්බිය
reticulum=ජාලිකාව
retina=දර්ශන පටලය | දෘෂ්ටි විතානය | දෘෂ්ටිවිතානය | රෙටිනාව | විතංසතිය | විතංසනිය | විතංසය
retinaculate=නැටිති සහිත
retinaculum=නැටිත්ත
retinerved=දැල් නාරටි සහිත
retinue=ආවතේවකාරයෝ | කැටුව යන සෙනඟ | පිරිවර ජනයා | සහපිරිවර
retire=අස්ව යනවා | ඉවත් වෙනවා | ඉවත්ව යනවා | පසුබසිනවා | විවේකය සොයා යනවා | විශ්‍රාම ගන්නවා
retired=අප්‍රසිද්ධ | අස් වූ | පිටිසරබද | විවික්ත | විශ්‍රාම ලත්
retirement=විශ්‍රාම ගැනීම | විශ්‍රාමය
retiring=ඉතා විනීත | ඉදිරිපත් වීමට අකැමැති | තනිව සිටීමට කැමැති | සමාජයට නොකැමැති
retorsion=පිළිවදන
retort=ආසවන යන්ත්‍රය | ඇනුම්පදය | එකට එක කියනවා | එකටෙක කරනවා | එකටෙක කියනවා | කට ගහනවා | ප්‍රතිවාදය | පිළිවදන | පිළිවදන් දෙනවා | බක යන්ත්‍රය | හංසපාතිය
retouching=ප්‍රතිපරාමර්ශය
retrace=නැවත සොයා යනවා
retract=අස්කැරැගන්නවා | පස්සට අදිනවා | ප්‍රත්‍යාභාෂණය කරනවා | වරද පිළිගන්නවා
retractable=වරද පිළිගන්නා
retractile=ප්‍රතිකර්ෂක | වරද පිළිගන්නා
retraction=අස් කර ගැනීම | ධාරණ ශක්තිය | ප්‍රත්‍යාභාෂණය | ප්‍රතිකර්ෂණය
retractor=ප්‍රතිකර්ෂක
retraining=පුනරභ්‍යාසය
retransmission=ප්‍රතිසම්ප්‍රේෂණය
retread=ටයරයකට අඩියක් ගහනවා | නැවත පුරවන ලද ටයරය
retreat=අපක්‍රමණය | අපගමනය | අපගමය | ඇලව තිබෙනවා | උපවාසය | පස්සට නැමී තිබෙනවා | පසු බසිනවා | පසු බැසීම | පසුබැසීම | වස්කාලය | විවේකී ස්ථානය | හුදකලාව විසීම
retrench=කපාහරිනවා | වියදම අඩු කරනවා | සේවක සංඛ්‍යාව අඩු කිරීම
retrenchment=වියදම අඩු කිරීම
retrial=නැවත විභාගය | පුනසමේෂණය
retriangulation=ප්‍රතිත්‍රිකෝණනය
retribution=ප්‍රතික්‍රියාව | ප්‍රතිඵලය | ඵලවිපාකය | විපාක | විපාකඵලය | විපාකය
retributive=විපාකදායී | විපාකය දෙන
retrieval=සමුද්ධරණය
retrieve=වරද හරිගස්සා ගන්නවා | සොයා ලබාගන්නවා
retriever=වෙඩි තැබු කුරුල්ලන් හෝ සතුන් සොයා ගෙන ඒමට පු
retro-flexion=පස්සට නැමීම
retro-rocket=අභ්‍යවකාශ යානයක මන්දනය ඇතිකරවන රොකට්ටුව | ප්‍රතිගාමක රොකට්ටුව
retroact=එරෙහිව ක්‍රියා කරනවා
retroaction=පරාක්‍රියාව | ප්‍රතික්‍රියාව
retroactive=අතීතයේ සිට බලපවත්වන | පරාක්‍රිය | පූර්වකාරී
retroflexed=පුනර්වර්තී
retrogation=ප්‍රතික්‍රම | ප්‍රතික්‍රමණ
retrogradation=ප්‍රතික්‍රමණය
retrograde=දියුණුවට බාධක වූ | පරාවර්තී | ප්‍රතිගාමි | ප්‍රතිගාමී | වක්‍රවෙනවා
retrogress=ආපස්සට යනවා | ක්ෂය වෙනවා
retrogression=ග්‍රහයන්ගේ චක්‍ර ගමන | පසුබැසීම | ප්‍රත්‍යාවෘත්තිය | ප්‍රතිගමනය | පිරිහීම
retrogressive=පසු බසින | ප්‍රතිගාමී
retrorse=ප්‍රතිනත
retrospect=අතීතය දෙස බැලීම | අතීතාවලෝකනය | පශ්චාත්දෘෂ්ටිය | ප්‍රත්‍යාවලෝකනය | සිංහාවලෝකනය
retrospection=අතීත සිද්ධි අවලෝකනය කිරීම | ප්‍රත්‍යාවලෝකනය | ප්‍රත්‍යෙක්ෂණය
retrospective=අතීතයට බලපාන | අතීතානුයෝගී | පසුගිය දේට බලපාන | ප්‍රත්‍යවලෝකන | ප්‍රත්‍යවේක්ෂණ | ප්‍රත්‍යවේක්ෂා
retroussage=තැවරුම
retroversion=ප්‍රත්‍යාවර්තනය
retroverted=අනෙක් පස හරවන ලද
retsina=ග්‍රීසියේ මුද්‍රික පානයක්
retting=පල් කිරීම | පල් වීම
return=ආපසු එවුම | ආපසු ගෙවනවා | ආපසු තබනවා | ආපසු දමනවා | ආපසු දෙනවා | ආපසු යෑම | ඊම | තොරතුරු ඇතුළත් ලියවිල්ල | තෝරනු ලැබීම | ප්ර්රතිලාභය | ප්‍රත්‍යපකාරය | ප්‍රත්‍යාගමනය | ප්‍රතිලබ්ධිය | ප්‍රතිලාභ | ප්‍රයෝජනය | පැවසුම් | පෙරළා එනවා | ඵල | ලැබෙන්නට සලසනවා | ලේඛනය | ව්‍යාකාරය | වාර්තාව | විස්තර වාර්තාව | වෙන්නට සලසනවා
return-ticket=යාම් ඊම් දෙකටම ප්‍රවේශ පත්‍රය
returning=ආවර්ත | පුනරාගමනය | හැරෙන
returns=ප්‍රතිලබ්ධි | වාර්තාව
retuse=නතාග්‍ර
reunion=නැවත හමුවීම | ප්‍රතිසංගමය | යළි එක්වීම
revaluation=ප්‍රත්‍යාගණනය | ප්‍රතිප්‍රමාණ කිරීම | ප්‍රතිප්‍රමාණනය | ප්‍රතිප්‍රමාණය | ප්‍රතිමාණය | පිළි ඇගයීම | පිළිඅගැයුම | පිළිඇගැයීම
revalue=නැවත අගය කරනවා
revamp=අලුත්වැඩියා කරනවා | හරිගස්සනවා
reveal=අනාවරණය | එළිදරවු කරනවා | ප්‍රකට කරනවා | ප්‍රකාශ වෙනවා | හෙළි කරනවා | හෙළිකරනවා | හෙළිවෙනවා
reveille=අලුයම අවදි වීමට කරන නළා හෝ බෙර හජ
revel=අතිශයින් ප්‍රීති වෙනවා | ප්‍රීත්‍යත්සවය | ප්‍රීති ඝෝෂා පවත්වනවා | මධුපානෝත්සවය
revelation=ආනුශ්‍රවිකය | ආවිෂ්කරණය | එළිදරව්ව | දේවවාක්‍යය | ප්‍රකාශනය | භවිෂ්‍යත් විදර්ශනාව | රහස් එළිදරවු කිරීම | වේදය | ශ්‍රුතිය | හෙළිදරව්ව
reveller=මධුපානෝත්සවයට සහභාගි වන්නා
revelry=ඝෝෂාකාර උත්සවය
revenge=එදිරි පිරිමැහුම | පලිගන්නවා | පලිගැනීම | පලිය | පළිගන්නවා | පළිගැනීම | පළිය | වාඩුව | වෛරබුද්ධිය
revengeful=පලිගැනීමට ආශා ඇති
revenger=පළි කාරයා
revenue=අය | අය භාරය | අයභාරය | ආදානය | ආදායම
reverberant=නින්නාදී
reverberate=ගිගුම් දෙනවා | දෝංකාරය ඇති කරනවා | දෝංකාරය ඇති වෙනවා | ප්‍රතිරාවය ඇති කරනවා | ප්‍රතිරාවය ඇති වෙනවා
reverberation=අනුනාදය | දෝංකාරය | ප්‍රතිධ්වනිය | ප්‍රතිනාදනය | ප්‍රතිනාදය
reverberator=ප්‍රතිනාදකය
reverberatory=ප්‍රතිනාදක | ප්‍රතිප්‍රභාරක
revere=ගරු කරනවා
revered=පූත | සම්මානිත
reverence=නමස්කාරය | ප්‍රණාමය | මහත් ගෞරව දක්වනවා | මානනය | සම්මානය
reverend=පූජ්‍ය | වහන්දෑ | වහන්සේ
reverent=ගෞරව සහිත | භක්තිමත් | විනීත
reverential=ගෞරව සහිත | භක්තිමත් | විනීත
reverie=ආවන්තාව | කල්පනාවෙහි ගැලී සිටීම | ධ්‍යානය | වන්තනය
revers=වාටි කනපිට
reversal=පරාජය | ප්‍රත්‍යාවර්තනය | ප්‍රතිනමනය | ප්‍රතිවර්තනය | විපර්යාසය | වෙනස් කිරීම | වෙනස් වීම
reverse=අනික් | අනික් පැත්ත | අවලංගු කරනවා | ආපස්සට | ආපසු | ආපිට | පරාජය | පස්ස ගහනවා | ප්‍රතිනමනය කරනවා | ප්‍රතිපක්ෂ | ප්‍රතිපක්ෂය | ප්‍රතිභ්‍රමනය වෙනවා | ප්‍රතිලෝම | ප්‍රතිවර්ත | ප්‍රතිවර්ත කරනවා | ප්‍රතිවර්තන | ප්‍රතිවර්තනය | ප්‍රතිවර්ත්‍යය | පිටපැත්ත | පිළිලොම් | පෙරළනවා | බාධාව | විපර්යාසය | විපරීත | විරුද්ධ | විලෝම
reversely=අනික් අතට
reverser=ප්‍රතිවර්තකය
reversibility=ප්‍රතිවර්ත්‍යතාව
reversible=ප්‍රත්‍යවර්ත්‍ය | ප්‍රතිනම්‍ය | ප්‍රතිවර්ත්‍ය | පෙරළිය හැකි | වෙනස් කළ හැකි
reversing=ආපසු යැවීම | ප්‍රතිවර්තනය
reversion=ආපසු පෙරළීම | ප්‍රත්‍යාගමනය | ප්‍රත්‍යාවර්තනය | ප්‍රතිලාභය | ප්‍රතිවර්තනය | විපර්යාසය
reversionary=ප්‍රතිලාභි | ප්‍රතිවර්තක
reversioner=ප්‍රතිලාභියා | මතුලබන්නා
revert=ආපසු ඒම | ආපසු පැමිණෙනවා | ආපසු යනවා | එළඹෙනවා | පස්සට හරවනවා | ප්‍රතිවර්තක වෙනවා | ප්‍රතිවර්තනය | ප්‍රතිවර්තනය වෙනවා | ලැබෙනවා
revertive=ප්‍රතිනිවර්ත්‍ය
revery=අවන්තාව | ආවන්තාව
revesting=පුනවේෂ්ටනය
revet=අරකිනවා | ගල් බැඳීමෙන් ශක්තිමත් කරනවා | ගල්බැම්මක් යොදා ශක්තිමත් කරනවා
revetment=ඇරැකුම් බැම්ම | බදාම ඇල්ලීම
review=ග්‍රන්ථ විචාරය | ගුණදොස් විවේචනය | ගුණදොස් විවේචනය කරනවා | නැවත සිතා බලනවා | නිරීක්ෂණය | පරීක්ෂණය | පරීක්ෂා කර බලනවා | පුනරීක්ෂණය කරනවා | විමංසනය | විමර්ශනය | විවේචනය | ශාස්ත්‍රීය සඟරාව | සම්මර්ශනය | සමාලෝචනය
reviewer=විචාරකයා
revile=අපහාස කරනවා | ගරහනවා | නින්දා කරනවා | පරිභව කරනවා | පහස කියනවා
revilement=පරවම්භනය
reviler=අපහාසය
revisal=සංශෝධනය | හරිවැරදි බැලීම
revise=ප්‍රතිශෝධනය | ප්‍රතිශෝධනය කරනවා | වරද හරිගස්සනවා | වෙනස් කරනවා | සංශෝධනය කරනවා | හරි වැරදි බලනවා
revised=සංශෝධිත
revision=පරිශෝධනය | ප්‍රතිශෝධනය | පුනරීක්ෂණය | ශුද්ධිය | සංශෝධනය | සංස්කරණය | හරිවැරදි බැලීම
revisionism=ප්‍රතිශෝධන වාදය | විවේචනය
revisory=සංශෝධක
revival=අලුත් උද්‍යෝගය | උන්නතිය | නව වනය | නැවත පණ පිහිටුවීම | ප්‍රත්‍යානයනය | පුනර්වනය | පුනරුත්ථානය | පුබුදුව
revivalism=පුනර්වනවාදය
revivalist=ආගමික භක්තිය පණ ගන්වන්නා
revive=නැවත උද්‍යෝගවත් කරනවා | නැවත උද්‍යුෝගවත් වෙනවා | නැවත ප්‍රාණවත් කරනවා | නැවත ප්‍රාණවත් වෙනවා | පණ පිහිටුවනවා
reviver=මත්පැන් අඩිය
revivify=ක්‍රියාශීලී කරනවා | නවපණක් දෙනවා | යළි ශක්තිමත් කරනවා
revocable=අස්කළ හැකි | අහෝසි කල හැකි
revocation=අවලංගු කිරීම | අහෝසි කිරීම
revoke=අවලංගු කරනවා | අස් කර ගන්නවා | අහෝසි කරනවා | කඩ කරනවා | නිෂ්ප්‍රභ කරනවා | ප්‍රත්‍යාදිෂ්ට කරනවා
revolt=කැරලි ගසනවා | කැරැල්ල | ප්‍රතිශෝධනවාදය | පෙරළිය | බලවත් අමනාපය දක්වනවා | බලවත් නොකැමැත්ත | බලවත් පිළිකුල දක්වනවා | රාජ විරෝධය | විප්ලවය
revolter=කැරලිකරුවා
revolting=පිළිකුල් දනවන
revolute=ප්‍රතිවලිත
revolution=කරකැවීම | කැරකීම | චක්‍රය | පරිභ්‍රමණය | මහත් විපර්යාසය | විප්ලවනය | විප්ලවය
revolutionary=අතිශයින් විපර්යාස වූ | කැරලිකාර | පෙරළිකාර | විපර්යාස කාරයා | විප්ලවකාරි | විප්ලවකාරී | විප්ලවවාදියා | විප්ලවවාදී
revolutionize=විප්ලවීකරණය | සම්පූර්ණයෙන් වෙනස් කරනවා
revolve=කරකවනවා | කැරකැවෙනවා | පරිභ්‍රමණ වෙනවා | පරිභ්‍රමණය කරනවා | පරිභ්‍රමණය වෙනවා | පරිශ්‍රමණය වෙනවා | පිළිවෙලින් වටේ යනවා | සිත සිතා ඉන්නවා
revolver=කැරකෙන පිස්තෝලය | පරිභ්‍රමකය
revolving=ආවර්ත | කරකැවිල්ල | කැරකෙන | පරිභ්‍රමණ වන | භ්‍රමක
revue=රිව්‍ය රංගය | විවිධ ප්‍රසංගය
revulsion=පිළිකුල
reward=ත්‍යාග කරනවා | ත්‍යාගය | තෑග්ග | තෑගි දෙනවා | දාක්ෂිණ්‍යය | පරිදානය | පරිදානය කරනවා | ප්‍රතිඵලය | පාරිතෝෂය | පාරිතෝෂිකය | විපාක ඇති කරනවා | විපාක දෙනවා | ශුභඵලය
rewarding=අගනා ප්‍රතිඵල ලබාදෙන | ඉටුඵලදායී
rewind=නැවත ඔතනවා
rewinding=නැවත එතීම
rewire=නැවත විදුලි රැහැන් අදිනවා
reword=වෙනත් වචනයෙන් කියනවා
rewrite=නැවත ලියනවා
rfling=රයිපලයක හාරන ලද ඉරි ඇති පිළිවෙළ
rgveda=සෘග්වේදය
rhachilla=අනුප්‍රාක්ෂය | ප්‍රාක්ෂිකය
rhachis=ප්‍රාක්ෂය
rhaetic=රයටික්
rhamnase=රැම්නේස්
rhamnin=රැම්නින්
rhaphe=සේවනිය
rhaphide=සුවස්ඵටිකය
rhapsodist=අතිශයෝක්ති රචනා කරන රචකයා
rhapsodize=අතිශයෝක්ති රචනාවක් කරනවා
rhapsody=අතිශයෝක්තිය | ආටෝප සහිත රචනාව | රැප්සඩිය | ව්‍යාකුල ප්‍රබන්ධය
rhe=රීය
rhegma=ඒ‍රණ්ඩය
rheine=රෙයින්
rhenichloride=රේනික් ලෝරයිඩ්
rhenium=රෙනියම් නමැති මූලද්‍රව්‍යය | රේනියම්
rheobasis=ධාරාවමය
rheology=ස්‍රැති විද්‍යාව
rheometer=රෙයොමීටරය
rheonomic=කාලායත්ත
rheophyte=ප්‍රවාහශාකය
rheorician=ආලංකාරිකයා
rheoscope=රෙයොවීක්ෂය
rheostat=ධාරා නියාමකය | ධාරානියාමකය | ධාරාස්ථාපය
rheotropism=ධාරාවර්තනය
rhesus=කුඩා වඳුරු විශේෂයක්
rhetoric=අලංකාර ශාස්ත්‍රය | අලංකාරෝක්තිය | ඉෂ්ඨඵලය | වාගලංකාරය
rhetorical=උපමා උපමේය සහිත
rhetorics=අලංකාරශ්‍රස්ත්‍රය
rheum=ශ්ලේෂ්මාධිකය | සෙම
rheumatic=වාත
rheumatics=රක්තවාතය | වාතරක්තයෙන් පෙළීම පිළිබඳ | වාතරක්තයෙන් පෙළෙන | වාතරෝගියා
rheumatism=රක්තවාතය | රූමැටිසියාව | වාතජ්වරය | වාතරක්තය
rheumatoid=රක්තවාත ලක්ෂණ ඇති
rheumy=තෙත් වූ | සෙම් වෑහෙන
rhinal=නාසය පිළිබඳ වූ
rhinestone=අරුමෝසම් දියමන්ති
rhinitis=ඝ්‍රාණදාහය
rhinoceros=කඟවේණා | රයිනෝසිරස්
rhinophyma=ඝ්‍රාණ රුහිතය
rhipicephalus=රිපිකෙපලස්
rhipidium=රිපිඩියම
rhisophora=කඩොල් ගහ
rhizanthous=මුලපුෂ්පී
rhizautocious=මුලෛකගෘහී
rhizina=ශිඵාව
rhizine=ශිඵාව
rhizobium=රිසොබියුම්
rhizocaline=රයිසොකේලීන්
rhizocarpic=මූලඵලීන
rhizocarpous=මූලඵලීන
rhizoccarpae=රිසොකාපේ
rhizoctonia=රිසෝක්ටෝනියා
rhizogenic=මුලජන්‍ය
rhizoid=මූලාභය
rhizoidal=මූලාභ
rhizomatic=රෛසෝමීය
rhizomatose=රෛසෝමීය
rhizome=රයිසෝමය | රෛසෝමය
rhizomic=රෛසෝමීය
rhizomorph=මුලාංගය
rhizophore=මුලධරය
rhizopodium=මුලපාදිකය
rho=ග්‍රීක හෝඩියේ දාහත් වන අකුර
rhodate=රෝඩේට්
rhodium=රෝඩියම් | ලෝහමය මූලද්‍රව්‍යයක්
rhododendron=මහ රත් මල් ගහ | මහරත්මල්
rhodophyll=රොඩොපිල්
rhodophyta=රොඩොපීටා
rhodoplastid=රක්තලවය
rhodopsin=රොඩොප්සින්
rhoebase=ධාරාවමය
rhomb=රොම්බසය
rhombic=රොම්බසීය
rhombid=රොම්බසාකාර
rhombo-triangle=පිකඩ මෝස්තරය | පිකඩය
rhombobedral=රොම්බතල
rhombohedral=රොම්බස්තල
rhombohedron=රොම්බතලය | රොම්බස්තලය
rhomboid=රොම්බසාකාර | රොම්බසාභය | රොම්බාභය
rhomboidal=රොම්බසාභ | රොම්බාභ
rhombus=රොම්බ | රොම්බසය
rhubarb=පැළ වර්ගයක්
rhumbatron=රම්බට්‍රෝනය
rhyme=එලිසමය | එළිසම කරනවා | එළිසම වෙනවා | එළිසමය | කවි තනනවා | තානම | තාලය
rhymer=රයිමරය
rhymeter=පද්‍ය රචකයා
rhythm=අලංකාරශාස්ත්‍රය | ගීතස්වරය | තාලය | රිත්මය | රිද්මය | රිද්මය | ලය | සමපදතාව | සසය
rhythmic=තාලයට අනුරූප වූ | රිත්මයානුකූල | ලයානුසාරී
rhythmical=තාලයට අනුරූප වූ | ලයානුසාරී
rhytidome=සංයුක්ත පරිචර්මය
rhyton=රයිටන් චෂකය
ria=රියාව
rib=ඉලය | ඉළඇටය | නාරටිය | පර්ශුව | පරාළය | පාර්ශුකාව | මහානාරටීය | වැරකඩ
ribald=කැත | කැතයා | තුච්ඡ | නීච | නීචයා
ribaldry=අසභ්‍ය කථාව | දුරුක්තිය
riband=දිගතීරුව
ribbed=නාරටි සහිත | පර්ශුක
ribbon=පීත්තපටිය
riboflavin=රයිබොප්ලේවින්
rice=ගොයම් | බත | බත් | ව්‍රීහි | වී | ශාලි | සස් | සහල | සහල් | සාල් | සාලි | හාල් | හැල් | හුළු
rice-gruel=කඤ්ජ
rich=අනර්ඝ | අලංකාර | ආඩ්‍ය | ඉතා මිහිරි | ඉසුරුමත් | ධනවත් | ප්‍රණීත | පොහොසත් | රසවත් | ලූ | විපුල | සධන | සමෘද්ධ | සරු | සාර | සාරවත් | හරකං | හාස්‍යජනක
riches=ධනය | වස්තුව | සම්පත් | සැපත
richly=උසස් අන්දමින්
richness=ලූව | සමෘද්ධිය | සාරවත්භාවය
ricinolein=රිසිනොලෙයින්
rick=ගොයම් කොළය | පිදුරු බිස්ස
rickery=හොරය
rickets=ග්‍රහණිය | ග්‍රහනිය | ගිරහණිය | මාන්දම | රිකට්සය
rickettsaie=රිකෙට්සී
rickettsia=රිකෙට්සියා
rickety=වැනෙන | ශක්ති නැති | සන්ධි දුර්වල වූ
rickshaw=රික්ෂෝරථය
ricochet=උණ්ඩය පැන පැන යන ලෙස වෙඩි තබනවා | ගල වතුරේ පැන පැන යන ලෙස වීසි කිරීම | ගල වතුරේ පැන පැන යන ලෙස වීසිකරනවා
rid=ඉවත් කරනවා
riddance=ඉවත් කිරීම | බේරීම
riddle=ගැටලු ප්‍රකාශය | තුන්තේරවිල්ල | ප්‍රහ්ලිකාව | ප්‍රහේලිකාව | පෙනේරෙන් හළනවා | ලොකු පෙනේරය | හලනය
riddlings=හලු කැට
ride=කරපින්නවාගෙන යනවා | පාවෙනවා | පැද යනවා | පැදගෙන යනවා | පෙළෙනවා | වාහනයක නැඟී යාම
rider=අතුරු වාර්තාව | අනුප්‍රකාශය | අනුමේයය | අශ්වාරෝහකයා | ආරෝහකය | ආරෝහකයා | පරිශිෂ්ටය
ridge=උස් වූ වැටිය | කඳුවැටිය | මාර | මියර | මුදුන | වහලේ මුඳුන් වැටිය | වැටිය | වෙහෙලි | සැස්ම | හෙල්‍රූන
ridge-pole=කැණිමජල
ridgeway=කඳුවැටිය අයිනේ පාර
ridicule=අවමන් කරනවා | අවහාස කරනවා | අවහාසය | උපහාසය | පරිහාසය | සමච්චල් කරනවා | හෙළා දැකීම
ridiculous=විහිළු | හාස්‍ය
riding=දැති පිට වැටීම | පුරාණ යෝර්ක්ෂයර් ප්‍රාන්තයෙහි කොටසක්
riel=රියල
rife=බහුල
riff-raff=රස්තියාදුකාරයෝ | රොඩු | වැදගම්මකට නැති අය
riffle=ගල්පරය | පොතක පිටු පෙරළනවා
riffler=දුනු පීර
rifle=අත් තුවක්කු විශේෂයක් | රයිපලය
rifleman=තුවක්කුවක් සහිත සොල්දාදුවා
rift=නිමරුව | පැල්ම | පැළුම | භේදය | විවරය
rig=කුඹය | පැළඳගන්නවා | පෙරුම් පුරනවා | විදුම් යත | විශේෂ ඇඳුම් අන්දනවා
rigger=පටි කප්පිය | රිගරය
rigging=නැවේ ආම්පන්න
right=අයිතිය | අයිතිවාසිකම | දකුණ | දකුණට | දකුණු | ධර්මය | නතුව | නියම | නියම තැන තබනවා | නිවැරදි | නිසි | පිහිටුවනවා | බොහෝ සේ | යහපත් ලෙස | යුක්තිය | යුක්තිය සලසනවා | යුතුකම | වැරදි හරිගස්සනවා | සත්‍ය | සාධාරණ | සුදුසු සේ | සෘජු | හරි | හිමිකම | හොඳ
right-angle=සෘජුකෝණය
right-hand=දකුණත
right-hand-man=අවශ්‍ය සහකාරයා | දකුණු අත
right-handed=දකුණත හුරු | සුරත්
right-honourable=අතිගරු | මහාමාන්‍ය
right-minded=අවංක | සෘජු
right-ward=දකුණු පැත්තට
righteos=දැහැමි
righteous=දමිටු | ධර්මිෂ්ඨ | ධාර්මික | යහපත්
righteousness=ධාර්මිකතාව
rightfu=හරි ආකාර
rightful=නියම | නීත්‍යනුකූල බලය ලත් | හරි ආකාර
righthandedness=දකුණත් හුරුව
rightousness=ධර්මිෂ්ඨකම
rights=අයිතිවාසිකම් | හිමිකම්
rights,human=මානව අයිතිවාසිකම් | මානව හිමිකම්
rights-in-uxoren=පත්නී අයිතිවාසිකම්
rigid=අනම්‍ය | ඉදු | උග්‍ර | කඨින | තද | දැඩි | දෘඩ | පහසුවෙන් නොනැමෙන | බුරුලක් නැති
rigidity=අනම්‍යතාව | ඉදු බව | තදකම | දෘඩතාව
rigmarole=වැල්වටාරම් කථාව | හෑල්ල
rigor=කාටීන්‍යය | කාඨින්‍යය | ගැහීම | වෙවුලුම සහිත සීතල | සන්නිය
rigorism=දෘඩවාදය
rigorous=උග්‍ර | තදබද | බරපතළ
rigour=උග්‍රභාවය | තදකම | දැඩිබව | බුරුලක් නැතිබව
rile=කලබල කරනවා | කුපිත කරනවා
rilievo=උන්නතය
rill=කුඩා දොළ | දියපාර
rim=ගැටිය | දැවිය | නිම් වළල්ල | නිම්වළල්ල | නේමිය | පට්ටම | වළල්ල | විල්ල
rime=තුෂාර | තුෂාරය
rimer=රයිමරය
rimless=පට්ටම් නැති
rimmed=ගැටියක් ඇති
rind=පොත්ත | ලෙල්ල | සිවිය
rinderpest=කුර ලෙඩ | ගව වසංගතය
rinderpist=කුරලෙඩ | ගවවසංගතය
ring=කවය | චක්‍රය | නද | නදවනවා | නාද කරනවා | නාද වෙනවා | පිඟන් බඩුවල නාදය | පිල්ල | මුද්ද | මුදු | මුදුව | රංචුව | රැස්ව සිටින පිරිස | ලෝහ ද්‍රව්‍යවල නාදය | වක්‍රාකාරව උඩට නැඟෙනවා | වට කරනවා | වටය | වලය | වලයය | වළල්ල | සොරමුළ | හජ නඟනවා | හස
ring-armature=වළලු ආමේචරය
ring-finger=වෙදගිල්ල | වෙදැඟිල්ල
ring-master=සංදර්ශනයක මෙහෙයුම්කරු
ring-worm=උඳුගොව්වන් කෑම | පණු පණුකැවිල්ල | පණුකැවිල්ල
ringent=කටබැලි
ringer=නදවනය
ringfinger=මුදු දමන ඇඟිල්ල
ringing=නදන | නදවන | පොතු වටකැපීම
ringlet=කුඩා මුදුව
ringworm=පණුකැවිල්ල
rinse=පිරිසුදු දියෙහි සෝදනවා | යන්තමින් සෝදනවා
riot=කැරලි කෝලාහල | කැරලි කෝලාහලය | කැරලි කෝලාහාල | කැරැල්ල | කැලඹීම | කෝලාහල කරනවා | කෝලාහලය | ඝෝෂා සහිත ක්‍රීඩෝත්සවය | දුරාචාරය | දුරාචාරයෙහි යෙදෙනවා
rioter=කැරලිකරුවා
riotous=අශික්ෂිත | මහත් ඝෝෂා සහිත | සීමා ඉක්මවා ගිය
rip=ඉරනවා | ඉරා වෙන් කරනවා | ඉරුම | දිග පැල්ම | පළනවා | මහත් වේගයෙන් දුවනවා
rip-rap=ඉරිගල්
riparian=ඉවුරු බද | ගංගාබද | ගඟබඩ | තීර | නදී නිම්නයට සම්බන්ධ | නදීපාත්‍ර
riparious=ගඟබඩ | තීර
ripe=ඉදුණු | ඉදෙනවා | පරිණත | පැසුණු | මේරූ | වැලකොඩුව | සම්පූර්ණ | හොඳින් වැඩුණු
ripen=ඉදවනවා | ඉදෙනවා | මෝරනවා | විලිකුම් | සම්පූර්ණ කරනවා | සම්පූර්ණත්වයට පැමිණෙනවා
ripeness=ඉදුණුබව
ripening=ඉදීම | පරිණත වීම | පැහීම
riposte=පහර දීම
ripper=ඉරනය
ripping=ඉරීම | නොම්මර එකේ | පැළීම | හරි ජය
ripple=කුඩා දියරැල්ල | කුඩා රැලි නඟිනවා | රැලිත්ත | රැළිත්ත | රැළියත්ත
rise=ඉහළ යනවා | උදා වෙනවා | උපදිනවා | උසස් වෙනවා | උසස්වීම | ක්‍රමයෙන් දියුණු වෙනවා | නැගෙනවා | නැඟිටිනවා | නැඟීම | නැඟුම | නැඟෙනවා | පිබිදෙනවා | මතු වෙනවා
risen=උද්ගත | නැඟුණු
riser=නඟිනාර | පඩි උස
risibility=අවඥා සහගත බව
risible=සිනාසීමට කැමති
rising=ඉහල නගින | උට්ඨාන | උත්ථාන | උද්ගමය | උද්වහනය | ක්‍රමයෙන් දියුණු වන | කැරැල්ල | කුරුලෑව
risk=අනතුර | අනතුරක් වියහැකි බව | අනතුරට භාජනය කරනවා | අවදානම | අවදානමට පත් වෙනවා | ආපදාව | උපද්‍රව | පාඩුවක් වියහැකි බව | විසන්දේහය | සැකය
risk-bearing=අවදානම් දරණ
risky=අනතුරු සහිත | අනුමාන | අවදානම් සහිත | සැක සහිත
risque=අසභ්‍ය
ritardando=සංගීතයේ තීව්‍රතාව අඩු කර
rite=චාරිත්‍රවිධිය | පාලිය | වත | වතාවත | ව්‍රතය | විධිය | සංස්කාරය
rites=වත්
ritoccata=ප්‍රතිපරාමාෂ්ටය
ritschlianism=රිචලියානුවාදය
ritual=චාරිත්‍රක්‍රමය | පිළිවෙත | පිළිවෙත් පිළිබඳ වූ | පූජාකර්මය | පූජාවිධි | පූජාවිධිය | යාගය | ව්‍රතය | විධි | විධිගතය | වෛධික | ශාන්තිකර්මය | ශාන්තිය | ශාන්තිවිධි | සමයම | සෙත් සාන්තිය
ritualism=පුද පූජා විධිය | පූජාවිධි වාදය
ritualistic=ජූජාවිධිමයි
ritualization=පූජාවිධිකරණය
ritualized=පූජාවිධිගත
rituals=පූජාවිධි
ritzy=ජේත්තුකාර | ධනවත් | සුඛෝපභෝගී
rivage=ඉවුර | වෙරළ
rival=තරඟ කරනවා | තරඟකාරී | ප්‍රකාශ කරනවා | ප්‍රතිවාදියා | විරුද්ධව ක්‍රියා කරන්නා | සතුරු | සමව පවතිනවා
rivalry=තරගය | තරඟය | ප්‍රතිවිරෝධය | විරෝධය
rive=පළනවා
riven=පැළුණු
river=ආර | ගංගාව | ගඟ | ගලායන දිය පහර | නදිය | නී | වාහිනී | හෝ
river-basin=ගංදෙණිය
river-cliff=ගංදඹය
river-mouth=ගංමෝය | මුවදොර | මෝදර
river-side=ගංතෙර
river-terrace=ගංදඟරය
riverain=ගංඉවුරෙහි වූ | ගඟෙහි වූ
riverbank=ගංතෙර | හෝකඩ
riverbed=ගංපත්ල | නදීපාත්‍රය
rivermouth=මෝ
rivers=ගංගා
riverside=ගංඉවුර | සතලා | සතෙර | හෝකන්ද
rivet=මිටියම් | මිටියම් ඇණය | මිටියම් කරනවා | රිවට් කරනවා
riveted=මිටියම් කළ
riveter=මිටියම් කරන්නා | මිටියම්කුරුව
riveting=මිටියම | මිටියම් කිරීම
rivulet=ඇළ | කුඩා දිය පාර | කුන්නදිය | ගඟ | ගඟිත්ත | දොළ
rix-dollar=පතාගය
rixa=කෝපය
riyal=රියාල්
rm.s.=වර්ග මධ්‍යන්‍ය මූල
roach=මාලු විශේෂයක්
road=පථය | පන්ථ | පන්ථක | පාර | මං | මංපෙත | මංමාවත් | මග | මඟ | මහපාර | මාර්ග | මාර්ගය | මාවත | වීථිය | හසර
road-hog=නොසැලකිලිමත් රියදුරා
road-metal=පාරට යොදන ගල්
roadstead=නැව්පොළ
roadworthy=ගමනට සුදුසු | මාර්ග යෝග්‍ය | මාර්ගයෝග්‍ය
roam=ඉබාගාතේ යනවා | කරක් ගහනවා | තැන් තැන්වල ඇවිදිනවා | නිදැල්ලේ යනවා | සවරන් ගහනවා
roaming=අටනය | සවරම
roan=වයිරම් සහිත තුනී බැටළුහම
roar=කෑගසනවා | ගර්ජනය | ගුගුරනවා | ගොරවනවා | බෙරිහන් දෙනවා | මහානාදය
roaring=කුණාටු සහිත
roast=කර කනවා | කර කරනවා | පුලුස්සනවා | බදින ලද මස් | බදිනවා | බැණවදිනවා | මලවනවා | රොස් කරනවා
roasted=තම්බන ලද | බදින ලද | මැලවූ | රොස්
roaster=කරකුරුව | බදින උපකරණය
roasting=අධික රස්නය ඇති | කර කිරීම | භස්මීකරණය
rob=පැහැරගන්නවා | මංකොල්ල කනවා | සුද්ද කරනවා | හොරෙන් ගන්නවා
robber=පල් හොරා | මංකොල්ලකාරයා | හොරා
robbery=කොල්ලය | මංකොල්ලය | මහා හොරකම | විලෝපය
robbing=විලෝපනය
robe=චීවරය | දිග ඇඳුම | පළඳවනවා | පළඳිනවා | පාරුපණ | පොරෝනය | ලෝගුව | සළුව | සිවුර
robes=නිලය හෝ තත්ත්වය අඟවන ඇඳුම් කට්ටලය
robin=අවිච්වයා
robot=පරිගණක මිනිසා | රොබෝ | රොබෝව | රෝබෝව | රෝබෝවා
robotics=රොබෝ විද්‍යාව
robotology=රොබෝ වේදය
robust=වෙර ඇති | ශක්තිමත් | හැඩිදැඩි
robustious=දඩබ්බර
roc=විශාල පක්ෂි වර්ගයක්
rocaille=විසිත්කම්
rochelle-salt=රොෂෙල් ලවණ
rochet=දේවගැතිවරයාගේ ඇඳුම
rock=අවල | කළු ගල් | කුළ | ගල | ගල්කුළ | ගල්පර්වතය | ගිර | ගිරි | දඹ | පද්දවනවා | පර්වතය | පව්ව | පහණ | පාෂාණ | පාෂාණය | පැද්දුම | වාණ | ශිඛි | ශිලා | ශෛල | සල් | සිලා | සෙල | සෙල් | සේල
rock-basin=පාෂාණ ද්‍රෝණිය
rock-crystal=පාෂාණ ස්ඵටිකය | සෙල් පිළිමිණි
rock-waste=පාෂාණ සුන්බුන්
rocker=දළකුරුව | පැද්දීම සඳහා ගනු ලබන ලීය | සලැඟිල්ල
rockery=කුඩා මල්පැළ ආදිය සිටුවීමට සකස් කළ ගල් සහිත බිම්
rocket=ආකාශ වෙඩිල්ල | ඉක්මනින් ඉහළ යනවා | රොකටය | රොකට්ටුව | වේගයෙන් ඉහළ යනවා
rocketry=රොකට් ප්‍රක්ෂේපණ විද්‍යාව | රොකට් ශිල්පය
rocksalt=සහිඳ ලුණු
rockwork=සෙල්කම්
rocky=ගල් සහිත | ශිලාමය | ශෛලමය
rococo=රොකෝකෝ
rod=කූර | කෝටුව | දණ්ඩ | පොල්ල | බිලීපිත්ත | යටිය | යෂ්ටි | රිට | වේවැල
rodding=කීරීම | කූරු ලෑම
rode=අවිනීත | අශෝභන | නොහික්මුණු | රළු | හැඩහුරු මදි වූ
rodent=කාන්නකයා
rodenticide=මූසිකනාසක
rodeo=ගවයන් ගාල් කිරීම
rodman=පොලු කරුවා
rodomontade=පුරාජේරු කතාව
roe=කුඩා මුව වර්ගයක් | කුරංගයා | මාලු බිත්තර සමූහය
rogation=දේව මෙහෙයක්
roger=හරි පණිවුඩය ලැබුණා
rogue=කට්ටයා | තක්කඩියා | ධූර්තයා | මැරයා | හොරගෙඩියා | හොරා
roguery=හොරමැරකම
roguish=දඟකාර | මැර
roguishness=හොරමැරකම
roister=වෙරි වී කෑ ගසමින් යනවා
role=ක්‍රියාකලාපය | කාර්යභාරය | භූමිකාව | රෝල | ස්වකීය ක්‍රියාකලාපය
roles=කාර්ය සංකේත
rolimop=මාලු වලින් සකසන ලද ආහාරයක්
roll=අකුළන ලද මිටිය | අකුළනවා | ආලේඛනය | ඇකිළෙනවා | ඔතනවා | ඔප්පා වෙනවා | කරකවනවා | කුඩා පාන් ගෙඩිය | ගුළි ගසනවා | තළා මට්ටම් කරනවා | නම් වට්ටෝරුව | නළු ලේඛනය | පැත්තෙන් පැත්තට පැද්දෙනවා | පැද්දීම | පෙරළනවා | පෙරළෙනවා | පෙරෙට්ටුවේ නම් අජගැසීම | පොතනුව | මහත් ශබ්දය | රෝල | රෝල් කරනවා | සුරුණ්ඩි
rolled=පිරිවැටූ | රෝල් කළ
roller=කරකැවෙන පොල්ල | පිරිවටනය | රොලය | රෝල | රෝලරය
rollick=වැනි වැනි යනවා
rollicking=ක්‍රීඩාවෙහි යෙදුණු
rolling=ඇනීම | කැරලි ගැසීම | පිරිවටන | පිරිවටනය | පෙරළීම | රෝල් කිරීම | ලාසනය
rolls=කැරලි | රෝල්
rollway=පිටාර මඟ
roly-poly=ජෑම් යෙදූ පුඩිං වර්ගයක් | තරබාරු
rom=පඨන මාත්‍ර මතකය | රොම්
roman=රෝමන් ජාතිකයා | රෝමයට අයිති | රෝමානු
romance=අතිශයෝක්තියෙන් දක්වනවා | අද්භූත කථා කියනවා | අද්භූත වෘත්තාන්තය | ආඛ්‍යානය | ප්‍රබන්ධ කථාව | ප්‍රේම වෘත්තාන්තය | ප්‍රේමවෘත්තාන්තය | මිථ්‍යා ප්‍රබන්ධ කියනවා | විවත්‍රාද්භූතය
romanesque=යුරෝපයේ පෙර පැවැති ගෘහනිර්මාණ කලාවක් | රෝමාකාර
romanism=රෝමවාදය | රෝමානු ආගම
romanists=රෝමිකයෝ
romanization=රෝම අකුරින් ලිවීම
romanize=රෝම අකුරෙන් දක්වනවා
romantic=අද්භූත | රොමැන්ටික් | විවත්‍ර | විවත්‍රාද්භූත | ශෘංගාර
romanticism=රොමැන්ටික්වාදය | විවත්‍රාද්භූතවාදය | විවතාද්භූතවාදය | සත්‍යයට වඩා අලංකාරයට ප්‍රිය කරන කලාව
romanticist=සත්‍යයට වඩා අලංකාරයට ප්‍රිය කරන රචකයා
romanticize=ප්‍රේම හැඟීම් ඇතිකරවනවා
romantists=රොමැන්ටික්වාදියෝ
romany=අහිගුණඨිකයා
rome=රෝමය
romp=පෙම්කෙළිනවා
romper=දරුවන්ට අන්දන ඇඳුමක්
rondeau=කුඩා ගීත විශේෂයක්
rondel=කුඩා ගීත විශේෂයක් | වෘත්තාකාරය
rondo=කුඩා ගීත විශේෂයක්
roneo=රෝනියෝ
rontgen=විකිරණශීලිතාව මනින මිම්ම
rood=අක්කරයෙන් හතරෙන් පංගුව | කුරුසි සුරුවම | රූඩය
roof=ඡදන | ඡාදනය | පල | පලය | පියස්ස | වහල | වහළ | වහළක් යොදනවා | වැස්ම | සදන | සියන | සෙවිලි කරනවා | සෙවෙනිය
roofing=වහළේ අඩුවැඩිය
rook=රවටනවා | ලොකු කපුටු වර්ගයක් | වංචාකාරයා
rookery=කපුටන් ලගින තැන
rookie=ආධුනික සෙබලා
room=අවකාශය | ඉඩ | ඉඩපාඩු | කාමරය | කුටිය | ගබ | ගැබ | මැදිරිය | ශාලිකා
roomy=ඉඩපාඩු ඇති | විශාල
roost=කුරුලු රැළ
rooster=කුකුළා
root=අල | අලය | උදුරනවා | කන්ද | දා | ධාතුව | නිදානය | පතුල | ප්‍රකෘතිය | පාමුල | මුල | මුල් | මුල් අදිනවා | මුල් බැසගන්නවා | මුල් හේතුව | මූල | මූලය
root-stock=අලටිය
rooted=දැඩි | මුල් බැසගත් | ස්ථීර
rooter=මං බිඳිනය
rootlet=කුඩා මුල | මුලිකාව
roots=මූල
rope=කඹය | ණ | තේඩාව | න | බඳිනවා | බහන | බාන | බැඳගන්නවා | මන්ද | යොත | රජ්ජුව | රැහැන | ලණු | වරපට
roquetort=කේජු විශේෂයක්
rorqual=තල්මසා වර්ගයක්
rosaceous=රෝස පවුලට අයත් | රෝසාකාර
rosary=අක්ෂමාලාව | කොන්තය | නවගුණවැල | යාච්ඤා සංග්‍රහය | රෝස උයන
rose=මල | රෝස පාට | රෝස මල සෙව්වන්දි | ලාරතු වර්ණය | වතුර මල | සෙව්වන්දි
rose-apple=ජම්බු
rose-water=පිනිදිය
roseate=රෝසපාට
rosemary=සුවදැති පැළෑටි වර්ගයක්
rosery=රෝස වත්ත
rosette=මලිත්ත | රොසට්ටුව | රෝසභූෂණය | සෙව්වන්දිය
rosewood=රෝස දැව | ලී වර්ගයක්
rosicrucianism=රොසෙන්කෘයෙට්ස්වාදය
rosin=ගල් දුම්මල | ගස්වලින් වෑහෙන ලාටු | දුම්මල
rostel=තුණ්ඩිකය
rostellate=තුණ්ඩික
rostellum=තුණඩිකය | තුණ්ඩිකය
roster=කෘත්‍යලේඛනය | මුර ලැයිස්තුව | රාජකාරි ලේඛනය | වැඩ වාර සටහන | වැඩවාර සටහන
rostrate=සතුඩු
rostriform=තුඩුවන්
rostrum=අනුවේදිකාව | කථිකාසනය | වේදිකාව
rosy=රෝසපාට | සතුටුදායක
rot=කුණු වීම | කුණු වෙනවා | දිරනවා | දිරවනවා | දිරාපත් වීම | දිරීම | දිරුම | පල් වෙනවා | පව | සවුත්තු කරනවා
rota=කෘත්‍යසූවය | මුර ලැයිස්තුව
rotamer=භ්‍රමාවයවිකය
rotamerism=භ්‍රමාවයවිතතාව
rotand=ගෝලාකාර | මණ්ඩලාකාර | වටකුරු
rotarian=රෝටරි සමාජයේ සාමාකයා
rotary=පරිභ්‍රමී | භමණ | භ්‍රමණ | රෝටරිය | රෝදයක් මෙන් කරකැවෙන
rotate=කරකවනවා | කැරකැවෙනවා | පෙරළෙනවා | බමනවා | භ්‍රමණය | භ්‍රමණය කරනවා | භ්‍රමණය වෙනවා | මණ්ඩලාකාර | මාරුවෙන් මාරුවට පැමිණෙනවා | වටකුරු
rotating=භ්‍රමණ
rotation=කරකැවීම | පරිභ්‍රමණය | පරිවර්තනය | පෙරළුම | බැමවීම | භ්‍රමණය | වටමාරුව | වැටුම්
rotator=භ්‍රමකය | භ්‍රමණ ඌෂ්මකය
rotatory=භ්‍රමණය වන | භ්‍රමී
rotaversion=භ්‍රමාවයවීකරණය
rote=පුරුද්ද
rote-memory=යාන්තික ස්මරණය
rotisserie=රෝස් කළ ආහාර විකුණන අවන්හල
rotor=බ්‍රමකය | භ්‍රමකය
rotoscope=භ්‍රමේක්ෂය | රොටොස්කෝපය
rotten=කුණු වූ | තුච්ඡ | දුෂ්ට | පල් වූ | පිලුණු | පූති | වැදගැම්මකට නැති
rotter=කමකට නැති තැනැත්තා | කාලකණ්ණියා | නිකමා
rotty=රොටිය
rotund=ගෝලාකාර | තරබාරු | වටකුරු
rotunda=චක්‍රාකාර ගෘහය | වටගේ
rotundity=වටකුරුබව
rotundiy=වටකුරු බව
roue=මුඛරාගය | සල්ලාලයා
rouge=රතු සුවඳ පුයර මිශ්‍රණයක් | රුජ් ආලේපය
rough=අමිහිරි | අවුස්සා අවුල් කරනවා | අශික්ෂිත ලෙස | අශිෂ්ට | අශිෂ්ටයා | අසම්පූර්ණ | අසම්පූර්ණ ලෙස | කඨින | කර | කරළු | කර්කශ | කොරොස් | කොහොල් | ඛර | ගොරහැඩි | ගොරෝසු | තද | දළ | දළ වශයෙන් | දළ්හ | දැඩි | දුෂ්කර | නපුරු | නිර්දය | නොසැලකිලි ලෙස | පරුෂ | ප්‍රචණ්ඩ | මැරයා | යාමට දුෂ්කර | රළු | රූක්ෂ | රොඹු | ලොට්ට | විෂම | සැජ | සැඩ | සැර
rough-cast=දළ කපරාරුව
rough-draft=කෙටුම්පත | මුල් සැලැස්ම
rough-rider=කුළු අශ්වයන් පුරුදු කරන්නා
rough-shod=පිටට නෙරූ ඇණ සහිත ලාඩම් ඇති
roughage=දළ ආහාර වර්ග | රළුව
roughcast=රළු වාත්තුකම
roughen=ගොරෝසු කරනවා | ගොරෝසු වෙනවා | රළු කරනවා | රළු වෙනවා
roughing=රළු කැපීම
roughly=දළ වශයෙන්
roughness=දළ බව | රළු බව | රළුව
roulette=තිත්කුරුව | රූලේ | සුදු විශේෂයක්
round=කවාකාර | ක්‍රීඩාවාරය | ගෝලය | ගෝලාකාර | චක්‍රාකාර | පිරුණු | පෙත්ත | මණ්ඩලය | රවුම | වට | වටකුරු | වටකුරු කරනවා | වටකුරු වෙනවා | වටගමන | වටනැටුම | වටය | වටා පිටා | වටේ | වටේ තබනවා | වටේ යන ගමන | වෙඩිමුරය | සම්පූර්ණ | ස්ථූල | සෑම පැත්තෙන් | සෘජු | හාත්පස
round-about=වටරවුම
round-up=වැටලීම
roundabout=බඹර ඔන්වල්ලාව | වටරවුම
rounded=වටකුරු
roundel=නැටුම් විශේෂයක්
roundelay=ගීත විශේෂයක්
rounders=එල්ලේ ගැසීම | පන්දු ක්‍රීඩාවක්
rounding=වටැයිම
roundly=නිර්භයව | පැහැදිලිවම
roundness=වට බව
roundsman=බඩු බෙදාදීමේ නියුක්ත වෙළඳ නියෝජිතයා
roundworm=වටපණුවා
rouse=අවුස්සනවා | නැඟිටිනවා | නැඟුටුවනවා | ප්‍රබෝධවත් කරනවා
rousing=ප්‍රබෝධකර
roustabout=විවිධ වැඩ කරන කම්කරුවා
rout=අන්ත පරාජයට පත් කරනවා | කලබල සහිතව පලායාම | ගෝට්ටිය | තුමූලය | පලවා හැරීම | මහත් පරාජය | සේනාභංගය
route=ගමන් පථය | ගමන් මඟ | ධාවන මාර්ගය | මඟ | මාර්ගය | යායුතු පාර
router=උළුපුව
routine=ආකාරික | ආකාරිකය | ක්‍රම චර්යාව | චර්යානුගත | දිනචරියාව | දිනපතා කරන වැඩ | නිත්‍ය පිළිවෙත | නෛත්‍යක | නෛත්‍යකය | පුරුද්ද | රූටිනය
routiner=නීතියුරුව
routing=මං සැකසුම | මාර්ගගත කිරීම | මාර්ගෝපගත කිරීම | මැඟීම
rouwkoop=අත්තිකාරම | රවුකූපය
rove=ඉබාගතේ යනවා | කරකැවෙනවා
rover=ජ්‍යෙෂ්ඨ බාලදක්ෂයා | මූදු කොල්ලකාරයා
row=අට්ටිය | අසුන් පෙළ | ඔරු පදිනවා | ඔරුවෙන් යන ගමන | කලකෝලාහල | කලබලය | කෑමොර ගහනවා | කොලොප්පම | කෝලාහලය | ගෝට්ටිය | චරචරය | පදිනවා | පැදගෙන යනවා | පිළ | පෙළ | පේළිය | මාලා | රොද | රොඹ | වැල | සඩංගුව
rowdiness=නොහික්මුණුකම | මැරවරකම
rowdy=චණ්ඩියා | නොහික්මුණු | මැරයා | මැරවර | මැරවරයා
rowdyism=මැරවරකම
rowel=සන්කටුවෙහි සවි කළ කුඩා කටුරෝදය
royal=උදාර | ක්ෂත්‍රිය | කැත් | මංගල | මංගල්‍ය | මඟුල් | රාජ | රාජකීය | රාජ්‍ය | රෝයලය | සිරි
royalist=රාජපාක්ෂිකයා
royally=ඉතා උසස් ලෙස
royalty=කර්තෘභාගය | නිෂ්පාදන භාගය | පුරස්කාරය | රජකම | රාජත්වය | රාජභාගය | රාජවංශය | රාජවංශිකයා | රාජ්‍යභාගය | හිමිකාරභාගය
rpm=යලි විකුණුම් මිල රැකීම | යළි විකුණුම් මිල රැකීම
rrived=සපැමිණි
rtatory=භ්‍රමක
rub=අතුල්ලනවා | අමාරුව | ඇතිල්ලීම | ඉලීම | උලනවා | උළනවා | ගටනවා | ගානවා | තවරනවා | නහස්නාව | පිරිමදිනවා | පිසදැමීම | පිහිනවා | බාධාව | මකනවා | ශුද්ධ කරනවා
rub-a-dub=බෙර ශබ්දය
rubber=ඉලුම් කැටය | මකනය | රබර්
rubberneck=අනුන්ගේ ඇදකුද සොයන්නා
rubbing=ඇතිල්ලීම | ඝර්ෂණය | පිරිලස | පිළිරුව ගැනීම | සම්මර්ශනය
rubbish=අහක දමන දේ | කන්දල් | කසළ | කැළිකසළ | කුණු | කුණුකන්දල් | කුණුකසල | ලටපට | ලට්ටලොට්ට | වල්පල් | සංකාර
rubbishy=රොඩු සහිත | වැඩකට නැති
rubble=කුඩා ගල් කෑලි | රළුගල් | සක්ක ගල්
rubefacient=ශොණිතකය
rubella=ජර්මන් සරම්ප | රූබෙලාව
rubenists=රූබන් වාදියෝ
rubicon=ඉතාලියේ ගඟක්
rubicund=මඳක් රතු | මුහුණ රතු වූ
rubidium=මෘදු ලෝහමය මූලද්‍රව්‍යයක් | රුබීඩියම්
rubiginous=යමලවන්
rubignose=යමලවන්
rubric=අභිධානය | පරිච්ඡේදයෙහි මාතෘකා පාඨය | මාතෘකා පාඨය
rubrication=රක්තනය
ruby=පද්මරාග | පද්මරාගය | පොකුරුමිණි | රක්තවර්ණ | රත්න පුෂ්පරාග | රතුකැට | රතුකැටය
ruche=රැලි කළ වාටිය
ruck=ගොන්න | රැලි ගැසෙනවා
rucksack=ඔලගුව | ගමන් මල්ල
ruction=දබරය | වාදය
rudaceous=රතු
rudder=අරිත්‍රය | සුක්කානම
ruddy=උලව් | රතුපාට ඇති
rude=අණක් ගුණක් නැති | අදාන්ත | අශිෂ්ට | අශෝභන | ග්‍රාම්‍ය | ගොරෝසු | නූගත් | නොහික්මුණු | පරුෂ | ඵරුෂ | බලවත්
rudeness=නොහික්මුණු බව
ruderal=සංකාර
ruderals=සංකාර ශාක
rudiment=අල්පවිකසිතය | ආකෘතිය | ආද්‍යය
rudimental=අල්පවිකසිත
rudimentary=අල්පවිකසිත | අසම්පූර්ණ | ආකෘතික | ප්‍රාථමික | මූලික
rudiments=මූලශික්ෂා | මූලික කරුණු
rudy=අරුණ
rue=කනගාටු වෙනවා | පසු තැවෙනවා | සහගහනවා
rueful=දුහ්ඛිත | පසුතැවිලි වන
ruff=අත් ලොවිච්වය | රැලි පිස්මේන්තුව
ruffian=දුෂ්ටයා | මැරවරයා
ruffianism=චණ්ඩිකම | මැරවරකම
ruffianly=චණ්ඩ
ruffle=අවුල් කරනවා | රැල්ල | ලොවිච්වය
rug=කම්බිලිය | පලස | රග්බි ක්‍රීඩාව
rugate=රැළි සහිත
rugby=රග්බි ක්‍රීඩාව
rugged=අවලක්ෂණ | කරුකශ | කසිකබල් | තද | පරුෂ | රළු | විෂම | සමතලා නොවූ
rugose=රැළි සහිත
rugosity=වෛච්‍යය
rugs=බුමුතුරුණු
rugulose=කැරළි සහිත
ruhuna=රුහුණ | රූණ
ruin=ඉඟ මොළ කනවා | කඩාකප්පල් කරනවා | කාබාසිනියා කරනවා | ගරා වැටෙනවා | ජාරාවාසය | දිරනවා | නෂ්ටාවශිෂ්ට | නෂ්ටාවශේෂ | නසිනවා | නැති කරනවා | පරාභවය | යකාට යනවා | රටකනවා | වණ කරනවා | ව්‍යසනය | වින්නැහිය | විනාශ කරනවා | විනාශය | විනේ | විපත්තිය
ruination=නස්පැත්තිය
ruined=කපෝති | කම්මුතු | දිරාපත් | නටබුන්
ruinous=අනර්ථකර | ජරාවාස වූ | රට නැති කරන | විනාශකාරී | විනාශදායක
ruins=ගරාවැටුණු ගොඩනැඟිලි ආදිය | නටබුන් | නෂ්ටාවශේෂ
rule=අඩිපටිය | අණ | අධිපාලනය | ආණ්ඩු කරනවා | ආණ්ඩුව | ඉර | ඉරි ගසන ලීය | ඉරි ගසනවා | ඉරිගහනවා | ක්‍රමය | කෝදුව | න්‍යාය | නියම කරනවා | නියමය | නීතිය | පාලනය | පාලනය කරනවා | පුරුද්ද | මැඩපවත්වනවා | රජ කරනවා | රාජ්‍යය | රාජ්‍යය කරනවා | රැජැයුම | රීති | රීතිඅණ | රීතිය | රූල | රූල් ගසනවා | රෙකුලාසිය | විධිය | සම්වතා | හසුරුවනවා
ruled=රේඛිත
ruler=අඩිකෝදුව | අධිපති | ආණ්ඩුකාරයා | කෝදුව | පල්ලා | පාලකයා | රූල | රූල් පොල්ල
rules=කොන්දේසි | නීති | නීතිරීති | රීති
ruling=අධිපති | ප්‍රධාන | පාලක | රීති නියමය | රේඛනය | විධිතීරණය
rum=අපූරු | අරුම | පුදුම | රම්
rumba=නැටුම් විශේෂයක්
rumble=ගර්ජනය | ගැටුම් බෙරය | ගොරවනවා | දුර්වල ලෙස ගොරවනවා
rumbling=ගැටවීම
rumbustious=චණ්ඩ | හඬ නඟා කෑගසන
ruminant=රෝමන්ථ | රෝමන්ථයා | වමාරා කන්නා
ruminate=කල්පනාවෙහි යෙදී සිටිනවා | කැටයම් වැටුණු | ප්‍රත්‍යවේක්ෂා කරනවා | වමාරා කනවා
rumination=වමාරා කෑම
ruminative=කල්පනාවෙහි යෙදුණු
rummage=අවුස්සා සොයනවා
rummy=කාඩ් ක්‍රීඩාවක්
rumour=අනුශ්‍රැතිය | කට කථා පතුරුවනවා | කටකතාව | කටකථාව | කටලුකතා | ජනප්‍රවාදය | දූෂමාන ආරංචිය | දූසමාන ආරංචිය | දූසමානය | ප්‍රවාදය
rumoured=කට කථා පතුරුවන
rump=වලිගා කොටේ | ශ්‍රෝණිය | සට්ටම
rumple=බොකුටු කරනවා | වැකරැලි ගහනවා
rumpus=ආරාවුල | ගෝට්ටිය
run=කරනවා | කල් පවත්නවා | කුකුළු කොටුව | ගමන් කරනවා | ගමන් මාර්ගය | ගමනාගමනය | ගමනාගමනය කරනවා | ගලා යනවා | ගෙවී යනවා | දිගට වැවෙනවා | දිවීම | දිවුම | දුවනවා | දුවවනවා | ධාවනය | ධාවනය කරනවා | පලා යනවා | පලා යාම | පාලනය කරමින් පවත්වනවා | වක්කරනවා | වේගයෙන් යනවා | සිද්ධවීම
run-agate=පලායන්නා | පාදඩයා
run-away=පලා යන
run-off=අතිරික්තය
runaway=පලායන්නා
runcinate=ලඹදැතැනි
rune=පැරණි ජර්මන් භාෂාවෙහි යෙදුණු අකුරු පිළිබඳ | පැරණි ජර්මන් භාෂාවෙහි යෙදුණු අකුරු වර්ගයක්
runnel=දොළ
runner=ගලනාර | දුවනය | ධාවකය | ධාවකයා | පණිවිඩකාරයා | වැල
runners=දිගන
running=අනුක්‍රමණ | ගොහොදු ගැලීම | දුවන | ධාවනය | නොකඩවා පවත්වන | පිට පිට | පිට පිට වූ | සන්ධාවනය
running-in=පදම් දිවවීම
runny=ගලන | ද්‍රවීය
runs=පෙළ
runt=කුඩා පුද්ගලයෙක් | කුඩා සතෙක්
rupee=රුපියල
rupestrine=අශ්මරුහ
rupia=රුපියාව
rupiah=රුපියාව
rupicolous=අශ්මරුහ
ruptum=කැම
rupture=අණ්ඩවායුව | කැඩෙනවා | පැල්ම | පැළෙනවා | පිපිරීම | භංජය | භේද වෙනවා | භේදය | විදාරණය
rural=ගම්බද | ග්‍රාමීය | ගැමි | ගොඩේ | පසල් | පිටිසර
ruralization=ග්‍රාමිකරණය
rurban=ග්‍රාමරික
ruse=කූට උපාය | දඟය | ප්‍රයෝගය
rush=ආක්‍රමණය | ඉක්මන් කරවනවා | ඉක්මනින් ස්ථීර කරගන්නවා | කටයුතු බහුලවීම | තල්ලු වෙනවා | දඩිබිඩිය | පන් | පහරදීම | වේගය | වේගයෙන් කරන ක්‍රියාව | වේගයෙන් කරන ගමන | වේගයෙන් යනවා | සැරෙන් දුවනවා | සැරෙන් යනවා
rush-mat=කළාල
rusk=විස්කෝතු වර්ගයක් | හුළං විස්කෝතු
russet=මඳ රතු වූ
russia=රුසියාව
russian=රුසියාවට අයත්
rust=ගොයම් රෝගයක් | මණ්ඩුර | මල | මල බඳිනවා | මල බැඳෙනවා | මලකඩ | මලකඩ කනවා | යකඩ මල | යමල
rust-proof=මල නොකන
rust-proofing=මල වැරීම
rustic=අශිෂ්ට | කාෂ්ට | ගම්වැසියා | ග්‍රාම්‍ය | ග්‍රාමික | ග්‍රාමිණ | ග්‍රාමීය | ගැමි | ගැමියා | ගොඩේ | චාන් | පිටිසර | පිටිසරයා
rusticate=පිටිසරබඳව වත් වෙනවා
rusticity=චාම්බව | පිටිසරකම
rusting=මල කෑම | මල බැඳීම
rustle=මර්මර නාදය | සර සර ගානවා | සර සර ගෑම
rustling=සර සර හඬ
rusty=පැරණි | මල බැඳුණු | මල සහිත
rut=චක්‍රමාර්ගය | නීරස විතය | මද කාලය | රථරෝදයෙන් සෑදෙන වළ
ruth=අනුකම්පාව | දයාව | මෘදුකම
ruthenate=රුතනේට්
ruthenium=ප්ලැටිනම් කාණ්ඩයේ දැඩි සුදු පැහැති ලෝහමය මුලද්‍ර | රුතේනියම්
ruthless=අනුකම්පා නැති | කරුණු | ක්‍රෑර
rutile=රූටයිල්
rutted=රථ රෝදයෙන් පාර හෑරුණු
rutty=වළවල් සහිත
rye=රයි
rye-grass=රයිගස
ryghm=තාලය
rymer=රයිමරය
rymering=රයිමර් කිරීම
ryot=ගම්වැසියා
